labels,pr_number,created_at,additions,deletions,effort
"A-lang;B-RFC-approved;B-unstable,A-parser;B-RFC",11994,2014-02-02T13:27:08Z,179,18,197
"A-frontend;E-easy,E-easy;I-cleanup,A-frontend;E-easy,E-easy;I-cleanup",26772,2015-07-04T16:59:29Z,0,0,0
NULL,26777,2015-07-04T21:11:17Z,26,1,27
NULL,26783,2015-07-05T05:54:31Z,215,128,343
NULL,26798,2015-07-05T15:35:16Z,10645,9338,19983
NULL,26807,2015-07-05T19:42:07Z,17,2,19
NULL,26811,2015-07-05T23:12:21Z,10739,9373,20112
A-docs,26820,2015-07-06T06:55:43Z,11,0,11
I-ICE,26824,2015-07-06T15:47:11Z,42,12,54
NULL,26825,2015-07-06T16:14:43Z,4,0,4
NULL,26827,2015-07-06T16:27:28Z,32,0,32
A-docs,26828,2015-07-06T17:39:51Z,300,11,311
NULL,26829,2015-07-06T17:43:51Z,481,90,571
P-low,26833,2015-07-06T19:40:03Z,0,0,0
NULL,26836,2015-07-06T21:45:00Z,0,0,0
NULL,26837,2015-07-06T22:30:53Z,0,0,0
NULL,26844,2015-07-07T02:06:31Z,988,432,1420
NULL,26846,2015-07-07T03:29:26Z,38,20,58
NULL,26852,2015-07-07T13:19:20Z,29,0,29
"A-docs,A-docs,A-docs",26853,2015-07-07T13:22:56Z,14,14,28
"A-docs,A-docs,A-docs",26854,2015-07-07T13:27:12Z,14,1,15
"A-docs,A-docs,A-docs",26855,2015-07-07T13:29:19Z,6,5,11
NULL,26856,2015-07-07T13:37:20Z,18,2,20
NULL,26858,2015-07-07T15:24:25Z,0,0,0
NULL,26859,2015-07-07T15:49:13Z,58,18,76
NULL,26861,2015-07-07T17:49:56Z,200,42,242
NULL,26863,2015-07-07T17:57:04Z,0,14,14
NULL,26879,2015-07-08T10:57:58Z,66,3,69
NULL,26883,2015-07-08T12:29:54Z,40,5,45
"A-libs;E-easy,A-libs;E-easy",26885,2015-07-08T13:09:35Z,10,0,10
"A-resolve;I-cleanup,A-resolve;I-cleanup",26889,2015-07-08T14:32:32Z,0,5,5
NULL,26891,2015-07-08T17:05:22Z,4,0,4
NULL,26892,2015-07-08T17:09:21Z,5,3,8
NULL,26894,2015-07-08T18:34:27Z,61,17,78
"A-io;T-libs,A-io;T-libs,A-io;T-libs",26897,2015-07-08T20:03:13Z,1,1,2
NULL,26901,2015-07-08T21:41:23Z,25,1,26
relnotes,26904,2015-07-08T23:05:24Z,64,93,157
"A-llvm;I-ICE;T-compiler,A-llvm;I-ICE;T-compiler,A-llvm;I-ICE;T-compiler",26919,2015-07-09T16:52:58Z,8,31,39
NULL,26929,2015-07-09T23:47:21Z,225,35,260
"B-RFC-approved,B-RFC-approved,B-RFC-approved",26931,2015-07-10T07:06:43Z,39,21,60
NULL,26934,2015-07-10T09:53:20Z,109,10,119
NULL,26936,2015-07-10T12:52:13Z,4,4,8
NULL,26942,2015-07-10T17:46:02Z,0,0,0
NULL,26947,2015-07-10T21:11:47Z,32,20,52
"A-libs;I-crash;I-nominated;I-wrong,A-libs;I-crash;I-nominated;I-wrong,A-libs;I-crash;I-nominated;I-wrong",26955,2015-07-10T23:33:20Z,638,484,1122
"A-libs;B-RFC-approved;E-easy,A-libs;B-RFC-approved;E-easy,A-libs;B-RFC-approved;E-easy",26957,2015-07-10T23:39:49Z,109,89,198
"relnotes,relnotes",26961,2015-07-11T07:40:14Z,15,8,23
NULL,26963,2015-07-11T10:48:02Z,712,31,743
NULL,26965,2015-07-11T11:33:43Z,16,4,20
"A-libs;B-RFC-approved,A-libs;B-RFC-approved,A-libs;B-RFC-approved",26966,2015-07-11T11:58:15Z,110,77,187
"A-docs,A-docs,A-docs",26981,2015-07-12T00:45:58Z,26,6,32
NULL,26982,2015-07-12T03:05:53Z,92,14,106
NULL,26984,2015-07-12T07:33:01Z,22,0,22
NULL,26985,2015-07-12T07:35:55Z,66,67,133
"A-debuginfo,A-debuginfo,A-debuginfo",26993,2015-07-12T18:55:16Z,24,0,24
NULL,26999,2015-07-12T22:44:15Z,2,2,4
NULL,27003,2015-07-13T02:57:32Z,0,0,0
NULL,27006,2015-07-13T06:49:11Z,38,23,61
"A-codegen;I-wrong,A-codegen;I-wrong,A-codegen;I-wrong",27011,2015-07-13T11:27:04Z,21,1,22
NULL,27012,2015-07-13T11:58:02Z,71,47,118
NULL,27013,2015-07-13T13:25:40Z,4,4,8
NULL,27017,2015-07-13T17:18:03Z,379,6,385
"I-ICE,I-ICE,I-ICE",27018,2015-07-13T18:04:56Z,23,1,24
"A-diagnostics,A-diagnostics,A-diagnostics",27026,2015-07-13T22:19:03Z,92,90,182
"A-windows,A-windows",27036,2015-07-14T12:34:51Z,0,0,0
"I-ICE,I-ICE,I-ICE,I-ICE",27050,2015-07-15T05:21:25Z,0,0,0
NULL,27056,2015-07-15T21:46:02Z,142,13,155
NULL,27061,2015-07-16T03:51:57Z,0,4,4
"B-RFC-approved,B-RFC-approved",27064,2015-07-16T06:38:41Z,195,15,210
"A-parser;E-easy,A-parser;E-easy",27065,2015-07-16T07:25:40Z,49,19,68
NULL,27073,2015-07-16T19:02:27Z,60,47,107
A-rustdoc,27074,2015-07-16T19:55:57Z,3,4,7
beta-accepted;T-libs,27082,2015-07-17T08:06:25Z,113,17,130
NULL,27084,2015-07-17T12:00:27Z,154,7,161
A-diagnostics,27085,2015-07-17T14:27:46Z,78,27,105
NULL,27087,2015-07-17T14:45:12Z,539,374,913
NULL,27088,2015-07-17T15:04:08Z,4,6,10
NULL,27093,2015-07-17T18:08:46Z,22,0,22
NULL,27094,2015-07-17T18:35:37Z,2,2,4
NULL,27096,2015-07-17T19:44:05Z,40,12,52
NULL,27098,2015-07-17T21:13:17Z,136,248,384
NULL,27111,2015-07-18T16:26:43Z,17,1,18
NULL,27117,2015-07-18T21:41:07Z,28,0,28
A-associated-items;I-ICE,27118,2015-07-18T22:18:59Z,39,0,39
NULL,27121,2015-07-19T01:15:46Z,44,9,53
NULL,27127,2015-07-19T14:19:52Z,28,2,30
NULL,27131,2015-07-19T19:39:58Z,17,0,17
NULL,27132,2015-07-19T19:47:25Z,17,0,17
NULL,27133,2015-07-19T21:05:20Z,21,0,21
NULL,27134,2015-07-19T22:48:00Z,11,0,11
NULL,27138,2015-07-20T05:17:55Z,0,0,0
"A-debuginfo,A-debuginfo",27139,2015-07-20T08:12:26Z,17,4,21
"I-wrong,I-wrong",27140,2015-07-20T08:36:09Z,38,0,38
NULL,27146,2015-07-20T12:32:32Z,30,0,30
NULL,27147,2015-07-20T12:41:23Z,47,0,47
"A-libs,A-libs",27150,2015-07-20T14:48:46Z,15,9,24
"A-typesystem,A-typesystem,A-typesystem,A-typesystem",27154,2015-07-20T17:00:01Z,20,0,20
NULL,27158,2015-07-20T17:31:35Z,24,0,24
"A-windows,A-windows",27172,2015-07-20T23:15:23Z,12,32,44
"I-slow,I-slow",27180,2015-07-21T08:47:22Z,0,0,0
NULL,27182,2015-07-21T11:05:06Z,63,1,64
NULL,27193,2015-07-21T16:40:52Z,156,26,182
NULL,27194,2015-07-21T17:18:09Z,0,0,0
NULL,27197,2015-07-21T18:08:17Z,25,49,74
NULL,27199,2015-07-21T19:04:39Z,0,0,0
A-parser;T-compiler,27203,2015-07-21T21:09:20Z,5,4,9
NULL,27206,2015-07-21T23:00:24Z,0,0,0
NULL,27207,2015-07-22T02:46:08Z,0,0,0
NULL,27208,2015-07-22T04:33:13Z,93,1,94
NULL,27209,2015-07-22T05:22:03Z,0,0,0
NULL,27212,2015-07-22T12:53:27Z,56,2,58
NULL,27213,2015-07-22T13:19:59Z,0,0,0
NULL,27215,2015-07-22T13:39:55Z,899,47,946
NULL,27216,2015-07-22T14:28:39Z,0,0,0
NULL,27219,2015-07-22T16:56:53Z,4011,1300,5311
NULL,27220,2015-07-22T17:00:35Z,39,1,40
I-nominated;T-libs,27223,2015-07-22T22:20:35Z,0,0,0
NULL,27228,2015-07-23T07:34:43Z,0,0,0
NULL,27229,2015-07-23T09:44:59Z,50,1,51
NULL,27230,2015-07-23T10:28:27Z,156,9,165
A-docs,27235,2015-07-23T13:43:57Z,3,3,6
NULL,27236,2015-07-23T13:48:03Z,0,0,0
A-docs,27238,2015-07-23T16:57:18Z,8,0,8
NULL,27239,2015-07-23T17:27:55Z,27,1,28
A-diagnostics;E-easy,27244,2015-07-23T19:50:56Z,24,0,24
A-libs;E-easy;E-mentor,27246,2015-07-23T20:32:01Z,0,0,0
NULL,27252,2015-07-24T01:16:44Z,133,108,241
I-ICE,27253,2015-07-24T02:17:56Z,18,2,20
I-stable-regression;P-high;T-lang,27258,2015-07-24T14:26:51Z,80,31,111
B-RFC-approved;T-tools,27260,2015-07-24T16:06:59Z,97,1,98
NULL,27265,2015-07-24T18:56:04Z,409,38,447
NULL,27267,2015-07-24T20:16:22Z,4,3,7
NULL,27270,2015-07-24T23:06:19Z,0,0,0
I-ICE,27272,2015-07-25T00:04:45Z,20,25,45
NULL,27283,2015-07-25T18:27:13Z,63,44,107
"A-docs,A-docs",27285,2015-07-25T19:15:43Z,146,14,160
NULL,27297,2015-07-26T09:16:33Z,22,36,58
NULL,27307,2015-07-26T19:13:28Z,3828,18,3846
NULL,27313,2015-07-27T01:24:25Z,183,141,324
A-diagnostics,27315,2015-07-27T02:22:49Z,18,6,24
NULL,27318,2015-07-27T06:29:44Z,17,1,18
"A-syntaxext;A-testsuite,A-syntaxext;A-testsuite",27330,2015-07-27T17:43:40Z,38,23,61
beta-accepted,27334,2015-07-27T20:16:22Z,231,11,242
NULL,27338,2015-07-27T23:09:00Z,147,1673,1820
A-docs,27348,2015-07-28T13:18:02Z,0,0,0
"A-codegen;I-wrong;T-compiler,A-lint",27349,2015-07-28T13:54:51Z,30,9,39
A-closures;A-diagnostics,27350,2015-07-28T14:05:38Z,5,2,7
"A-build;A-testsuite;I-crash;I-nominated;T-compiler,A-build;A-testsuite;I-crash;I-nominated;T-compiler",27351,2015-07-28T14:31:42Z,154,28,182
"A-closures;A-diagnostics,A-closures;A-diagnostics",27353,2015-07-28T16:24:35Z,17,19,36
NULL,27358,2015-07-28T17:57:02Z,5,4,9
NULL,27378,2015-07-29T12:45:45Z,220,10,230
NULL,27380,2015-07-29T14:30:37Z,652,398,1050
NULL,27382,2015-07-29T19:03:37Z,40,2,42
"beta-accepted;T-libs,beta-accepted;T-libs",27383,2015-07-29T20:13:54Z,97,70,167
"beta-accepted;T-libs,beta-accepted;I-stable-regression;relnotes,beta-accepted;T-libs",27387,2015-07-29T20:57:15Z,61,15,76
NULL,27390,2015-07-29T21:54:19Z,0,0,0
B-RFC-approved,27393,2015-07-30T01:43:05Z,500,417,917
B-RFC-approved,27400,2015-07-30T16:51:52Z,1287,647,1934
NULL,27407,2015-07-30T21:34:22Z,14,3,17
A-rustbook;A-tools,27410,2015-07-30T22:32:37Z,4,3,7
I-nominated;T-compiler,27413,2015-07-31T01:12:42Z,0,0,0
"A-codegen;A-windows;E-easy;P-low,A-codegen;A-windows;E-easy;P-low",27416,2015-07-31T02:25:13Z,330,168,498
NULL,27424,2015-07-31T08:11:34Z,1,1,2
I-ICE,27432,2015-07-31T12:28:45Z,19,4,23
NULL,27436,2015-07-31T15:56:52Z,0,0,0
NULL,27439,2015-07-31T17:44:33Z,189,54,243
A-docs;I-nominated,27444,2015-07-31T21:20:19Z,45,41,86
NULL,27453,2015-08-01T07:01:24Z,114,28,142
"A-frontend;E-easy;I-wrong,A-frontend;E-easy;I-wrong",27458,2015-08-01T18:33:02Z,260,145,405
A-docs,27460,2015-08-01T20:08:29Z,38,41,79
NULL,27461,2015-08-01T21:40:04Z,0,0,0
NULL,27470,2015-08-02T14:52:15Z,57,4,61
NULL,27476,2015-08-02T21:03:53Z,7,11,18
"A-dst;P-high,A-dst;P-high",27483,2015-08-03T02:39:37Z,0,0,0
NULL,27488,2015-08-03T05:07:15Z,74,6,80
beta-accepted;T-tools,27494,2015-08-03T14:02:04Z,38,23,61
A-rustdoc,27496,2015-08-03T15:41:01Z,0,0,0
A-rustdoc,27499,2015-08-03T18:57:50Z,57,1,58
NULL,27507,2015-08-03T23:17:16Z,55,15,70
A-docs,27508,2015-08-04T00:58:07Z,6,6,12
NULL,27509,2015-08-04T07:22:54Z,0,0,0
beta-accepted,27512,2015-08-04T12:30:54Z,127,79,206
A-io;A-runtime,27516,2015-08-04T16:05:05Z,4,0,4
A-docs,27519,2015-08-04T18:25:01Z,122,122,244
A-docs,27524,2015-08-04T20:43:57Z,5,1,6
A-docs,27525,2015-08-04T22:14:24Z,2,2,4
A-docs,27528,2015-08-05T01:07:22Z,3,2,5
NULL,27530,2015-08-05T08:15:39Z,151,148,299
"A-docs,A-docs",27533,2015-08-05T16:16:30Z,3,0,3
"A-debuginfo,A-debuginfo",27534,2015-08-05T16:23:26Z,0,188,188
"A-docs,A-docs",27536,2015-08-05T16:58:42Z,38,0,38
"A-docs,A-docs",27538,2015-08-05T17:24:21Z,12,2,14
NULL,27539,2015-08-05T17:45:34Z,60,0,60
NULL,27540,2015-08-05T18:34:49Z,0,0,0
A-docs,27542,2015-08-05T18:51:33Z,53,0,53
NULL,27544,2015-08-05T19:09:51Z,168,19,187
NULL,27546,2015-08-05T19:31:08Z,23,1,24
"A-resolve;I-wrong;P-low,A-resolve;I-wrong;P-low",27547,2015-08-05T20:08:20Z,138,15,153
NULL,27557,2015-08-06T06:12:57Z,25,1,26
NULL,27565,2015-08-06T16:36:49Z,78,0,78
NULL,27571,2015-08-06T22:02:16Z,22,6,28
"I-nominated;T-compiler,I-nominated;T-compiler",27582,2015-08-07T14:41:25Z,39,3,42
"A-diagnostics;A-parser;A-syntaxext;I-cleanup,A-diagnostics;A-parser;A-syntaxext;I-cleanup",27584,2015-08-07T14:55:32Z,54,29,83
NULL,27586,2015-08-07T21:52:57Z,185,7,192
A-libs;B-RFC-approved,27588,2015-08-07T22:41:56Z,140,0,140
A-diagnostics;E-easy,27596,2015-08-08T07:03:30Z,6,3,9
NULL,27605,2015-08-08T16:40:10Z,54,1,55
"A-io,A-io;A-libs",27609,2015-08-08T21:14:01Z,0,0,0
A-concurrency;A-libs,27615,2015-08-09T15:09:15Z,23,0,23
NULL,27617,2015-08-09T15:45:58Z,37,2,39
A-libs,27624,2015-08-10T01:54:30Z,23,2,25
NULL,27625,2015-08-10T04:29:16Z,3,2,5
NULL,27634,2015-08-10T11:55:46Z,0,1,1
NULL,27638,2015-08-10T15:27:30Z,1,2,3
NULL,27641,2015-08-10T19:21:46Z,4732,651,5383
NULL,27644,2015-08-10T19:54:28Z,16,1,17
NULL,27647,2015-08-10T21:53:07Z,1,1,2
beta-nominated,27649,2015-08-10T22:27:45Z,94,6,100
NULL,27650,2015-08-10T23:08:07Z,11,1,12
A-libs;E-easy;E-mentor;I-slow,27652,2015-08-10T23:28:55Z,215,0,215
B-unstable;E-easy;final-comment-period;T-libs,27655,2015-08-11T02:22:02Z,0,0,0
T-libs,27657,2015-08-11T02:48:51Z,0,0,0
beta-nominated,27658,2015-08-11T07:56:48Z,159,16,175
NULL,27662,2015-08-11T13:00:39Z,0,0,0
"I-needs-decision;T-libs,I-needs-decision;T-libs",27668,2015-08-11T18:40:13Z,71,82,153
NULL,27672,2015-08-11T19:16:21Z,2,2,4
NULL,27674,2015-08-11T19:58:56Z,5,3,8
"relnotes,A-windows",27676,2015-08-11T21:15:03Z,55,23,78
NULL,27682,2015-08-12T01:40:48Z,2,2,4
NULL,27689,2015-08-12T05:52:46Z,38,22,60
"A-windows,A-windows",27690,2015-08-12T06:21:40Z,1,1,2
"A-macros;I-ICE,A-macros;I-ICE",27691,2015-08-12T08:38:02Z,21,1,22
NULL,27698,2015-08-12T17:00:53Z,33,0,33
NULL,27699,2015-08-12T17:11:56Z,21,1,22
NULL,27757,2015-08-12T19:49:45Z,71,2,73
NULL,27758,2015-08-12T19:53:20Z,30,1,31
B-unstable;T-libs,27760,2015-08-12T21:46:51Z,0,0,0
NULL,27803,2015-08-13T08:47:07Z,372,113,485
"A-allocators;I-slow,A-libs;I-slow",27807,2015-08-13T16:00:37Z,577,227,804
"B-unstable;T-libs,B-unstable;T-libs",27808,2015-08-13T16:48:59Z,293,171,464
NULL,27816,2015-08-13T19:42:11Z,1,1,2
A-libs,27818,2015-08-13T20:09:28Z,752,539,1291
I-compiletime;T-compiler,27822,2015-08-13T21:26:41Z,1,0,1
A-macros,27827,2015-08-14T05:40:45Z,20,10,30
I-ICE,27833,2015-08-14T13:15:21Z,257,298,555
A-libs,27835,2015-08-14T13:47:30Z,0,0,0
B-unstable;E-easy;final-comment-period;T-libs,27836,2015-08-14T17:32:48Z,28,5,33
B-unstable;T-libs,27837,2015-08-14T19:07:15Z,239,161,400
NULL,27838,2015-08-14T19:20:35Z,36,1,37
A-bsd;A-build,27839,2015-08-14T19:27:54Z,1,1,2
NULL,27846,2015-08-15T09:05:15Z,19,1,20
NULL,27858,2015-08-16T14:51:31Z,8,2,10
A-rustdoc;E-easy,27860,2015-08-16T20:39:17Z,125,62,187
NULL,27864,2015-08-17T13:36:34Z,51,0,51
B-unstable;T-lang;T-libs,27866,2015-08-17T17:34:26Z,86,24,110
NULL,27867,2015-08-17T19:36:31Z,0,0,0
B-unstable;T-libs,27871,2015-08-17T21:33:18Z,244,461,705
NULL,27875,2015-08-18T00:06:54Z,65,1,66
NULL,27880,2015-08-18T14:03:57Z,0,3,3
A-docs,27883,2015-08-18T17:45:19Z,5,0,5
A-docs,27884,2015-08-18T17:49:11Z,22,0,22
A-docs;E-easy,27885,2015-08-18T17:54:09Z,3,0,3
A-docs,27888,2015-08-18T17:59:13Z,3,2,5
NULL,27891,2015-08-18T19:03:12Z,118,7,125
NULL,27892,2015-08-18T21:49:10Z,925,116,1041
"A-docs,A-docs",27894,2015-08-18T22:37:58Z,78,8,86
"B-unstable;E-easy;final-comment-period;T-libs,B-unstable;E-easy;final-comment-period;T-libs",27900,2015-08-19T15:34:34Z,24,0,24
"A-rustdoc,A-rustdoc",27919,2015-08-20T17:33:10Z,24,1,25
"A-libs;P-medium,A-libs;P-medium",27930,2015-08-21T10:21:51Z,59,23,82
NULL,27939,2015-08-22T06:33:04Z,0,0,0
"A-rustdoc,A-rustdoc",27945,2015-08-22T20:14:03Z,62,37,99
NULL,27947,2015-08-22T23:15:44Z,21,18,39
"A-libs;I-wrong,A-libs;I-wrong,A-libs;I-wrong,A-libs;I-wrong",27948,2015-08-23T00:13:31Z,5,1,6
"A-concurrency;A-libs,A-concurrency;A-libs",27966,2015-08-23T20:30:47Z,34,0,34
"A-io;A-libs,A-io;A-libs",27971,2015-08-24T00:01:46Z,25,1,26
"A-infrastructure;A-windows,A-infrastructure;A-windows",27974,2015-08-24T03:57:08Z,15,2,17
"B-unstable;T-libs,B-unstable;T-libs",27975,2015-08-24T05:05:59Z,238,115,353
NULL,27976,2015-08-24T06:01:19Z,17,1,18
"A-io;A-libs,A-io;A-libs",27980,2015-08-24T19:40:22Z,31,6,37
"A-frontend,A-frontend",27983,2015-08-24T21:32:27Z,82,75,157
"A-docs;E-easy,A-docs;E-easy",27988,2015-08-24T22:45:22Z,1,3,4
NULL,27991,2015-08-25T02:05:18Z,91,25,116
NULL,27992,2015-08-25T03:30:06Z,224,67,291
NULL,27994,2015-08-25T13:43:08Z,72,9,81
NULL,28000,2015-08-25T17:03:41Z,5,1,6
NULL,28017,2015-08-26T14:35:00Z,0,0,0
A-docs,28021,2015-08-26T17:59:37Z,6,5,11
A-docs,28022,2015-08-26T18:02:30Z,14,1,15
NULL,28023,2015-08-26T19:09:37Z,1,1,2
B-RFC-approved;I-nominated;T-libs,28034,2015-08-27T00:35:17Z,27,16,43
A-windows,28035,2015-08-27T02:15:24Z,15,4,19
NULL,28038,2015-08-27T06:29:09Z,8,5,13
NULL,28039,2015-08-27T07:05:10Z,81,1,82
T-libs,28043,2015-08-27T15:12:56Z,283,13,296
NULL,28051,2015-08-27T22:08:04Z,0,0,0
NULL,28052,2015-08-27T22:08:39Z,1652,838,2490
NULL,28060,2015-08-28T13:25:58Z,189,9,198
A-docs,28063,2015-08-28T15:43:29Z,5,3,8
NULL,28067,2015-08-28T16:58:28Z,19,0,19
I-wrong,28069,2015-08-28T17:55:46Z,34,17,51
NULL,28077,2015-08-28T22:33:00Z,149,127,276
A-docs,28083,2015-08-29T12:19:50Z,0,0,0
NULL,28086,2015-08-29T15:53:40Z,20,1,21
NULL,28087,2015-08-29T16:24:28Z,20,1,21
NULL,28094,2015-08-30T01:07:36Z,62,0,62
A-libs;E-easy;E-mentor;I-slow,28101,2015-08-30T16:02:28Z,46,0,46
NULL,28103,2015-08-30T16:38:15Z,59,1,60
NULL,28106,2015-08-30T18:45:01Z,23,1,24
NULL,28117,2015-08-31T05:57:02Z,2,2,4
NULL,28122,2015-08-31T11:02:13Z,1,0,1
NULL,28123,2015-08-31T12:04:17Z,32,0,32
B-unstable;T-libs,28128,2015-08-31T15:56:58Z,0,0,0
A-windows,28130,2015-08-31T17:47:28Z,68,9,77
"A-closures;I-ICE,I-ICE,I-ICE",28131,2015-08-31T19:38:21Z,73,1,74
A-amusing,28132,2015-08-31T20:55:00Z,1,115,116
NULL,28164,2015-09-02T14:38:06Z,31,1,32
NULL,28165,2015-09-02T16:25:40Z,1,0,1
NULL,28174,2015-09-02T22:04:39Z,1,0,1
A-diagnostics,28175,2015-09-02T22:07:23Z,1,2,3
"I-ICE,I-ICE",28190,2015-09-03T10:37:53Z,31,9,40
NULL,28195,2015-09-03T16:02:46Z,15,1,16
B-unstable;E-easy;final-comment-period;T-libs,28198,2015-09-03T17:40:17Z,5,8,13
NULL,28199,2015-09-03T17:59:33Z,0,0,0
NULL,28200,2015-09-03T18:00:39Z,878,764,1642
NULL,28201,2015-09-03T18:43:54Z,93,50,143
A-docs,28216,2015-09-03T21:40:34Z,0,10,10
NULL,28220,2015-09-04T00:10:10Z,14871,5279,20150
NULL,28234,2015-09-04T18:23:38Z,18,1,19
T-lang,28246,2015-09-04T23:38:53Z,145,110,255
A-amusing,28247,2015-09-04T23:58:17Z,17,1,18
A-libs,28248,2015-09-05T02:18:02Z,27,15,42
A-docs,28250,2015-09-05T03:09:20Z,52,0,52
A-bsd;A-x86_64,28254,2015-09-05T05:01:12Z,0,0,0
NULL,28258,2015-09-05T10:46:02Z,1750,377,2127
NULL,28268,2015-09-06T11:52:00Z,71,69,140
NULL,28269,2015-09-06T13:14:41Z,19,17,36
B-RFC-approved,28270,2015-09-06T13:15:18Z,234,40,274
NULL,28297,2015-09-08T15:51:09Z,28,16,44
"I-ICE,I-ICE,A-associated-items;I-wrong,A-associated-items;I-wrong,I-ICE,A-associated-items;I-wrong,I-ICE,A-associated-items;I-wrong,I-ICE,A-associated-items;I-wrong",28299,2015-09-08T18:21:08Z,208,0,208
NULL,28300,2015-09-08T18:24:27Z,138,12,150
NULL,28304,2015-09-08T21:40:04Z,0,0,0
NULL,28311,2015-09-09T05:46:27Z,0,0,0
NULL,28313,2015-09-09T09:59:35Z,1,1,2
NULL,28316,2015-09-09T13:06:12Z,10,108,118
"I-nominated;T-lang,I-nominated;T-lang,I-nominated;T-lang,I-nominated;T-lang,I-nominated;T-lang,I-nominated;T-lang",28321,2015-09-09T20:08:51Z,35,11,46
NULL,28332,2015-09-10T15:27:52Z,156,0,156
NULL,28336,2015-09-10T19:49:24Z,187,124,311
NULL,28337,2015-09-10T20:06:17Z,13,0,13
"B-unstable;E-easy;final-comment-period;T-libs,B-unstable;E-easy;final-comment-period;T-libs,B-unstable;E-easy;final-comment-period;T-libs,A-io;B-unstable;E-easy;final-comment-period;T-libs,A-libs,B-unstable;T-libs,B-unstable;E-easy;final-comment-period;T-libs,B-unstable;E-easy;final-comment-period;T-libs,B-unstable;E-easy;final-comment-period;T-libs,B-unstable;E-easy;final-comment-period;T-libs,B-unstable;E-easy;final-comment-period;T-libs,B-unstable;E-easy;final-comment-period;T-libs,B-unstable;E-easy;final-comment-period;T-libs,B-unstable;E-easy;final-comment-period;T-libs,B-unstable;E-easy;final-comment-period;T-libs,B-unstable;E-easy;final-comment-period;T-libs,A-io;B-unstable;E-easy;final-comment-period;T-libs,A-libs,B-unstable;T-libs,B-unstable;E-easy;final-comment-period;T-libs,B-unstable;E-easy;final-comment-period;T-libs,B-unstable;E-easy;final-comment-period;T-libs,B-unstable;E-easy;final-comment-period;T-libs,B-unstable;E-easy;final-comment-period;T-libs,B-unstable;E-easy;final-comment-period;T-libs,B-unstable;E-easy;final-comment-period;T-libs,B-unstable;E-easy;final-comment-period;T-libs,B-unstable;E-easy;final-comment-period;T-libs,A-libs,B-unstable;E-easy;final-comment-period;T-libs,B-unstable;E-easy;final-comment-period;T-libs,B-unstable;E-easy;final-comment-period;T-libs,A-io;B-unstable;E-easy;final-comment-period;T-libs,B-unstable;T-libs,B-unstable;E-easy;final-comment-period;T-libs,B-unstable;E-easy;final-comment-period;T-libs,B-unstable;E-easy;final-comment-period;T-libs,B-unstable;E-easy;final-comment-period;T-libs,B-unstable;E-easy;final-comment-period;T-libs,B-unstable;E-easy;final-comment-period;T-libs,B-unstable;E-easy;final-comment-period;T-libs,B-unstable;E-easy;final-comment-period;T-libs,B-unstable;E-easy;final-comment-period;T-libs,B-unstable;E-easy;final-comment-period;T-libs,B-unstable;E-easy;final-comment-period;T-libs,B-unstable;E-easy;final-comment-period;T-libs,A-io;B-unstable;E-easy;final-comment-period;T-libs,B-unstable;T-libs,B-unstable;E-easy;final-comment-period;T-libs,B-unstable;E-easy;final-comment-period;T-libs,B-unstable;E-easy;final-comment-period;T-libs,B-unstable;E-easy;final-comment-period;T-libs,B-unstable;E-easy;final-comment-period;T-libs,B-unstable;E-easy;final-comment-period;T-libs,B-unstable;E-easy;final-comment-period;T-libs,B-unstable;E-easy;final-comment-period;T-libs,B-unstable;E-easy;final-comment-period;T-libs,B-unstable;E-easy;final-comment-period;T-libs,B-unstable;E-easy;final-comment-period;T-libs,B-unstable;E-easy;final-comment-period;T-libs,B-unstable;E-easy;final-comment-period;T-libs,A-io;B-unstable;E-easy;final-comment-period;T-libs,A-libs,B-unstable;T-libs,B-unstable;E-easy;final-comment-period;T-libs,B-unstable;E-easy;final-comment-period;T-libs,B-unstable;E-easy;final-comment-period;T-libs,B-unstable;E-easy;final-comment-period;T-libs,B-unstable;E-easy;final-comment-period;T-libs,B-unstable;E-easy;final-comment-period;T-libs,B-unstable;E-easy;final-comment-period;T-libs,B-unstable;E-easy;final-comment-period;T-libs,B-unstable;E-easy;final-comment-period;T-libs,B-unstable;E-easy;final-comment-period;T-libs,B-unstable;E-easy;final-comment-period;T-libs,A-libs,B-unstable;E-easy;final-comment-period;T-libs,B-unstable;E-easy;final-comment-period;T-libs,B-unstable;E-easy;final-comment-period;T-libs,B-unstable;E-easy;final-comment-period;T-libs,B-unstable;E-easy;final-comment-period;T-libs,B-unstable;E-easy;final-comment-period;T-libs,B-unstable;E-easy;final-comment-period;T-libs,B-unstable;E-easy;final-comment-period;T-libs,B-unstable;E-easy;final-comment-period;T-libs,A-libs,B-unstable;E-easy;final-comment-period;T-libs,B-unstable;E-easy;final-comment-period;T-libs,B-unstable;E-easy;final-comment-period;T-libs,B-unstable;E-easy;final-comment-period;T-libs,A-io;B-unstable;E-easy;final-comment-period;T-libs,B-unstable;T-libs,B-unstable;E-easy;final-comment-period;T-libs,B-unstable;E-easy;final-comment-period;T-libs,B-unstable;E-easy;final-comment-period;T-libs,B-unstable;E-easy;final-comment-period;T-libs,B-unstable;E-easy;final-comment-period;T-libs,B-unstable;E-easy;final-comment-period;T-libs,B-unstable;E-easy;final-comment-period;T-libs,B-unstable;E-easy;final-comment-period;T-libs,B-unstable;E-easy;final-comment-period;T-libs,B-unstable;E-easy;final-comment-period;T-libs",28339,2015-09-10T20:54:44Z,121,140,261
NULL,28346,2015-09-11T03:14:21Z,0,0,0
"I-compiletime,I-compiletime,I-compiletime,I-compiletime,I-compiletime,I-compiletime",28354,2015-09-11T14:43:51Z,3,0,3
"E-easy;I-nominated;T-libs,E-easy;I-nominated;T-libs,E-easy;I-nominated;T-libs,E-easy;I-nominated;T-libs",28364,2015-09-11T22:09:04Z,209,58,267
"A-lifetimes,A-lifetimes,A-lifetimes,A-lifetimes",28369,2015-09-12T05:07:59Z,36,3,39
"I-compiletime,I-compiletime,I-compiletime,I-compiletime",28370,2015-09-12T07:30:44Z,10,1,11
"A-libs,A-libs,A-libs,A-libs,A-libs",28375,2015-09-12T14:27:19Z,3,8,11
"A-dst;P-high,A-dst;P-high,A-dst;P-high,B-RFC-approved,A-dst;P-high,B-RFC-approved,A-dst;P-high,A-dst;P-high,A-dst;P-high,B-RFC-approved,A-dst;P-high,B-RFC-approved",28381,2015-09-13T01:29:57Z,82,2,84
"I-ICE,I-ICE,I-ICE,I-ICE,I-ICE,I-ICE",28392,2015-09-13T18:00:19Z,59,11,70
"A-diagnostics,A-diagnostics,A-diagnostics,A-diagnostics,A-diagnostics",28393,2015-09-13T19:45:31Z,46,41,87
NULL,28395,2015-09-13T20:17:21Z,94,12,106
NULL,28396,2015-09-13T20:43:14Z,66,33,99
NULL,28400,2015-09-14T11:55:21Z,2,1,3
NULL,28406,2015-09-14T22:10:02Z,18,2,20
NULL,28414,2015-09-15T10:32:55Z,0,0,0
NULL,28417,2015-09-15T14:14:56Z,18,0,18
"A-docs,A-docs,A-docs,A-docs",28420,2015-09-15T14:55:49Z,5,6,11
NULL,28421,2015-09-15T16:47:00Z,155,78,233
NULL,28423,2015-09-15T18:01:01Z,0,0,0
"beta-accepted,beta-accepted,beta-accepted,beta-accepted",28425,2015-09-15T21:01:46Z,206,0,206
"A-lint;E-easy;I-cleanup,A-lint;E-easy;I-cleanup",28429,2015-09-16T00:27:20Z,859,799,1658
A-frontend;I-ICE,28430,2015-09-16T00:39:54Z,20,1,21
A-docs,28432,2015-09-16T08:19:54Z,2,2,4
I-ICE,28435,2015-09-16T10:50:57Z,32,0,32
relnotes,28436,2015-09-16T12:10:30Z,50,23,73
A-frontend;A-resolve;I-wrong,28440,2015-09-16T16:46:26Z,0,0,0
T-lang,28442,2015-09-16T17:13:57Z,15,51,66
NULL,28444,2015-09-16T18:27:05Z,0,0,0
NULL,28459,2015-09-17T13:34:46Z,40,0,40
A-docs,28462,2015-09-17T15:07:35Z,0,0,0
A-docs,28463,2015-09-17T15:09:00Z,28,31,59
A-docs,28464,2015-09-17T15:10:32Z,0,0,0
NULL,28468,2015-09-17T20:12:13Z,15,14,29
NULL,28476,2015-09-17T21:06:57Z,2856,3397,6253
"A-parser;I-wrong;P-high;T-lang,A-parser;I-wrong;P-high;T-lang",28486,2015-09-18T06:09:07Z,30,5,35
A-libs;regression-from-stable-to-stable,28494,2015-09-18T14:35:07Z,40,1,41
A-collections;T-libs,28497,2015-09-18T18:27:45Z,59,1,60
NULL,28501,2015-09-18T21:08:34Z,8,0,8
NULL,28503,2015-09-18T22:28:47Z,28,7,35
NULL,28504,2015-09-19T00:10:25Z,53,6,59
A-linkage;E-easy,28505,2015-09-19T02:29:02Z,9,14,23
A-diagnostics,28507,2015-09-19T04:00:13Z,26,6,32
NULL,28511,2015-09-19T07:04:56Z,8,0,8
E-easy,28512,2015-09-19T08:06:35Z,1,0,1
NULL,28516,2015-09-19T15:15:49Z,1649,886,2535
relnotes,28519,2015-09-19T18:02:57Z,1,1,2
A-attributes;A-stability;E-easy;I-nominated;T-compiler,28522,2015-09-19T20:36:40Z,135,5,140
relnotes,28529,2015-09-20T05:46:28Z,215,67,282
NULL,28531,2015-09-20T08:07:56Z,9,3,12
NULL,28534,2015-09-20T12:08:26Z,1,1,2
"A-parser;A-resolve;A-syntaxext;I-cleanup,A-parser;A-resolve;A-syntaxext;I-cleanup",28535,2015-09-20T13:58:22Z,485,473,958
NULL,28543,2015-09-20T17:46:35Z,603,68,671
A-docs,28548,2015-09-20T19:52:20Z,1,1,2
A-refactor;E-easy;E-mentor,28552,2015-09-20T20:17:14Z,114,139,253
I-wrong;regression-from-stable-to-beta,28560,2015-09-21T08:52:40Z,7,0,7
NULL,28564,2015-09-21T14:37:39Z,0,0,0
A-testsuite;E-easy;I-enhancement,28565,2015-09-21T14:44:02Z,120,0,120
A-linkage;A-llvm,28567,2015-09-21T15:36:39Z,14,2,16
A-rustdoc,28574,2015-09-21T19:56:40Z,1,1,2
A-lint;E-easy;I-cleanup,28580,2015-09-22T01:12:33Z,689,661,1350
A-io,28585,2015-09-22T09:27:28Z,5,83,88
A-build;A-infrastructure,28589,2015-09-22T16:16:55Z,0,0,0
NULL,28596,2015-09-23T02:59:05Z,21,2,23
NULL,28598,2015-09-23T04:44:47Z,3,1,4
A-linkage,28605,2015-09-23T16:31:16Z,72,49,121
NULL,28612,2015-09-24T00:58:28Z,95,3,98
A-docs;A-io,28613,2015-09-24T01:43:36Z,0,0,0
B-unstable;T-libs,28615,2015-09-24T06:40:13Z,29,7,36
I-ICE,28626,2015-09-24T14:03:56Z,33,1,34
I-ICE,28629,2015-09-24T15:28:38Z,80,13,93
A-io,28631,2015-09-24T15:49:51Z,54,41,95
B-unstable;T-libs,28632,2015-09-24T15:52:31Z,44,52,96
NULL,28633,2015-09-24T16:16:41Z,0,0,0
NULL,28634,2015-09-24T16:26:38Z,48,28,76
B-unstable;T-libs,28635,2015-09-24T16:41:43Z,22,2,24
NULL,28636,2015-09-24T16:45:58Z,0,0,0
"A-parser;A-resolve;A-syntaxext;I-cleanup,A-parser;A-resolve;A-syntaxext;I-cleanup",28642,2015-09-24T21:49:18Z,335,399,734
A-windows,28646,2015-09-25T04:58:30Z,99,31,130
NULL,28649,2015-09-25T05:16:54Z,112,139,251
"A-attributes;I-completion,A-attributes;I-completion",28650,2015-09-25T06:34:23Z,182,13,195
B-unstable;E-easy;T-libs,28652,2015-09-25T11:01:40Z,2,2,4
A-associated-items,28656,2015-09-25T13:05:35Z,0,0,0
A-io,28661,2015-09-25T15:36:38Z,0,0,0
A-libs;I-slow,28662,2015-09-25T15:48:54Z,47,11,58
A-libs,28663,2015-09-25T15:50:54Z,14,0,14
NULL,28665,2015-09-25T19:33:33Z,34,38,72
NULL,28669,2015-09-26T00:03:55Z,206,10,216
A-diagnostics,28672,2015-09-26T02:55:59Z,37,9,46
NULL,28681,2015-09-26T20:15:18Z,172,84,256
NULL,28685,2015-09-27T00:00:39Z,26,16,42
A-resolve;I-ICE,28686,2015-09-27T02:21:13Z,31,2,33
NULL,28689,2015-09-27T09:35:18Z,499,230,729
I-ICE,28702,2015-09-28T05:05:55Z,42,2,44
NULL,28703,2015-09-28T13:02:10Z,35,0,35
A-docs,28705,2015-09-28T15:47:53Z,2,3,5
NULL,28707,2015-09-28T17:41:09Z,20,0,20
relnotes,28715,2015-09-28T21:32:01Z,552,713,1265
A-build,28717,2015-09-28T22:04:40Z,16,2,18
B-unstable;T-libs,28722,2015-09-29T03:26:12Z,0,0,0
A-rustdoc;I-enhancement,28725,2015-09-29T04:40:59Z,0,0,0
A-io;B-unstable;T-libs,28729,2015-09-29T13:43:46Z,11,0,11
NULL,28730,2015-09-29T14:20:21Z,26,0,26
NULL,28732,2015-09-29T15:49:37Z,2,2,4
A-docs,28743,2015-09-30T00:45:11Z,91,8,99
"A-book;A-docs,B-unstable;T-libs",28753,2015-09-30T15:56:02Z,20,18,38
NULL,28755,2015-09-30T16:40:19Z,2,2,4
A-docs,28757,2015-09-30T16:43:38Z,2,0,2
NULL,28758,2015-09-30T17:01:24Z,93,11,104
"A-book;A-docs,B-unstable;T-libs",28759,2015-09-30T17:21:56Z,8,3,11
A-docs,28760,2015-09-30T17:24:37Z,1,1,2
A-docs,28761,2015-09-30T17:31:16Z,2,0,2
A-docs,28762,2015-09-30T17:35:27Z,7,0,7
A-docs,28763,2015-09-30T17:39:52Z,4,1,5
A-docs,28764,2015-09-30T17:43:04Z,7,2,9
A-docs,28765,2015-09-30T17:47:01Z,29,0,29
NULL,28767,2015-09-30T18:12:25Z,0,0,0
NULL,28768,2015-09-30T18:14:41Z,194,145,339
NULL,28769,2015-09-30T18:51:56Z,130,37,167
NULL,28781,2015-09-30T22:19:30Z,0,0,0
NULL,28782,2015-09-30T22:20:05Z,33,26,59
NULL,28789,2015-10-01T12:37:12Z,0,28,28
NULL,28790,2015-10-01T13:07:55Z,18,3,21
NULL,28791,2015-10-01T15:26:15Z,19,0,19
I-needs-decision;T-libs,28797,2015-10-01T19:55:04Z,75,0,75
NULL,28798,2015-10-01T20:16:14Z,0,0,0
beta-nominated;T-libs,28802,2015-10-01T22:59:29Z,149,32,181
NULL,28807,2015-10-02T07:37:23Z,155,9,164
NULL,28811,2015-10-02T16:01:41Z,20,0,20
A-lang,28816,2015-10-02T21:48:53Z,845,894,1739
I-nominated;T-libs,28818,2015-10-02T22:42:34Z,6,1,7
NULL,28820,2015-10-03T00:38:23Z,490,182,672
A-parser,28823,2015-10-03T09:47:12Z,31,15,46
NULL,28825,2015-10-03T15:05:42Z,52,2,54
A-libs;I-needs-decision;P-low;T-libs,28826,2015-10-03T15:36:29Z,49,40,89
A-diagnostics,28833,2015-10-04T10:02:16Z,38,8,46
"A-diagnostics;E-easy;I-cleanup;I-completion;P-low,A-diagnostics;E-easy;I-cleanup;I-completion;P-low",28841,2015-10-05T00:23:41Z,17,1,18
NULL,28856,2015-10-06T02:28:24Z,24,21,45
B-RFC-approved;P-high,28861,2015-10-06T12:18:07Z,770,103,873
NULL,28873,2015-10-06T20:51:41Z,25,5,30
NULL,28875,2015-10-07T00:58:06Z,0,0,0
NULL,28876,2015-10-07T02:01:22Z,9,9,18
NULL,28886,2015-10-07T14:10:41Z,0,0,0
A-parser,28887,2015-10-07T16:29:31Z,8,7,15
A-docs,28893,2015-10-07T20:41:25Z,25,0,25
NULL,28897,2015-10-07T22:18:38Z,85,49,134
A-an-interesting-project;A-frontend;E-easy,28902,2015-10-08T00:01:32Z,0,0,0
NULL,28911,2015-10-08T14:08:18Z,0,0,0
NULL,28913,2015-10-08T17:54:05Z,467,269,736
T-lang,28919,2015-10-08T23:11:03Z,2,2,4
A-llvm,28920,2015-10-08T23:28:38Z,101,16,117
NULL,28929,2015-10-09T16:05:37Z,480,46,526
NULL,28930,2015-10-09T16:07:12Z,158,154,312
NULL,28931,2015-10-09T18:57:31Z,0,0,0
NULL,28932,2015-10-09T19:44:37Z,20,2,22
NULL,28938,2015-10-10T00:06:31Z,17,0,17
NULL,28948,2015-10-10T17:36:15Z,3,3,6
NULL,28960,2015-10-11T00:40:12Z,9,2,11
NULL,28963,2015-10-11T03:23:29Z,10,7,17
NULL,28991,2015-10-12T10:43:59Z,114,88,202
A-dst;I-ICE,28993,2015-10-12T13:44:45Z,17,0,17
NULL,29001,2015-10-12T18:55:13Z,36,7,43
NULL,29003,2015-10-12T19:00:20Z,4,4,8
A-macros;I-nominated,29004,2015-10-12T19:41:14Z,22,0,22
NULL,29006,2015-10-12T20:52:25Z,28,1,29
A-windows,29012,2015-10-13T01:28:44Z,45,1,46
NULL,29013,2015-10-13T02:27:38Z,1,1,2
NULL,29026,2015-10-13T17:09:54Z,140,113,253
"E-easy;E-mentor,E-easy;E-mentor",29031,2015-10-13T21:01:32Z,233,0,233
NULL,29039,2015-10-14T04:23:42Z,515,272,787
NULL,29050,2015-10-14T17:56:22Z,18,1,19
NULL,29066,2015-10-15T00:26:28Z,7,7,14
NULL,29069,2015-10-15T02:14:49Z,0,0,0
NULL,29070,2015-10-15T08:11:34Z,137,134,271
NULL,29072,2015-10-15T13:02:45Z,525,223,748
A-build,29079,2015-10-15T19:19:20Z,11,20,31
NULL,29080,2015-10-15T19:38:58Z,0,66,66
NULL,29083,2015-10-15T21:18:40Z,633,168,801
A-docs,29090,2015-10-16T00:53:37Z,0,0,0
NULL,29091,2015-10-16T01:55:42Z,28,3,31
B-unstable;T-libs,29098,2015-10-16T10:22:40Z,0,0,0
A-lint;E-easy,29099,2015-10-16T11:34:07Z,0,0,0
A-lint;E-easy,29100,2015-10-16T12:28:09Z,0,0,0
NULL,29102,2015-10-16T14:21:23Z,12,11,23
A-lint;E-easy,29109,2015-10-16T20:51:32Z,28,9,37
NULL,29110,2015-10-16T21:54:56Z,148,12,160
"beta-nominated;relnotes;T-lang,beta-nominated;relnotes;T-lang,beta-nominated;relnotes;T-lang,relnotes",29112,2015-10-16T22:50:10Z,344,108,452
A-typesystem,29114,2015-10-17T01:33:07Z,24,0,24
NULL,29117,2015-10-17T09:26:00Z,261,145,406
NULL,29134,2015-10-18T04:00:12Z,15,3,18
NULL,29139,2015-10-18T09:25:07Z,0,0,0
NULL,29141,2015-10-18T12:47:12Z,2,2,4
A-debuginfo,29144,2015-10-18T14:42:04Z,7,3,10
NULL,29148,2015-10-18T16:16:01Z,19,17,36
NULL,29152,2015-10-18T23:09:27Z,1,1,2
NULL,29153,2015-10-19T00:08:42Z,16,23,39
NULL,29155,2015-10-19T04:03:09Z,9,0,9
NULL,29158,2015-10-19T04:56:26Z,1,1,2
NULL,29167,2015-10-19T15:13:39Z,0,0,0
NULL,29172,2015-10-19T21:14:09Z,299,104,403
NULL,29178,2015-10-20T03:52:45Z,0,0,0
NULL,29186,2015-10-20T12:56:37Z,31,0,31
NULL,29187,2015-10-20T13:43:48Z,12,11,23
A-lifetimes;I-nominated;regression-from-stable-to-nightly;T-compiler;T-lang,29188,2015-10-20T14:20:23Z,182,456,638
NULL,29190,2015-10-20T18:35:57Z,59,17,76
NULL,29192,2015-10-20T21:58:39Z,20,4,24
NULL,29196,2015-10-21T04:24:08Z,0,0,0
NULL,29204,2015-10-21T11:19:23Z,0,0,0
NULL,29206,2015-10-21T12:59:02Z,36,0,36
NULL,29210,2015-10-21T17:19:26Z,43,2,45
NULL,29214,2015-10-21T20:23:52Z,0,0,0
A-parser,29215,2015-10-21T21:35:33Z,10,10,20
NULL,29218,2015-10-21T22:52:15Z,0,0,0
NULL,29220,2015-10-21T23:56:32Z,0,0,0
relnotes,29222,2015-10-22T01:40:21Z,0,0,0
NULL,29224,2015-10-22T02:33:51Z,1,1,2
A-build,29229,2015-10-22T08:57:36Z,7,0,7
NULL,29232,2015-10-22T13:13:01Z,0,0,0
NULL,29236,2015-10-22T16:43:25Z,25,21,46
A-linkage;A-plugin,29237,2015-10-22T18:48:20Z,19,1,20
NULL,29240,2015-10-22T22:34:44Z,0,0,0
NULL,29241,2015-10-22T22:44:06Z,114,14,128
NULL,29243,2015-10-23T00:16:52Z,35,1,36
"B-unstable;T-libs,B-unstable;T-libs,B-unstable;T-libs,B-unstable;T-libs,B-unstable;E-easy;T-libs,B-unstable;T-libs,A-io;B-unstable;T-libs,B-unstable;T-libs,B-unstable;T-libs,B-unstable;E-easy;T-libs,A-io;B-unstable;T-libs,A-io;B-unstable;E-easy;T-libs,B-unstable;T-libs,B-unstable;T-libs,B-unstable;T-libs,B-unstable;E-easy;T-libs,B-unstable;E-easy;T-libs",29254,2015-10-23T16:41:33Z,274,195,469
NULL,29259,2015-10-23T21:24:03Z,36,10,46
NULL,29260,2015-10-23T21:57:02Z,60,4,64
NULL,29261,2015-10-24T00:16:13Z,15,0,15
NULL,29262,2015-10-24T01:32:20Z,115,15,130
NULL,29264,2015-10-24T01:37:09Z,8,5,13
I-ICE,29284,2015-10-24T21:33:08Z,203,0,203
NULL,29291,2015-10-25T02:51:54Z,217,143,360
NULL,29303,2015-10-25T15:38:34Z,90,124,214
NULL,29305,2015-10-25T17:24:42Z,62,56,118
NULL,29306,2015-10-25T17:31:33Z,2,4,6
NULL,29310,2015-10-25T20:24:09Z,9,6,15
NULL,29312,2015-10-25T21:48:32Z,51,0,51
NULL,29316,2015-10-26T03:55:55Z,605,404,1009
NULL,29325,2015-10-26T16:18:27Z,18,13,31
NULL,29326,2015-10-26T16:30:14Z,4,4,8
NULL,29327,2015-10-26T16:33:51Z,74,38,112
A-lang,29383,2015-10-26T18:19:10Z,192,127,319
I-ICE,29385,2015-10-26T19:59:11Z,0,0,0
NULL,29396,2015-10-27T07:41:58Z,0,0,0
A-build,29397,2015-10-27T10:25:15Z,2,1,3
NULL,29398,2015-10-27T12:13:56Z,30,7,37
"A-diagnostics,A-diagnostics",29404,2015-10-27T17:09:28Z,3,5,8
NULL,29405,2015-10-27T18:04:18Z,1,1,2
A-llvm;I-ICE,29409,2015-10-27T21:05:30Z,24,1,25
NULL,29412,2015-10-27T21:19:07Z,0,0,0
NULL,29425,2015-10-28T12:53:27Z,17,0,17
NULL,29435,2015-10-28T20:23:33Z,2,0,2
NULL,29439,2015-10-28T21:40:51Z,0,0,0
NULL,29443,2015-10-29T00:13:17Z,43,6,49
NULL,29444,2015-10-29T00:27:36Z,261,102,363
NULL,29447,2015-10-29T02:35:16Z,0,0,0
NULL,29448,2015-10-29T02:43:50Z,0,0,0
NULL,29456,2015-10-29T18:29:54Z,37,3,40
NULL,29463,2015-10-29T21:30:27Z,23,68,91
"I-needs-decision;T-libs,I-needs-decision;T-libs",29475,2015-10-30T15:27:18Z,42,19,61
NULL,29491,2015-10-31T16:43:12Z,56,8,64
NULL,29495,2015-10-31T23:16:44Z,24,6,30
NULL,29507,2015-11-01T19:45:34Z,5,6,11
NULL,29513,2015-11-01T22:56:11Z,16,0,16
NULL,29514,2015-11-01T23:05:48Z,14,0,14
NULL,29536,2015-11-03T10:06:54Z,26,4,30
NULL,29537,2015-11-03T12:24:37Z,22,0,22
A-inline-assembly;I-wrong,29543,2015-11-03T16:24:03Z,41,2,43
NULL,29545,2015-11-03T18:05:21Z,9,7,16
A-resolve;I-wrong,29547,2015-11-03T19:11:58Z,194,151,345
NULL,29565,2015-11-04T06:49:27Z,536,24,560
NULL,29568,2015-11-04T09:19:47Z,3,0,3
NULL,29569,2015-11-04T09:20:06Z,0,0,0
NULL,29571,2015-11-04T09:34:58Z,29,2,31
A-libs,29579,2015-11-04T11:44:18Z,2,0,2
NULL,29581,2015-11-04T12:54:51Z,53,51,104
NULL,29588,2015-11-04T20:46:08Z,319,74,393
NULL,29592,2015-11-04T22:35:51Z,183,457,640
NULL,29607,2015-11-05T08:32:50Z,0,0,0
NULL,29610,2015-11-05T11:43:03Z,3054,789,3843
NULL,29611,2015-11-05T13:04:26Z,3,153,156
NULL,29612,2015-11-05T13:33:20Z,4,1,5
NULL,29613,2015-11-05T13:40:53Z,27,49,76
NULL,29617,2015-11-05T14:57:56Z,23,3,26
NULL,29619,2015-11-05T15:46:43Z,14,3,17
NULL,29620,2015-11-05T15:56:21Z,85,55,140
A-docs,29622,2015-11-05T16:29:55Z,21,14,35
NULL,29626,2015-11-05T17:47:37Z,0,0,0
NULL,29647,2015-11-05T21:25:57Z,192,196,388
NULL,29648,2015-11-05T21:28:50Z,585,235,820
NULL,29650,2015-11-05T21:43:00Z,796,742,1538
NULL,29653,2015-11-06T00:44:42Z,14,9,23
A-docs,29660,2015-11-06T16:42:57Z,3,1,4
NULL,29666,2015-11-07T01:14:46Z,68,21,89
NULL,29670,2015-11-07T07:46:34Z,0,0,0
NULL,29676,2015-11-07T17:32:01Z,0,0,0
NULL,29677,2015-11-07T18:11:02Z,22,1,23
NULL,29681,2015-11-08T01:52:27Z,17,52,69
NULL,29695,2015-11-08T16:33:17Z,0,7,7
NULL,29700,2015-11-08T18:40:56Z,0,0,0
NULL,29715,2015-11-09T15:51:09Z,1,1,2
NULL,29724,2015-11-09T17:13:04Z,9,2,11
T-lang,29725,2015-11-09T17:18:47Z,59,45,104
NULL,29727,2015-11-09T18:37:39Z,41,4,45
A-docs,29732,2015-11-10T00:46:49Z,193,40,233
NULL,29734,2015-11-10T01:49:09Z,111,64,175
NULL,29735,2015-11-10T03:20:35Z,132,57,189
NULL,29736,2015-11-10T03:27:06Z,0,0,0
NULL,29738,2015-11-10T04:01:13Z,42,1,43
NULL,29748,2015-11-10T15:32:21Z,65,14,79
NULL,29749,2015-11-10T15:51:49Z,63,24,87
NULL,29752,2015-11-10T17:28:23Z,5,22,27
NULL,29755,2015-11-10T19:18:50Z,4,2,6
NULL,29759,2015-11-10T21:24:18Z,17,37,54
NULL,29763,2015-11-11T03:25:40Z,570,550,1120
NULL,29766,2015-11-11T13:33:00Z,150,154,304
NULL,29775,2015-11-11T17:59:35Z,38,42,80
A-mir;I-ICE;I-nominated;T-compiler,29776,2015-11-11T18:23:50Z,535,48,583
NULL,29778,2015-11-11T19:29:31Z,645,564,1209
NULL,29785,2015-11-11T22:00:59Z,115,96,211
NULL,29788,2015-11-11T23:11:42Z,40,1,41
NULL,29790,2015-11-12T00:08:14Z,0,0,0
NULL,29792,2015-11-12T02:32:05Z,0,0,0
NULL,29795,2015-11-12T07:48:52Z,670,149,819
NULL,29796,2015-11-12T09:14:34Z,9,0,9
A-docs,29805,2015-11-12T18:36:08Z,4,3,7
NULL,29809,2015-11-12T21:08:01Z,0,0,0
NULL,29815,2015-11-13T15:59:00Z,0,0,0
A-diagnostics,29827,2015-11-14T05:19:26Z,54,23,77
A-diagnostics;A-macros,29828,2015-11-14T10:56:52Z,83,50,133
"A-associated-items;I-ICE,I-ICE",29836,2015-11-14T20:29:42Z,114,56,170
NULL,29837,2015-11-14T21:30:45Z,211,1,212
NULL,29846,2015-11-15T05:58:25Z,8,7,15
NULL,29848,2015-11-15T13:30:35Z,0,0,0
"A-docs,A-docs",29860,2015-11-16T15:41:17Z,8,0,8
NULL,29863,2015-11-16T17:04:23Z,3,0,3
NULL,29872,2015-11-16T21:22:49Z,14472,16279,30751
NULL,29873,2015-11-16T21:51:45Z,16,7,23
NULL,29874,2015-11-16T21:57:21Z,18,0,18
NULL,29875,2015-11-16T21:59:09Z,1,2,3
NULL,29878,2015-11-16T23:57:31Z,7,2,9
NULL,29879,2015-11-17T01:49:56Z,0,0,0
E-easy,29882,2015-11-17T09:25:10Z,2,148,150
NULL,29883,2015-11-17T09:42:16Z,48,24,72
NULL,29888,2015-11-17T16:12:44Z,17,0,17
NULL,29889,2015-11-17T16:31:15Z,12,11,23
A-docs,29890,2015-11-17T16:42:05Z,2,1,3
NULL,29891,2015-11-17T16:54:31Z,11,4,15
A-docs,29892,2015-11-17T17:43:33Z,132,16,148
A-libs;B-RFC-approved,29894,2015-11-17T20:06:55Z,816,102,918
NULL,29899,2015-11-17T23:11:05Z,0,0,0
NULL,29900,2015-11-17T23:13:06Z,794,378,1172
NULL,29901,2015-11-17T23:34:59Z,25,19,44
NULL,29902,2015-11-17T23:35:05Z,17,0,17
NULL,29917,2015-11-18T21:27:09Z,1,1,2
A-traits;I-unsound;P-high;T-compiler,29934,2015-11-19T18:14:55Z,85,19,104
B-unstable;T-libs,29937,2015-11-19T19:37:32Z,462,45,507
A-rustdoc,29939,2015-11-19T22:06:29Z,57,5,62
NULL,29948,2015-11-20T09:16:50Z,7,0,7
NULL,29949,2015-11-20T10:19:41Z,164,2,166
NULL,29951,2015-11-20T11:20:23Z,20,6,26
B-RFC-approved,29952,2015-11-20T13:15:48Z,126,113,239
A-build,29955,2015-11-20T14:50:42Z,9,4,13
A-diagnostics;P-high,29962,2015-11-20T20:16:37Z,95,50,145
NULL,29964,2015-11-20T22:18:19Z,1,1,2
beta-nominated;T-compiler,29967,2015-11-21T00:02:33Z,65,14,79
A-diagnostics;A-tools;B-clarifying,29968,2015-11-21T09:39:33Z,76,30,106
"B-unstable;T-lang,P-high;T-compiler,P-high;T-lang",29973,2015-11-21T16:23:43Z,808,320,1128
NULL,29983,2015-11-22T11:14:06Z,4,2,6
"A-diagnostics;B-clarifying;E-easy;I-papercut,A-diagnostics;B-clarifying;E-easy;I-papercut",29989,2015-11-22T20:10:38Z,0,0,0
E-easy,29999,2015-11-23T09:42:51Z,545,698,1243
"A-typesystem;I-enhancement,A-typesystem;I-enhancement",30000,2015-11-23T13:57:55Z,64,4,68
NULL,30009,2015-11-23T19:58:31Z,48,0,48
"A-macros,A-diagnostics;A-macros;E-easy,A-macros",30011,2015-11-23T20:18:35Z,63,11,74
A-docs,30013,2015-11-23T21:56:05Z,80,14,94
"E-easy,E-easy",30015,2015-11-23T22:55:52Z,47,84,131
A-libs;B-RFC-approved,30016,2015-11-23T22:56:10Z,24,14,38
NULL,30021,2015-11-24T09:12:23Z,0,0,0
NULL,30024,2015-11-24T12:39:25Z,0,0,0
"A-attributes;A-parser;E-easy;I-completion,A-attributes;A-parser;E-easy;I-completion",30025,2015-11-24T12:45:08Z,0,0,0
NULL,30028,2015-11-24T14:43:47Z,50,117,167
A-docs,30030,2015-11-24T16:51:50Z,169,36,205
NULL,30036,2015-11-24T20:47:42Z,203,59,262
A-libs;I-crash;I-wrong,30040,2015-11-24T21:41:06Z,5,0,5
NULL,30044,2015-11-24T22:57:45Z,3711,139,3850
NULL,30049,2015-11-25T03:51:19Z,96,16,112
A-docs,30057,2015-11-25T17:36:45Z,622,257,879
"A-macros;I-ICE,I-ICE,A-macros;I-ICE",30060,2015-11-25T20:02:58Z,40,12,52
NULL,30064,2015-11-25T23:34:01Z,42,8,50
NULL,30071,2015-11-26T10:24:30Z,1,1,2
A-rustdoc;E-easy,30074,2015-11-26T18:41:56Z,30,2,32
"A-diagnostics,A-parser",30075,2015-11-26T20:44:24Z,9,5,14
NULL,30080,2015-11-27T03:49:49Z,4,4,8
NULL,30085,2015-11-27T15:47:31Z,32,20,52
A-docs;E-curated;E-easy,30100,2015-11-29T13:37:49Z,1,1,2
A-diagnostics;E-curated;E-easy;E-mentor,30102,2015-11-29T14:24:21Z,24,7,31
NULL,30103,2015-11-29T15:16:32Z,0,0,0
A-refactor;E-curated;E-easy,30105,2015-11-29T17:41:31Z,191,192,383
NULL,30113,2015-11-30T15:44:57Z,0,7,7
NULL,30116,2015-11-30T17:01:44Z,26,1,27
NULL,30118,2015-11-30T18:54:22Z,1,1,2
A-docs,30119,2015-11-30T19:35:52Z,20,2,22
A-docs,30120,2015-11-30T19:47:10Z,12,1,13
NULL,30121,2015-11-30T19:56:32Z,2,2,4
NULL,30122,2015-11-30T20:00:31Z,1,1,2
A-docs,30124,2015-11-30T20:48:56Z,98,8,106
NULL,30126,2015-11-30T23:02:23Z,42,19,61
A-docs;E-easy,30129,2015-12-01T02:15:39Z,6,6,12
NULL,30131,2015-12-01T03:12:07Z,0,0,0
"A-hir;A-macros;E-mentor,A-macros",30145,2015-12-01T18:32:27Z,170,86,256
A-docs,30146,2015-12-01T18:39:53Z,194,4,198
A-docs,30148,2015-12-01T21:09:27Z,294,94,388
A-rustdoc,30149,2015-12-01T21:33:35Z,84,10,94
NULL,30151,2015-12-01T22:02:17Z,0,0,0
NULL,30153,2015-12-01T23:18:28Z,16,9,25
NULL,30155,2015-12-02T00:01:42Z,69,44,113
A-iterators;I-crash;I-nominated;I-wrong;T-compiler,30165,2015-12-02T17:19:41Z,26,2,28
NULL,30166,2015-12-02T17:38:12Z,27,3,30
NULL,30177,2015-12-02T23:09:29Z,122,0,122
NULL,30184,2015-12-03T03:01:23Z,321,24,345
"B-unstable;T-libs,A-libs;B-RFC-approved,B-unstable;T-libs,E-easy;E-mentor,B-unstable;T-libs,B-unstable;T-libs,E-easy;E-mentor,B-unstable;T-libs,A-io;B-unstable;T-libs,A-io;B-unstable;T-libs,A-io;B-unstable;T-libs,B-unstable;T-libs",30187,2015-12-03T18:20:53Z,712,718,1430
NULL,30202,2015-12-04T14:35:55Z,41,11,52
B-RFC-approved,30206,2015-12-04T17:02:27Z,1003,137,1140
NULL,30208,2015-12-04T18:05:29Z,92,1,93
T-tools,30211,2015-12-04T21:17:55Z,44,1,45
NULL,30222,2015-12-05T13:25:14Z,8,23,31
NULL,30238,2015-12-06T16:11:41Z,0,0,0
I-nominated;regression-from-stable-to-beta,30242,2015-12-06T18:23:44Z,123,11,134
A-dst;I-wrong,30245,2015-12-06T23:06:04Z,365,63,428
NULL,30247,2015-12-06T23:34:28Z,26,28,54
NULL,30249,2015-12-07T00:41:26Z,0,0,0
A-debuginfo,30250,2015-12-07T01:51:00Z,0,0,0
NULL,30263,2015-12-08T12:57:18Z,4,0,4
A-libs;I-wrong,30267,2015-12-08T15:25:55Z,67,1,68
NULL,30269,2015-12-08T16:53:52Z,25,10,35
NULL,30278,2015-12-09T05:01:18Z,89,68,157
NULL,30279,2015-12-09T11:41:31Z,44,4,48
A-docs,30293,2015-12-09T21:00:35Z,5,4,9
NULL,30353,2015-12-12T17:05:15Z,1,1,2
A-mir;P-medium;T-compiler,30364,2015-12-13T13:52:21Z,164,24,188
NULL,30372,2015-12-14T17:12:04Z,29,7,36
NULL,30374,2015-12-14T18:53:11Z,21,2,23
NULL,30375,2015-12-14T20:43:55Z,54,10,64
A-diagnostics;E-mentor,30377,2015-12-14T21:43:28Z,94,94,188
NULL,30381,2015-12-14T23:47:39Z,397,5,402
NULL,30394,2015-12-15T17:16:13Z,10,0,10
NULL,30400,2015-12-15T19:51:19Z,1,1,2
NULL,30402,2015-12-15T22:01:38Z,35,0,35
A-docs,30404,2015-12-15T22:22:36Z,22,20,42
NULL,30405,2015-12-16T01:26:24Z,1,2,3
NULL,30408,2015-12-16T02:38:24Z,106,0,106
NULL,30409,2015-12-16T11:08:59Z,0,0,0
NULL,30410,2015-12-16T12:16:30Z,455,270,725
A-diagnostics,30411,2015-12-16T13:28:23Z,1187,434,1621
NULL,30413,2015-12-16T15:45:37Z,133,5,138
NULL,30414,2015-12-16T16:07:57Z,2,2,4
NULL,30420,2015-12-16T19:29:01Z,400,413,813
A-libs,30426,2015-12-17T00:55:40Z,1916,2595,4511
NULL,30800,2016-01-09T19:04:21Z,1,2,3
I-papercut,30801,2016-01-09T19:38:36Z,92,17,109
NULL,30808,2016-01-10T15:54:55Z,0,1,1
NULL,30821,2016-01-11T13:48:24Z,2,2,4
"A-destructors;I-wrong,I-crash",30823,2016-01-11T16:36:56Z,392,44,436
NULL,30826,2016-01-11T19:17:54Z,939,260,1199
NULL,30830,2016-01-11T22:42:26Z,42,43,85
NULL,30836,2016-01-12T06:11:52Z,6,4,10
NULL,30844,2016-01-12T12:50:29Z,62,21,83
A-mir;P-medium;T-compiler,30845,2016-01-12T13:23:10Z,109,13,122
NULL,30848,2016-01-12T14:52:06Z,41,5,46
NULL,30854,2016-01-12T18:58:13Z,209,293,502
NULL,30856,2016-01-12T19:45:34Z,55,2,57
NULL,30859,2016-01-12T20:48:19Z,16,0,16
NULL,30866,2016-01-13T01:30:01Z,4,3,7
NULL,30897,2016-01-14T13:42:29Z,56,52,108
NULL,30898,2016-01-14T14:11:16Z,45,41,86
A-docs,30901,2016-01-14T15:17:18Z,57,0,57
relnotes,30913,2016-01-14T19:20:38Z,0,57,57
NULL,30915,2016-01-14T19:57:11Z,0,0,0
beta-nominated,30916,2016-01-14T19:58:35Z,116,105,221
NULL,30921,2016-01-14T21:51:16Z,0,0,0
NULL,30929,2016-01-15T09:37:39Z,600,224,824
NULL,30938,2016-01-15T16:41:06Z,43,5,48
"B-unstable;T-libs,B-unstable;T-libs,B-unstable;T-libs,B-unstable;T-libs,B-unstable;T-libs,I-nominated,B-unstable;T-libs,A-io;B-unstable;T-libs,A-io;B-unstable;T-libs,B-unstable;T-libs",30943,2016-01-15T21:18:00Z,356,235,591
NULL,30944,2016-01-15T21:51:55Z,26,18,44
beta-nominated,30950,2016-01-16T06:35:13Z,322,128,450
A-collections;E-easy,30956,2016-01-16T13:59:46Z,41,30,71
NULL,30975,2016-01-17T11:55:49Z,417,250,667
A-libs,30980,2016-01-17T15:52:26Z,118,17,135
NULL,30981,2016-01-17T16:02:44Z,2,2,4
A-collections;E-easy,30982,2016-01-17T17:26:23Z,126,0,126
NULL,30991,2016-01-18T04:49:02Z,29,1,30
NULL,30996,2016-01-18T10:10:07Z,8,10,18
NULL,31006,2016-01-18T20:05:15Z,36,34,70
NULL,31010,2016-01-18T22:51:34Z,725,671,1396
NULL,31020,2016-01-19T07:43:34Z,96,58,154
regression-from-stable-to-nightly,31028,2016-01-19T19:29:17Z,20,5,25
A-docs,31035,2016-01-19T22:01:01Z,29,0,29
NULL,31038,2016-01-20T03:10:04Z,2,2,4
NULL,31040,2016-01-20T03:34:00Z,372,1,373
NULL,31050,2016-01-20T15:23:58Z,1,1,2
NULL,31052,2016-01-20T16:38:41Z,31,3,34
NULL,31056,2016-01-20T16:56:13Z,163,52,215
NULL,31057,2016-01-20T17:03:28Z,1,1,2
A-windows-msvc,31064,2016-01-20T22:25:25Z,106,83,189
NULL,31071,2016-01-21T10:04:14Z,0,0,0
A-build,31074,2016-01-21T13:44:43Z,7,1,8
NULL,31077,2016-01-21T17:00:56Z,44,9,53
A-build;A-infrastructure,31078,2016-01-21T17:05:02Z,412,38,450
A-collections;B-unstable;T-libs,31081,2016-01-21T18:38:12Z,215,142,357
NULL,31089,2016-01-21T21:24:26Z,354,30,384
A-resolve;I-nominated;I-wrong;P-backcompat-lang,31105,2016-01-22T10:48:37Z,78,30,108
NULL,31110,2016-01-22T13:58:54Z,0,0,0
NULL,31111,2016-01-22T13:59:49Z,1,1,2
NULL,31124,2016-01-22T18:47:33Z,14,0,14
NULL,31136,2016-01-22T22:17:28Z,10,10,20
NULL,31144,2016-01-23T08:40:18Z,0,25,25
NULL,31147,2016-01-23T14:35:14Z,0,0,0
NULL,31148,2016-01-23T14:38:45Z,162,38,200
A-macros;T-compiler,31152,2016-01-23T18:41:30Z,313,1,314
NULL,31160,2016-01-24T07:13:27Z,50,15,65
NULL,31176,2016-01-25T04:58:10Z,65,12,77
NULL,31177,2016-01-25T05:20:21Z,133,4,137
NULL,31179,2016-01-25T06:57:12Z,0,0,0
NULL,31197,2016-01-26T02:33:53Z,1,1,2
NULL,31199,2016-01-26T03:26:53Z,4,0,4
NULL,31208,2016-01-26T05:37:17Z,0,0,0
NULL,31210,2016-01-26T07:41:58Z,946,1021,1967
NULL,31212,2016-01-26T09:13:10Z,35,73,108
NULL,31214,2016-01-26T13:25:39Z,220,37,257
"A-codegen;A-unicode;I-enhancement;I-slow,A-codegen;A-unicode;I-enhancement;I-slow",31215,2016-01-26T14:36:58Z,0,0,0
NULL,31226,2016-01-26T22:47:01Z,4,3,7
NULL,31231,2016-01-27T01:41:38Z,0,0,0
"I-wrong;P-high,I-wrong;P-high",31232,2016-01-27T03:32:57Z,50,15,65
NULL,31240,2016-01-27T18:29:41Z,4,3,7
NULL,31243,2016-01-27T19:18:32Z,78,10,88
NULL,31248,2016-01-27T21:45:07Z,18,14,32
NULL,31253,2016-01-28T09:03:50Z,32,20,52
A-bitrig;A-bsd;A-dragonflybsd;A-freebsd;A-netbsd;A-openbsd,31263,2016-01-28T17:25:44Z,31,31,62
NULL,31269,2016-01-28T21:06:17Z,19,1,20
NULL,31283,2016-01-29T13:20:47Z,3,19,22
NULL,31285,2016-01-29T14:49:40Z,38,12,50
NULL,31291,2016-01-29T20:41:40Z,0,0,0
NULL,31294,2016-01-29T22:44:47Z,2,2,4
NULL,31295,2016-01-29T22:48:42Z,5,0,5
NULL,31296,2016-01-29T22:53:40Z,11,0,11
NULL,31305,2016-01-30T12:27:17Z,449,55,504
NULL,31308,2016-01-30T15:51:13Z,0,0,0
A-windows,31319,2016-01-31T08:09:07Z,26,27,53
NULL,31326,2016-01-31T19:36:12Z,71,2,73
NULL,31327,2016-01-31T19:54:37Z,10,0,10
NULL,31329,2016-01-31T20:57:21Z,12,2,14
NULL,31332,2016-01-31T22:20:47Z,1,1,2
A-libs;I-wrong,31333,2016-01-31T23:56:46Z,74,20,94
B-unstable;T-libs,31335,2016-02-01T01:02:19Z,106,0,106
A-diagnostics;A-resolve,31338,2016-02-01T04:46:08Z,71,20,91
NULL,31344,2016-02-01T16:52:20Z,4,5,9
A-compiler;I-slow,31349,2016-02-01T21:16:32Z,314,152,466
NULL,31350,2016-02-01T23:18:08Z,0,0,0
NULL,31351,2016-02-01T23:33:01Z,24,0,24
NULL,31352,2016-02-01T23:49:46Z,33,1,34
NULL,31353,2016-02-02T00:03:38Z,0,0,0
A-libs;E-easy;E-mentor,31356,2016-02-02T01:32:34Z,0,0,0
NULL,31359,2016-02-02T05:32:20Z,162,67,229
"A-parser;I-wrong;P-high;T-lang,A-parser;I-wrong;P-high;T-lang",31362,2016-02-02T07:50:13Z,140,72,212
I-needs-decision;T-lang,31370,2016-02-02T21:24:25Z,210,18,228
NULL,31376,2016-02-03T00:55:26Z,0,0,0
NULL,31377,2016-02-03T00:57:28Z,0,0,0
NULL,31401,2016-02-04T05:12:28Z,21,0,21
I-ICE,31410,2016-02-04T20:36:24Z,119,41,160
NULL,31414,2016-02-04T20:51:37Z,203,40,243
NULL,31416,2016-02-04T21:39:06Z,35,14,49
"A-io;A-libs,A-io;A-libs",31417,2016-02-04T23:34:33Z,202,45,247
NULL,31418,2016-02-04T23:39:16Z,0,0,0
NULL,31421,2016-02-05T04:54:43Z,0,0,0
NULL,31425,2016-02-05T08:37:58Z,196,55,251
B-unstable;T-libs,31428,2016-02-05T10:26:29Z,1,60,61
NULL,31429,2016-02-05T12:18:37Z,317,4,321
NULL,31433,2016-02-05T18:53:49Z,2,7,9
NULL,31445,2016-02-06T05:34:51Z,3,7,10
NULL,31448,2016-02-06T12:46:13Z,0,0,0
NULL,31452,2016-02-06T18:05:10Z,0,0,0
NULL,31455,2016-02-06T19:34:02Z,39,11,50
A-libs;I-wrong,31457,2016-02-06T22:57:40Z,25,4,29
NULL,31461,2016-02-07T08:11:56Z,377,677,1054
NULL,31465,2016-02-07T16:04:46Z,21,14,35
NULL,31468,2016-02-07T18:11:17Z,56,2,58
NULL,31483,2016-02-08T01:21:43Z,0,0,0
A-driver,31499,2016-02-08T21:42:41Z,86,21,107
NULL,31507,2016-02-09T05:17:40Z,15,4,19
A-docs,31515,2016-02-09T17:02:31Z,6,0,6
A-docs,31516,2016-02-09T17:54:39Z,72,45,117
NULL,31517,2016-02-09T18:33:12Z,0,0,0
NULL,31519,2016-02-09T18:54:52Z,0,0,0
A-docs,31520,2016-02-09T19:07:39Z,22,4,26
NULL,31523,2016-02-09T21:58:59Z,165,115,280
NULL,31527,2016-02-10T00:19:32Z,25,0,25
A-parser;I-wrong,31530,2016-02-10T06:50:37Z,36,13,49
A-parser;I-nominated;T-lang,31534,2016-02-10T11:08:33Z,34,8,42
NULL,31545,2016-02-10T21:03:54Z,58,4,62
NULL,31550,2016-02-11T01:04:24Z,6,6,12
"I-nominated;T-libs,B-RFC-approved;T-libs",31551,2016-02-11T01:08:55Z,2036,482,2518
NULL,31552,2016-02-11T01:13:59Z,9,23,32
NULL,31562,2016-02-11T05:26:44Z,14,0,14
NULL,31564,2016-02-11T06:42:07Z,4,4,8
NULL,31566,2016-02-11T07:40:57Z,2,1,3
NULL,31581,2016-02-11T19:33:39Z,179,158,337
NULL,31583,2016-02-11T21:01:53Z,271,254,525
NULL,31602,2016-02-12T13:14:44Z,20,3,23
NULL,31604,2016-02-12T13:50:45Z,0,0,0
"A-linkage;A-runtime,A-frontend;E-easy,A-frontend;A-typesystem;I-completion,E-easy;I-cleanup,I-completion",31605,2016-02-12T15:45:11Z,0,0,0
NULL,31607,2016-02-12T16:55:22Z,1,2,3
B-RFC-approved;T-libs,31608,2016-02-12T17:31:29Z,268,0,268
NULL,31614,2016-02-12T21:36:37Z,46,5,51
NULL,31618,2016-02-13T00:21:23Z,609,53,662
A-rustdoc;I-papercut,31626,2016-02-13T10:54:33Z,2,2,4
A-testsuite;E-easy,31627,2016-02-13T11:45:42Z,18,0,18
NULL,31632,2016-02-13T17:18:36Z,0,0,0
NULL,31633,2016-02-13T18:54:34Z,0,0,0
NULL,31638,2016-02-13T19:30:14Z,0,2,2
NULL,31639,2016-02-13T20:18:06Z,4,4,8
A-visibility;I-nominated,31641,2016-02-13T21:10:24Z,316,11,327
NULL,31643,2016-02-13T22:29:11Z,104,29,133
NULL,31646,2016-02-14T02:19:18Z,35,10,45
NULL,31648,2016-02-14T09:07:27Z,43,92,135
"A-typesystem,A-typesystem",31651,2016-02-14T13:41:23Z,8,1,9
NULL,31661,2016-02-14T23:02:32Z,8,9,17
A-docs,31666,2016-02-15T01:03:13Z,12,5,17
NULL,31668,2016-02-15T03:21:51Z,14,11,25
NULL,31669,2016-02-15T04:03:44Z,78,17,95
NULL,31674,2016-02-15T12:10:56Z,521,85,606
I-compiletime;T-compiler,31680,2016-02-15T17:14:43Z,68,14,82
NULL,31685,2016-02-15T22:11:02Z,416,423,839
A-testsuite;E-easy,31689,2016-02-15T23:46:18Z,0,0,0
NULL,31693,2016-02-16T01:25:07Z,0,0,0
NULL,31696,2016-02-16T03:13:27Z,150,2,152
NULL,31707,2016-02-16T16:01:36Z,31,1,32
NULL,31709,2016-02-16T16:21:36Z,203,117,320
NULL,31710,2016-02-16T16:52:38Z,2056,2242,4298
NULL,31716,2016-02-16T22:26:54Z,9,1,10
NULL,31717,2016-02-16T23:24:11Z,77,2,79
A-collections;I-slow,31718,2016-02-16T23:42:04Z,4,1,5
NULL,31720,2016-02-17T02:47:19Z,18,2,20
NULL,31721,2016-02-17T03:50:05Z,21,21,42
NULL,31725,2016-02-17T09:39:37Z,0,0,0
NULL,31726,2016-02-17T10:21:42Z,388,305,693
NULL,31727,2016-02-17T10:47:18Z,1,0,1
NULL,31734,2016-02-17T18:40:55Z,63,131,194
NULL,31739,2016-02-17T23:14:37Z,326,182,508
NULL,31746,2016-02-18T04:25:23Z,22,1,23
NULL,31747,2016-02-18T08:00:40Z,37,72,109
B-RFC-approved;T-libs,31761,2016-02-18T20:28:34Z,55,1,56
NULL,31768,2016-02-18T23:43:09Z,107,3,110
NULL,31771,2016-02-19T06:50:34Z,5,0,5
NULL,31777,2016-02-19T19:23:29Z,47,32,79
NULL,31781,2016-02-20T00:56:05Z,2,0,2
NULL,31784,2016-02-20T08:55:33Z,2,2,4
NULL,31791,2016-02-20T17:32:01Z,2,2,4
NULL,31797,2016-02-20T22:50:24Z,27,28,55
NULL,31800,2016-02-21T02:21:45Z,4,4,8
NULL,31802,2016-02-21T02:34:59Z,3,0,3
"A-libs;E-easy;E-mentor;I-slow,A-libs;E-easy;E-mentor;I-slow",31809,2016-02-21T15:11:31Z,0,0,0
NULL,31813,2016-02-21T23:15:25Z,4,2,6
NULL,31818,2016-02-22T13:06:27Z,27,2,29
NULL,31822,2016-02-22T18:27:36Z,92,40,132
NULL,31824,2016-02-23T00:24:56Z,307,506,813
NULL,31832,2016-02-23T07:01:15Z,1,1,2
B-RFC-approved;T-libs,31834,2016-02-23T07:09:55Z,63,1,64
"A-rustdoc,A-rustdoc",31835,2016-02-23T08:33:15Z,36,9,45
NULL,31837,2016-02-23T10:07:26Z,34,4,38
NULL,31839,2016-02-23T11:21:14Z,7,6,13
E-easy,31842,2016-02-23T16:19:45Z,28,42,70
A-docs,31843,2016-02-23T17:07:12Z,44,1,45
NULL,31857,2016-02-24T06:33:49Z,56,19,75
NULL,31858,2016-02-24T07:24:59Z,10,5,15
NULL,31861,2016-02-24T12:56:34Z,0,0,0
NULL,31873,2016-02-24T22:51:12Z,138,62,200
NULL,31875,2016-02-25T01:26:38Z,0,0,0
NULL,31876,2016-02-25T02:02:03Z,11,7,18
NULL,31877,2016-02-25T03:09:49Z,0,0,0
NULL,31882,2016-02-25T06:11:03Z,441,192,633
A-tools,31889,2016-02-25T17:54:43Z,29,41,70
NULL,31892,2016-02-25T20:47:41Z,0,0,0
E-easy;I-cleanup,31901,2016-02-26T00:26:58Z,9,9,18
NULL,31902,2016-02-26T01:21:16Z,75,3,78
A-docs,31903,2016-02-26T01:44:17Z,52,11,63
NULL,31904,2016-02-26T02:00:08Z,62,1,63
NULL,31911,2016-02-26T09:42:18Z,85,20,105
NULL,31915,2016-02-26T16:25:08Z,28,12,40
NULL,31916,2016-02-26T17:33:59Z,246,265,511
NULL,31917,2016-02-26T18:50:57Z,359,7,366
A-docs,31918,2016-02-26T18:51:35Z,6,0,6
NULL,31919,2016-02-26T19:10:07Z,97,129,226
NULL,31920,2016-02-26T19:58:02Z,67,73,140
NULL,31925,2016-02-26T22:06:45Z,253,109,362
"B-unstable;T-libs,B-unstable;T-libs,A-libs;B-RFC-approved,B-unstable,B-unstable;T-libs,B-unstable;T-libs",31928,2016-02-26T23:51:35Z,214,227,441
NULL,31931,2016-02-27T01:44:53Z,9,9,18
beta-nominated,31932,2016-02-27T02:34:55Z,71,20,91
P-backcompat-lang,31938,2016-02-27T09:18:28Z,236,518,754
NULL,31944,2016-02-27T20:18:40Z,0,0,0
A-const-fn;B-RFC-approved;T-lang,31954,2016-02-28T23:27:34Z,369,16,385
NULL,31957,2016-02-29T00:55:15Z,23,11,34
NULL,31962,2016-02-29T13:57:38Z,39,1,40
A-docs;A-libs,31965,2016-02-29T15:24:07Z,12,12,24
I-slow,31966,2016-02-29T15:40:02Z,0,0,0
beta-nominated,31969,2016-02-29T18:16:28Z,0,4,4
NULL,31970,2016-02-29T18:29:57Z,0,0,0
"beta-nominated,beta-nominated",31971,2016-02-29T18:31:18Z,71,62,133
NULL,31975,2016-02-29T19:06:52Z,0,0,0
"beta-nominated,beta-accepted",31993,2016-03-01T18:39:43Z,48,34,82
NULL,32001,2016-03-02T01:31:16Z,163,190,353
NULL,32006,2016-03-02T06:32:14Z,113,4,117
NULL,32010,2016-03-02T18:16:21Z,46,6,52
"A-compiler;A-incr-comp;T-compiler,A-incr-comp;T-compiler",32016,2016-03-02T23:15:18Z,2053,712,2765
beta-nominated,32018,2016-03-03T00:35:26Z,1,0,1
B-RFC-approved,32025,2016-03-03T15:47:32Z,0,0,0
NULL,32034,2016-03-04T02:06:25Z,51,14,65
beta-nominated,32037,2016-03-04T07:34:34Z,0,0,0
"beta-nominated,beta-nominated",32038,2016-03-04T09:45:15Z,0,0,0
I-ICE;regression-from-stable-to-nightly,32039,2016-03-04T13:35:45Z,58,47,105
NULL,32041,2016-03-04T14:13:00Z,21,4,25
beta-nominated,32046,2016-03-04T19:17:29Z,34,5,39
"A-libs,A-libs",32051,2016-03-04T22:37:05Z,15,15,30
NULL,32053,2016-03-05T00:37:37Z,0,0,0
NULL,32054,2016-03-05T02:51:20Z,319,34,353
A-rustdoc,32055,2016-03-05T09:58:12Z,51,8,59
NULL,32060,2016-03-05T13:12:11Z,1,1,2
NULL,32064,2016-03-05T17:13:30Z,41,3,44
"A-libs,A-libs,A-libs,A-libs",32067,2016-03-05T19:42:22Z,0,0,0
NULL,32071,2016-03-05T23:42:31Z,17,53,70
NULL,32073,2016-03-06T08:42:15Z,22,33,55
"B-unstable;T-libs,I-nominated;regression-from-stable-to-beta;T-libs",32076,2016-03-06T12:02:05Z,0,0,0
needs-crater,32080,2016-03-06T15:10:23Z,4601,6369,10970
NULL,32083,2016-03-06T18:58:09Z,10,0,10
A-docs,32091,2016-03-07T03:16:33Z,10,8,18
NULL,32097,2016-03-07T10:30:30Z,65,21,86
NULL,32099,2016-03-07T14:40:41Z,51,13,64
NULL,32101,2016-03-07T15:41:08Z,2,1,3
B-unstable;T-libs,32102,2016-03-07T17:21:02Z,36,1,37
NULL,32107,2016-03-07T21:37:46Z,32,2,34
NULL,32117,2016-03-08T07:12:09Z,1,1,2
NULL,32123,2016-03-08T18:25:50Z,0,0,0
NULL,32126,2016-03-08T18:44:12Z,105,42,147
A-docs,32135,2016-03-08T22:48:30Z,111,0,111
A-docs,32136,2016-03-08T22:54:58Z,30,0,30
A-docs,32137,2016-03-08T23:28:35Z,144,0,144
"A-frontend;A-syntaxext;I-cleanup;P-backcompat-libs,A-frontend;A-syntaxext;I-cleanup;P-backcompat-libs",32139,2016-03-08T23:51:38Z,0,0,0
A-rustdoc,32142,2016-03-09T01:09:07Z,94,14,108
NULL,32147,2016-03-09T08:32:24Z,6,4,10
NULL,32148,2016-03-09T08:36:56Z,1,1,2
NULL,32149,2016-03-09T08:42:09Z,4,0,4
NULL,32150,2016-03-09T08:52:16Z,1,2,3
NULL,32165,2016-03-10T00:21:17Z,1,1,2
A-llvm,32168,2016-03-10T03:13:02Z,10,3,13
NULL,32169,2016-03-10T04:13:46Z,32,19,51
NULL,32172,2016-03-10T09:01:03Z,0,0,0
NULL,32173,2016-03-10T11:01:55Z,58,23,81
NULL,32182,2016-03-10T20:24:11Z,2,14,16
NULL,32183,2016-03-10T20:38:54Z,58,0,58
NULL,32192,2016-03-11T14:27:04Z,0,0,0
"B-RFC-approved;T-lang,A-build",32199,2016-03-11T20:47:45Z,438,46,484
NULL,32200,2016-03-11T21:11:28Z,279,69,348
B-unstable;T-libs,32204,2016-03-11T22:41:33Z,195,201,396
NULL,32209,2016-03-12T06:39:48Z,0,0,0
NULL,32210,2016-03-12T07:27:49Z,539,49,588
NULL,32212,2016-03-12T10:33:02Z,4,0,4
B-RFC-approved;B-unstable;T-lang,32213,2016-03-12T12:16:27Z,0,0,0
NULL,32219,2016-03-12T22:19:52Z,68,30,98
NULL,32227,2016-03-13T11:02:27Z,61,22,83
A-diagnostics,32228,2016-03-13T11:33:24Z,53,4,57
NULL,32229,2016-03-13T14:03:28Z,53,11,64
NULL,32230,2016-03-13T14:37:09Z,196,123,319
NULL,32232,2016-03-13T16:04:02Z,28,3,31
NULL,32233,2016-03-13T16:42:07Z,69,1,70
I-compiletime,32236,2016-03-13T22:10:18Z,2802,2741,5543
NULL,32239,2016-03-14T05:29:29Z,4,3,7
B-RFC-approved;T-libs,32244,2016-03-14T11:02:44Z,174,134,308
NULL,32250,2016-03-14T20:53:06Z,55,25,80
"A-frontend;A-syntaxext;I-cleanup;P-backcompat-libs,A-frontend;A-syntaxext;I-cleanup;P-backcompat-libs",32251,2016-03-14T20:53:45Z,140,114,254
NULL,32252,2016-03-14T20:54:26Z,62,37,99
NULL,32253,2016-03-14T20:55:01Z,21,1,22
A-libs;A-windows;I-wrong,32257,2016-03-15T05:47:39Z,42,1,43
A-diagnostics,32258,2016-03-15T08:55:35Z,348,99,447
NULL,32262,2016-03-15T13:24:04Z,0,0,0
NULL,32263,2016-03-15T14:15:44Z,141,6,147
NULL,32264,2016-03-15T14:56:34Z,22,0,22
NULL,32266,2016-03-15T17:08:39Z,2,2,4
NULL,32267,2016-03-15T17:11:53Z,88,32,120
NULL,32271,2016-03-15T20:36:47Z,4,0,4
A-testsuite,32273,2016-03-15T22:21:47Z,4,4,8
NULL,32274,2016-03-15T22:41:26Z,0,0,0
NULL,32275,2016-03-16T00:21:12Z,0,0,0
NULL,32280,2016-03-16T03:34:44Z,1,1,2
NULL,32287,2016-03-16T14:19:41Z,0,0,0
NULL,32291,2016-03-16T18:35:51Z,156,63,219
NULL,32293,2016-03-16T19:10:03Z,1833,659,2492
NULL,32306,2016-03-17T09:26:52Z,396,189,585
NULL,32308,2016-03-17T15:52:25Z,6,2,8
regression-from-stable-to-nightly,32309,2016-03-17T16:08:53Z,30,16,46
"beta-nominated,I-nominated;regression-from-stable-to-beta;T-libs,B-unstable;T-libs,beta-nominated",32314,2016-03-17T16:43:12Z,0,102,102
NULL,32317,2016-03-17T17:54:25Z,84,64,148
A-docs,32322,2016-03-17T22:04:50Z,35,0,35
NULL,32325,2016-03-18T02:05:38Z,363,56,419
NULL,32328,2016-03-18T05:24:09Z,207,207,414
NULL,32332,2016-03-18T10:46:14Z,21,1,22
B-RFC-approved;T-libs,32334,2016-03-18T12:55:49Z,43,21,64
NULL,32337,2016-03-18T14:52:35Z,2,2,4
NULL,32344,2016-03-19T00:06:25Z,35,2,37
NULL,32345,2016-03-19T00:29:59Z,48,54,102
NULL,32351,2016-03-19T10:30:02Z,100,34,134
B-RFC-approved;T-libs,32355,2016-03-19T14:18:09Z,0,0,0
NULL,32358,2016-03-19T16:38:15Z,104,50,154
NULL,32361,2016-03-19T20:01:20Z,6,1,7
NULL,32366,2016-03-20T01:53:21Z,0,0,0
NULL,32375,2016-03-20T15:58:35Z,2,2,4
NULL,32386,2016-03-21T03:40:19Z,86,21,107
NULL,32388,2016-03-21T05:11:20Z,1,0,1
I-nominated;regression-from-stable-to-nightly;T-compiler,32393,2016-03-21T10:40:28Z,21,0,21
NULL,32399,2016-03-21T13:50:38Z,0,0,0
NULL,32400,2016-03-21T14:38:45Z,0,0,0
NULL,32402,2016-03-21T15:46:53Z,55,10,65
NULL,32404,2016-03-21T16:48:22Z,28,0,28
A-docs,32416,2016-03-22T00:13:15Z,23,0,23
"I-ICE,I-ICE",32420,2016-03-22T02:40:53Z,22,0,22
NULL,32422,2016-03-22T06:16:42Z,0,0,0
NULL,32423,2016-03-22T06:17:50Z,37,1,38
NULL,32429,2016-03-22T16:34:25Z,6,6,12
A-rustdoc,32434,2016-03-22T20:07:58Z,48,11,59
A-mir;A-windows-msvc,32437,2016-03-23T01:02:54Z,6,0,6
"A-diagnostics,A-diagnostics",32439,2016-03-23T02:04:53Z,396,291,687
NULL,32447,2016-03-23T05:58:17Z,3,3,6
A-docs,32452,2016-03-23T13:17:34Z,50,0,50
NULL,32454,2016-03-23T15:59:17Z,173,32,205
NULL,32461,2016-03-24T05:55:49Z,473,196,669
A-docs,32464,2016-03-24T12:25:00Z,3,7,10
NULL,32465,2016-03-24T14:37:25Z,120,13,133
NULL,32466,2016-03-24T15:48:58Z,420,30,450
beta-nominated;T-libs,32467,2016-03-24T16:38:09Z,0,106,106
NULL,32470,2016-03-24T21:27:18Z,0,4,4
NULL,32479,2016-03-25T14:48:58Z,49,14,63
NULL,32485,2016-03-25T18:04:02Z,0,0,0
NULL,32488,2016-03-25T19:12:38Z,0,0,0
A-diagnostics;I-wrong,32494,2016-03-26T00:56:33Z,50,11,61
NULL,32495,2016-03-26T03:27:49Z,0,0,0
NULL,32496,2016-03-26T03:37:23Z,825,307,1132
NULL,32506,2016-03-26T13:42:04Z,34,19,53
NULL,32508,2016-03-26T15:05:50Z,63,138,201
NULL,32522,2016-03-27T02:33:07Z,4,1,5
NULL,32531,2016-03-27T17:16:38Z,0,0,0
NULL,32541,2016-03-27T23:31:24Z,54,0,54
NULL,32542,2016-03-28T01:50:17Z,0,0,0
NULL,32544,2016-03-28T05:34:24Z,169,42,211
NULL,32549,2016-03-28T13:00:29Z,59,17,76
NULL,32557,2016-03-28T16:01:06Z,152,17,169
NULL,32558,2016-03-28T16:13:45Z,54,10,64
NULL,32561,2016-03-28T17:48:29Z,73,44,117
NULL,32567,2016-03-29T05:23:49Z,56,72,128
NULL,32571,2016-03-29T10:54:23Z,22,44,66
NULL,32576,2016-03-29T15:27:20Z,5,9,14
A-docs,32581,2016-03-29T16:46:29Z,85,0,85
NULL,32582,2016-03-29T16:48:44Z,236,153,389
A-build;A-tools,32590,2016-03-29T20:17:48Z,654,742,1396
NULL,32596,2016-03-30T03:14:04Z,276,108,384
NULL,32621,2016-03-30T17:16:55Z,25,25,50
NULL,32622,2016-03-30T19:52:13Z,9,6,15
NULL,32628,2016-03-30T23:35:00Z,973,810,1783
NULL,32633,2016-03-31T01:07:41Z,138,0,138
NULL,32640,2016-03-31T06:30:27Z,0,1,1
"A-diagnostics;E-easy;I-cleanup;I-completion;P-low,A-diagnostics;E-easy;I-cleanup;I-completion;P-low,I-nominated",32644,2016-03-31T12:33:17Z,60,18,78
NULL,32666,2016-04-01T13:14:50Z,82,13,95
I-nominated;T-compiler,32671,2016-04-01T22:37:22Z,0,0,0
NULL,32674,2016-04-02T03:21:01Z,385,298,683
metabug,32682,2016-04-02T15:04:06Z,84,164,248
NULL,32683,2016-04-02T15:28:10Z,0,0,0
metabug,32688,2016-04-02T21:06:57Z,92,69,161
B-unstable;I-nominated;T-libs,32693,2016-04-03T03:47:55Z,52,0,52
NULL,32695,2016-04-03T05:22:54Z,1,1,2
NULL,32698,2016-04-03T11:44:03Z,0,0,0
NULL,32711,2016-04-03T20:31:27Z,21,1,22
NULL,32712,2016-04-03T21:03:41Z,58,18,76
NULL,32724,2016-04-04T11:36:30Z,5,20,25
P-backcompat-lang,32741,2016-04-05T09:41:24Z,74,86,160
NULL,32742,2016-04-05T09:43:03Z,51,21,72
NULL,32743,2016-04-05T11:13:23Z,913,424,1337
A-docs,32744,2016-04-05T12:12:02Z,12,0,12
NULL,32746,2016-04-05T14:35:17Z,0,0,0
regression-from-stable-to-nightly;T-lang,32748,2016-04-05T16:16:06Z,162,70,232
NULL,32759,2016-04-06T03:30:17Z,0,0,0
metabug,32767,2016-04-06T11:09:54Z,1389,2345,3734
A-docs,32768,2016-04-06T13:13:09Z,162,4,166
NULL,32771,2016-04-06T15:32:45Z,0,0,0
NULL,32772,2016-04-06T15:33:47Z,0,0,0
NULL,32773,2016-04-06T16:42:29Z,31,158,189
NULL,32778,2016-04-06T19:12:10Z,76,72,148
A-closures;A-diagnostics;A-traits,32780,2016-04-06T21:02:51Z,163,75,238
NULL,32787,2016-04-07T03:24:46Z,0,0,0
NULL,32789,2016-04-07T04:04:58Z,76,97,173
NULL,32791,2016-04-07T09:14:28Z,625,676,1301
NULL,32794,2016-04-07T11:47:11Z,815,521,1336
NULL,32795,2016-04-07T13:40:48Z,107,25,132
NULL,32800,2016-04-07T17:56:19Z,222,136,358
NULL,32802,2016-04-07T19:13:31Z,17,0,17
A-mir,32803,2016-04-07T19:47:05Z,560,635,1195
"B-RFC-approved;T-libs,B-unstable;T-libs,B-unstable;T-libs,B-RFC-approved,B-unstable;T-libs,B-RFC-approved,A-libs,B-unstable;T-libs,A-io;B-unstable;T-libs,B-RFC-approved,B-unstable;T-lang;T-libs,B-RFC-approved;T-libs,B-unstable;T-libs,B-RFC-approved;T-libs,B-unstable;T-libs,A-libs,T-libs",32804,2016-04-07T20:44:28Z,508,328,836
NULL,32807,2016-04-07T22:48:26Z,0,0,0
NULL,32811,2016-04-07T23:53:41Z,21,8,29
NULL,32812,2016-04-08T00:13:45Z,0,0,0
I-ICE,32813,2016-04-08T02:15:06Z,0,0,0
NULL,32814,2016-04-08T03:11:07Z,70,14,84
A-docs;E-easy,32815,2016-04-08T04:56:24Z,8,13,21
regression-from-stable-to-nightly,32816,2016-04-08T05:28:30Z,43,12,55
NULL,32817,2016-04-08T07:03:11Z,27,14,41
NULL,32823,2016-04-08T08:39:15Z,1,0,1
NULL,32828,2016-04-08T16:49:42Z,69,11,80
NULL,32844,2016-04-08T22:07:22Z,0,0,0
NULL,32846,2016-04-08T23:50:21Z,29,22,51
A-diagnostics,32849,2016-04-09T02:18:25Z,25,5,30
"A-resolve,A-resolve",32850,2016-04-09T02:42:31Z,57,0,57
A-docs,32854,2016-04-09T11:19:59Z,44,3,47
NULL,32856,2016-04-09T14:42:40Z,1,2,3
NULL,32860,2016-04-09T20:41:49Z,0,0,0
NULL,32862,2016-04-10T00:20:57Z,2,1,3
A-rustbuild,32865,2016-04-10T04:46:30Z,12,4,16
A-collections,32866,2016-04-10T09:34:40Z,179,0,179
B-RFC-approved;B-unstable;T-lang,32875,2016-04-11T06:33:36Z,478,196,674
NULL,32877,2016-04-11T08:43:33Z,54,7,61
A-docs;E-easy,32878,2016-04-11T09:37:28Z,0,0,0
NULL,32880,2016-04-11T10:04:57Z,26,18,44
NULL,32882,2016-04-11T14:31:29Z,233,65,298
NULL,32883,2016-04-11T16:46:17Z,132,22,154
A-parser;I-nominated;T-lang,32885,2016-04-11T18:31:53Z,2,2,4
beta-accepted,32897,2016-04-12T00:36:22Z,0,2,2
beta-accepted,32898,2016-04-12T00:40:23Z,51,8,59
"A-docs;E-easy,A-docs;E-easy",32899,2016-04-12T01:08:10Z,0,0,0
B-RFC-approved;B-unstable;T-lang,32900,2016-04-12T02:34:46Z,2322,931,3253
A-rustbuild,32903,2016-04-12T05:57:00Z,55,18,73
relnotes,32910,2016-04-12T15:23:52Z,508,328,836
NULL,32923,2016-04-13T00:26:38Z,50,8,58
A-rustbuild;E-easy,32926,2016-04-13T03:56:31Z,40,13,53
NULL,32931,2016-04-13T10:33:49Z,4,0,4
"A-rustdoc,A-rustdoc",32935,2016-04-13T14:09:36Z,85,8,93
A-docs,32937,2016-04-13T16:01:13Z,3,4,7
NULL,32939,2016-04-13T16:49:36Z,1698,393,2091
NULL,32941,2016-04-13T20:46:56Z,2,2,4
NULL,32942,2016-04-13T20:47:58Z,200,2999,3199
NULL,32946,2016-04-14T05:07:58Z,40,32,72
B-RFC-approved;T-libs,32951,2016-04-14T14:11:42Z,49,0,49
"A-debuginfo;A-mir,A-mir",32952,2016-04-14T14:24:46Z,206,80,286
A-docs,32956,2016-04-14T16:44:46Z,52,0,52
beta-accepted,32960,2016-04-14T18:49:12Z,79,32,111
NULL,32970,2016-04-14T20:46:32Z,13,7,20
NULL,32977,2016-04-14T23:59:32Z,9,5,14
A-rustdoc;I-wrong,32985,2016-04-15T04:56:37Z,53,14,67
A-docs;E-easy,32989,2016-04-15T15:11:19Z,31,2,33
NULL,32997,2016-04-15T17:03:33Z,4,2,6
A-libs;B-clarifying;I-enhancement,32999,2016-04-15T17:20:46Z,0,0,0
A-rustdoc,33002,2016-04-15T18:54:19Z,472,129,601
beta-nominated,33005,2016-04-15T19:46:45Z,248,79,327
A-rustbuild,33011,2016-04-15T20:54:36Z,8,1,9
A-libs,33023,2016-04-16T07:54:26Z,15,1,16
NULL,33033,2016-04-16T17:29:12Z,0,0,0
NULL,33034,2016-04-16T18:01:12Z,9,0,9
I-ICE,33039,2016-04-16T19:52:22Z,2,2,4
"A-syntaxext;I-wrong,A-syntaxext;I-wrong,A-grammar",33041,2016-04-16T20:26:46Z,798,858,1656
"A-syntaxext;I-wrong,A-syntaxext;I-wrong",33044,2016-04-17T01:14:17Z,224,134,358
NULL,33045,2016-04-17T02:18:18Z,56,75,131
NULL,33046,2016-04-17T02:52:48Z,5,1,6
B-RFC-approved;T-libs,33048,2016-04-17T11:52:51Z,600,612,1212
NULL,33049,2016-04-17T12:20:35Z,542,225,767
I-compiletime,33064,2016-04-18T01:12:14Z,25,11,36
NULL,33067,2016-04-18T05:23:26Z,9,0,9
NULL,33074,2016-04-18T15:42:22Z,42,41,83
NULL,33081,2016-04-18T18:50:36Z,74,52,126
A-debuginfo;A-mac-osx,33084,2016-04-18T22:47:33Z,39,8,47
T-libs,33086,2016-04-18T23:42:50Z,20,3,23
NULL,33091,2016-04-19T13:46:53Z,193,83,276
NULL,33097,2016-04-19T18:54:42Z,0,0,0
NULL,33099,2016-04-19T23:16:51Z,30,1,31
B-RFC-approved;B-unstable;T-lang,33100,2016-04-19T23:20:59Z,0,0,0
A-libs;E-easy;E-mentor;I-slow,33103,2016-04-20T08:39:55Z,45,0,45
NULL,33105,2016-04-20T10:17:56Z,0,0,0
A-diagnostics,33107,2016-04-20T13:02:54Z,20,17,37
NULL,33117,2016-04-20T20:33:18Z,0,3,3
NULL,33124,2016-04-21T04:44:47Z,0,64,64
metabug,33125,2016-04-21T05:58:14Z,87,53,140
NULL,33128,2016-04-21T12:24:23Z,53,6,59
A-docs,33129,2016-04-21T12:56:55Z,38,0,38
A-rustdoc,33133,2016-04-21T16:21:30Z,132,26,158
"A-syntaxext,A-syntaxext",33135,2016-04-21T16:24:12Z,0,0,0
NULL,33137,2016-04-21T18:19:25Z,760,233,993
I-ICE,33138,2016-04-21T20:10:55Z,845,413,1258
NULL,33148,2016-04-22T05:20:36Z,18,0,18
NULL,33153,2016-04-22T17:12:52Z,87,27,114
NULL,33154,2016-04-22T18:02:13Z,0,0,0
NULL,33155,2016-04-22T19:49:20Z,0,0,0
NULL,33157,2016-04-22T21:12:21Z,0,0,0
A-rustdoc,33160,2016-04-23T03:37:11Z,63,29,92
B-RFC-approved;B-unstable;T-lang,33161,2016-04-23T07:00:00Z,108,7,115
I-ICE,33169,2016-04-23T20:09:08Z,88,0,88
NULL,33179,2016-04-24T12:46:16Z,885,911,1796
NULL,33190,2016-04-25T03:48:01Z,73,126,199
NULL,33194,2016-04-25T05:57:21Z,4,3,7
NULL,33196,2016-04-25T09:32:19Z,79,13,92
NULL,33199,2016-04-25T15:23:37Z,148,74,222
NULL,33200,2016-04-25T16:14:33Z,1,1,2
NULL,33204,2016-04-25T20:14:52Z,301,89,390
A-tools;E-mentor,33208,2016-04-25T23:43:05Z,906,281,1187
A-rustbuild;E-easy,33209,2016-04-26T00:01:27Z,0,0,0
A-io;A-libs,33224,2016-04-26T22:25:44Z,42,0,42
NULL,33225,2016-04-26T23:03:13Z,124,50,174
A-docs;E-easy,33229,2016-04-27T00:10:33Z,45,1,46
NULL,33233,2016-04-27T08:40:35Z,0,0,0
NULL,33234,2016-04-27T08:57:11Z,1,1,2
A-debuginfo;A-mir,33235,2016-04-27T12:15:07Z,0,0,0
NULL,33236,2016-04-27T12:25:42Z,0,0,0
NULL,33238,2016-04-27T13:32:58Z,0,0,0
T-compiler,33239,2016-04-27T14:28:54Z,16,16,32
NULL,33248,2016-04-27T23:54:14Z,2,2,4
A-mir;I-needs-decision;T-compiler,33255,2016-04-28T12:15:27Z,0,0,0
NULL,33257,2016-04-28T13:51:45Z,64,13,77
NULL,33260,2016-04-28T17:26:46Z,51,10,61
NULL,33263,2016-04-28T20:24:44Z,0,64,64
NULL,33272,2016-04-29T10:33:32Z,36,7,43
A-const-fn;I-ICE,33274,2016-04-29T14:19:43Z,0,0,0
A-build;A-tools,33282,2016-04-29T21:34:07Z,182,26,208
A-docs,33283,2016-04-29T22:57:39Z,196,4,200
A-rustbuild;E-easy,33288,2016-04-30T06:18:49Z,38,11,49
A-docs;E-easy,33294,2016-04-30T17:36:08Z,76,1,77
NULL,33300,2016-04-30T23:55:01Z,25,0,25
NULL,33303,2016-05-01T06:03:27Z,448,394,842
NULL,33306,2016-05-01T08:12:16Z,73,1,74
NULL,33311,2016-05-01T17:00:48Z,20,9,29
NULL,33314,2016-05-01T17:42:40Z,5,5,10
A-build,33317,2016-05-01T18:01:12Z,31,10,41
A-libs;E-easy;E-mentor,33318,2016-05-01T18:22:31Z,27,2,29
NULL,33319,2016-05-01T18:31:27Z,37,5,42
NULL,33320,2016-05-01T18:46:43Z,7,4,11
NULL,33323,2016-05-01T19:59:20Z,70,2,72
NULL,33325,2016-05-01T20:26:12Z,0,8,8
NULL,33326,2016-05-01T21:01:15Z,14,15,29
A-diagnostics,33330,2016-05-02T05:26:34Z,15,8,23
NULL,33334,2016-05-02T05:46:41Z,4,5,9
NULL,33335,2016-05-02T06:43:30Z,5,5,10
A-diagnostics,33336,2016-05-02T06:48:46Z,3,3,6
A-diagnostics,33337,2016-05-02T07:39:46Z,48,1,49
NULL,33338,2016-05-02T08:46:33Z,11,2,13
NULL,33339,2016-05-02T09:33:45Z,67,55,122
NULL,33340,2016-05-02T09:35:13Z,54,11,65
NULL,33342,2016-05-02T12:55:39Z,36,5,41
A-diagnostics,33343,2016-05-02T13:11:20Z,18,5,23
NULL,33345,2016-05-02T14:51:17Z,21,1,22
NULL,33347,2016-05-02T15:21:02Z,0,0,0
NULL,33349,2016-05-02T15:38:09Z,0,0,0
NULL,33351,2016-05-02T16:24:25Z,99,83,182
A-docs;E-easy,33353,2016-05-02T17:22:38Z,27,1,28
NULL,33354,2016-05-02T19:32:45Z,3123,2315,5438
NULL,33355,2016-05-02T19:34:02Z,19,3,22
NULL,33358,2016-05-02T21:23:44Z,46,4,50
NULL,33359,2016-05-02T21:38:43Z,74,73,147
NULL,33363,2016-05-03T00:03:09Z,27,13,40
NULL,33367,2016-05-03T07:11:17Z,0,0,0
NULL,33369,2016-05-03T10:18:32Z,49,1,50
NULL,33370,2016-05-03T11:03:45Z,746,810,1556
NULL,33371,2016-05-03T11:12:20Z,57,12,69
"A-rustdoc,A-rustdoc",33373,2016-05-03T12:33:02Z,3,3,6
NULL,33376,2016-05-03T13:39:10Z,305,95,400
NULL,33377,2016-05-03T14:49:25Z,0,0,0
NULL,33380,2016-05-03T16:29:34Z,0,0,0
A-build,33381,2016-05-03T16:35:50Z,10,5,15
NULL,33382,2016-05-03T17:21:00Z,59,39,98
A-docs;E-easy,33383,2016-05-03T17:26:24Z,95,1,96
A-docs;E-easy,33384,2016-05-03T18:26:43Z,84,1,85
NULL,33385,2016-05-03T18:47:17Z,1,1,2
A-docs;E-easy,33386,2016-05-03T19:04:42Z,104,1,105
NULL,33388,2016-05-03T20:21:37Z,0,0,0
"A-const-fn;B-RFC-approved;T-lang,A-const-fn;B-RFC-approved;T-lang",33389,2016-05-03T20:35:56Z,0,0,0
NULL,33401,2016-05-04T16:50:17Z,384,20,404
NULL,33403,2016-05-04T17:16:43Z,3,3,6
A-rustbuild;E-easy,33404,2016-05-04T17:26:10Z,51,27,78
"beta-nominated,beta-nominated,needs-crater,beta-nominated",33407,2016-05-04T18:30:29Z,2122,454,2576
A-diagnostics,33410,2016-05-04T20:16:06Z,7,1,8
NULL,33411,2016-05-04T20:48:59Z,0,0,0
A-docs;E-easy,33412,2016-05-04T21:01:20Z,64,1,65
NULL,33414,2016-05-04T22:40:18Z,77,5,82
B-RFC-approved;T-libs,33420,2016-05-05T02:10:42Z,5,0,5
NULL,33425,2016-05-05T04:51:56Z,15089,14867,29956
B-RFC-approved;T-libs,33426,2016-05-05T05:46:20Z,451,159,610
NULL,33431,2016-05-05T13:12:29Z,106,45,151
regression-from-stable-to-nightly;relnotes,33437,2016-05-05T18:25:25Z,26,18,44
NULL,33440,2016-05-05T19:55:44Z,0,0,0
NULL,33441,2016-05-05T21:17:31Z,0,0,0
NULL,33447,2016-05-05T23:58:21Z,0,0,0
NULL,33450,2016-05-06T05:02:22Z,97,45,142
NULL,33451,2016-05-06T06:25:26Z,0,0,0
NULL,33457,2016-05-06T10:36:57Z,7,0,7
NULL,33462,2016-05-06T15:54:24Z,0,0,0
NULL,33471,2016-05-06T17:31:08Z,24,4,28
A-build,33472,2016-05-06T18:27:38Z,3,3,6
A-docs;E-easy,33475,2016-05-06T23:33:03Z,79,1,80
NULL,33476,2016-05-07T00:08:38Z,1037,370,1407
NULL,33478,2016-05-07T07:09:14Z,37,0,37
NULL,33480,2016-05-07T09:33:21Z,61,59,120
NULL,33482,2016-05-07T14:51:26Z,0,0,0
NULL,33485,2016-05-07T18:51:14Z,0,0,0
NULL,33486,2016-05-07T19:32:13Z,0,0,0
NULL,33487,2016-05-07T19:35:20Z,510,119,629
NULL,33488,2016-05-07T21:41:45Z,44,11,55
NULL,33492,2016-05-08T01:04:59Z,0,0,0
NULL,33494,2016-05-08T05:08:15Z,629,199,828
NULL,33501,2016-05-08T17:52:05Z,0,0,0
NULL,33505,2016-05-08T18:25:20Z,430,636,1066
NULL,33509,2016-05-09T08:18:43Z,1,1,2
A-rustdoc,33510,2016-05-09T09:03:15Z,0,0,0
NULL,33511,2016-05-09T09:42:46Z,0,0,0
NULL,33512,2016-05-09T13:56:46Z,23,2,25
NULL,33513,2016-05-09T14:11:26Z,32,2,34
A-rustdoc,33514,2016-05-09T14:51:27Z,38,3,41
"A-rustdoc;I-papercut,A-rustdoc;I-papercut",33516,2016-05-09T15:55:26Z,0,0,0
NULL,33523,2016-05-09T19:50:23Z,1148,925,2073
NULL,33526,2016-05-09T23:46:14Z,38,0,38
A-docs;E-easy,33533,2016-05-10T08:58:05Z,47,1,48
I-ICE,33541,2016-05-10T18:17:49Z,42,6,48
NULL,33542,2016-05-10T19:02:20Z,9,3,12
A-mir,33544,2016-05-10T19:15:07Z,113,119,232
NULL,33548,2016-05-10T21:21:28Z,0,0,0
NULL,33551,2016-05-10T21:36:57Z,0,0,0
NULL,33552,2016-05-11T00:33:56Z,124,59,183
B-RFC-approved;T-tools,33553,2016-05-11T01:24:02Z,283,94,377
NULL,33554,2016-05-11T05:05:14Z,22,43,65
NULL,33556,2016-05-11T13:27:45Z,262,20,282
NULL,33562,2016-05-11T19:30:20Z,409,25,434
A-mir,33566,2016-05-11T19:53:38Z,26,10,36
NULL,33572,2016-05-11T22:04:24Z,26,24,50
B-unstable;T-libs,33578,2016-05-12T01:01:35Z,3,3,6
NULL,33579,2016-05-12T02:33:28Z,36,58,94
NULL,33582,2016-05-12T08:41:42Z,0,0,0
"A-mir,A-mir",33583,2016-05-12T09:06:13Z,78,12,90
NULL,33589,2016-05-12T14:08:53Z,0,0,0
NULL,33595,2016-05-12T18:24:11Z,0,0,0
NULL,33596,2016-05-12T18:25:18Z,98,27,125
NULL,33597,2016-05-12T18:28:30Z,0,0,0
NULL,33599,2016-05-12T19:54:22Z,0,0,0
NULL,33600,2016-05-12T20:01:53Z,30,8,38
NULL,33610,2016-05-13T02:05:07Z,0,0,0
NULL,33615,2016-05-13T15:20:09Z,93,24,117
"I-nominated;I-wrong;T-compiler,A-codegen;I-enhancement;I-slow;P-backcompat-lang,I-nominated;I-wrong;T-compiler,A-codegen;I-enhancement;I-slow;P-backcompat-lang",33622,2016-05-13T19:56:45Z,2101,318,2419
NULL,33629,2016-05-14T03:24:05Z,0,0,0
NULL,33632,2016-05-14T09:57:50Z,1182,943,2125
"B-RFC-approved;B-unstable;T-lang,metabug,B-RFC-approved;B-unstable;T-lang,metabug",33639,2016-05-14T16:39:01Z,874,298,1172
"A-syntaxext,A-syntaxext,A-syntaxext,A-syntaxext",33642,2016-05-14T19:10:57Z,321,199,520
NULL,33643,2016-05-14T19:21:29Z,9,10,19
"metabug,metabug",33644,2016-05-15T00:00:15Z,166,282,448
NULL,33654,2016-05-15T12:39:55Z,160,239,399
NULL,33656,2016-05-15T13:31:17Z,11,1,12
NULL,33658,2016-05-15T14:43:43Z,619,43,662
NULL,33666,2016-05-16T09:07:45Z,5,21,26
NULL,33675,2016-05-16T20:58:52Z,1,0,1
A-rustdoc;I-enhancement,33679,2016-05-17T01:27:46Z,62,18,80
NULL,33680,2016-05-17T06:23:04Z,0,0,0
NULL,33683,2016-05-17T11:39:18Z,40,5,45
NULL,33688,2016-05-17T15:38:10Z,125,68,193
NULL,33692,2016-05-17T18:42:50Z,111,15,126
NULL,33694,2016-05-17T18:57:10Z,165,46,211
NULL,33696,2016-05-17T20:37:50Z,30,0,30
NULL,33698,2016-05-17T21:59:59Z,1,1,2
"B-unstable;T-libs,B-unstable;T-libs,B-unstable;T-libs,B-unstable;T-libs,B-unstable;T-libs,B-RFC-approved;T-libs,B-unstable;T-libs,B-RFC-approved,B-RFC-approved,A-io;B-unstable;T-libs",33699,2016-05-17T22:03:36Z,567,494,1061
NULL,33710,2016-05-18T08:37:46Z,55,24,79
NULL,33719,2016-05-18T16:32:47Z,38,1,39
NULL,33726,2016-05-18T21:50:41Z,0,0,0
NULL,33734,2016-05-19T03:20:02Z,68,4,72
NULL,33742,2016-05-19T15:51:08Z,221,80,301
NULL,33746,2016-05-19T22:52:19Z,4,7,11
NULL,33753,2016-05-20T10:23:06Z,2,0,2
NULL,33758,2016-05-20T13:49:54Z,415,25,440
NULL,33766,2016-05-21T02:50:38Z,191,413,604
NULL,33768,2016-05-21T03:38:11Z,81,39,120
"B-RFC,B-RFC",33769,2016-05-21T05:19:27Z,0,0,0
NULL,33785,2016-05-22T06:14:27Z,0,0,0
NULL,33787,2016-05-22T07:30:14Z,35,2,37
NULL,33793,2016-05-22T17:02:03Z,28,15,43
"A-lang;I-wrong,A-lang;I-wrong",33794,2016-05-22T18:00:21Z,312,214,526
NULL,33797,2016-05-22T19:52:07Z,1,0,1
"A-io;B-unstable;T-libs,A-io;B-unstable;T-libs,A-io;B-unstable;T-libs,A-io;B-unstable;T-libs",33801,2016-05-22T23:09:17Z,0,0,0
NULL,33803,2016-05-23T01:56:44Z,32,32,64
NULL,33810,2016-05-23T11:43:41Z,1,1,2
NULL,33816,2016-05-23T15:14:23Z,2149,633,2782
NULL,33820,2016-05-23T17:23:46Z,117,32,149
NULL,33821,2016-05-23T18:02:19Z,25,12,37
NULL,33833,2016-05-24T07:39:15Z,353,30,383
NULL,33834,2016-05-24T09:49:34Z,0,0,0
NULL,33841,2016-05-24T15:17:43Z,6,30,36
"A-libs;E-easy;E-mentor;I-slow,A-libs;E-easy;E-mentor;I-slow",33849,2016-05-24T19:53:26Z,56,28,84
"I-ICE,I-ICE",33852,2016-05-24T21:07:15Z,515,472,987
NULL,33856,2016-05-24T22:51:09Z,7,0,7
NULL,33861,2016-05-25T05:11:54Z,214,11,225
"metabug,metabug",33864,2016-05-25T08:17:52Z,1143,666,1809
NULL,33870,2016-05-25T20:16:56Z,28,7,35
NULL,33878,2016-05-26T13:31:35Z,51,17,68
beta-nominated,33883,2016-05-26T16:51:27Z,649,531,1180
NULL,33890,2016-05-26T19:43:45Z,1389,906,2295
NULL,33891,2016-05-26T19:43:47Z,1,1,2
NULL,33893,2016-05-26T22:52:48Z,28,2,30
"A-testsuite;E-easy,A-testsuite;E-easy",33894,2016-05-27T00:08:41Z,23,44,67
NULL,33900,2016-05-27T08:50:06Z,615,115,730
A-codegen;A-mir;I-wrong,33905,2016-05-27T12:16:58Z,1363,431,1794
NULL,33907,2016-05-27T16:53:34Z,80,0,80
"A-docs;E-easy,A-docs;E-easy",33920,2016-05-28T01:52:10Z,83,1,84
NULL,33921,2016-05-28T02:36:10Z,2,0,2
"A-diagnostics;I-papercut,A-diagnostics;I-papercut",33922,2016-05-28T04:27:11Z,169,20,189
NULL,33926,2016-05-28T08:53:48Z,38,60,98
NULL,33927,2016-05-28T12:54:13Z,787,612,1399
"A-libs;E-easy;E-mentor;I-slow,A-libs;E-easy;E-mentor;I-slow",33932,2016-05-28T18:36:41Z,0,0,0
NULL,33935,2016-05-28T23:38:43Z,0,0,0
NULL,33940,2016-05-29T05:38:24Z,336,77,413
"metabug,metabug",33943,2016-05-29T09:44:44Z,261,355,616
"A-libs;B-RFC-approved,A-libs;B-RFC-approved",33947,2016-05-29T14:27:03Z,538,92,630
NULL,33948,2016-05-29T14:28:07Z,0,0,0
"A-docs;E-easy,A-docs;E-easy",33955,2016-05-30T00:58:25Z,24,1,25
NULL,33958,2016-05-30T09:14:55Z,2,2,4
NULL,33959,2016-05-30T09:49:01Z,261,104,365
"A-libs;E-easy;I-wrong,A-libs;E-easy;I-wrong",33960,2016-05-30T10:18:17Z,3,1,4
"A-diagnostics;A-parser,A-diagnostics;A-parser",33963,2016-05-30T12:43:59Z,0,0,0
NULL,33965,2016-05-30T15:05:47Z,196,165,361
NULL,33967,2016-05-30T16:33:29Z,10,7,17
"A-build;A-infrastructure,A-build;A-infrastructure",33971,2016-05-30T20:42:03Z,11,1,12
NULL,33973,2016-05-30T22:38:31Z,26,16,42
"A-spurious;A-windows,A-spurious;A-windows",33979,2016-05-31T09:48:11Z,5,1,6
NULL,33982,2016-05-31T14:58:43Z,29,277,306
"A-debuginfo;A-mir,A-debuginfo;A-mir",33989,2016-05-31T19:00:13Z,478,493,971
"A-rustbuild;A-spurious,A-rustbuild;A-spurious",33991,2016-05-31T20:25:23Z,8,3,11
NULL,33994,2016-05-31T22:50:30Z,0,0,0
NULL,33996,2016-05-31T23:30:46Z,40,12,52
NULL,33998,2016-06-01T00:02:49Z,447,82,529
"A-mir,A-mir",33999,2016-06-01T00:11:21Z,65,10,75
NULL,34000,2016-06-01T01:51:57Z,55,33,88
NULL,34002,2016-06-01T02:33:33Z,41,51,92
"A-codegen;I-ICE,A-codegen;I-ICE,A-codegen;I-ICE",34003,2016-06-01T04:01:34Z,22,0,22
NULL,34004,2016-06-01T07:27:43Z,354,81,435
NULL,34005,2016-06-01T08:40:53Z,0,0,0
"A-amusing;A-mir,A-amusing;A-mir",34006,2016-06-01T09:50:19Z,302,107,409
NULL,34007,2016-06-01T10:38:07Z,19,1,20
NULL,34010,2016-06-01T11:36:35Z,32,13,45
NULL,34016,2016-06-01T15:31:39Z,34,8,42
NULL,34019,2016-06-01T16:03:39Z,3,2,5
NULL,34026,2016-06-01T23:05:44Z,0,0,0
"regression-from-stable-to-nightly,regression-from-stable-to-nightly",34031,2016-06-02T08:03:03Z,32,9,41
"A-macros,A-macros",34032,2016-06-02T08:22:51Z,99,97,196
NULL,34034,2016-06-02T11:47:09Z,344,17,361
NULL,34039,2016-06-02T14:40:49Z,6,0,6
"metabug,metabug",34044,2016-06-02T16:33:52Z,0,0,0
NULL,34045,2016-06-02T16:50:50Z,46,17,63
"I-ICE,I-ICE",34052,2016-06-02T22:00:32Z,17,0,17
"A-codegen;A-mir;I-wrong,A-codegen;A-mir;I-wrong",34054,2016-06-03T01:39:53Z,0,0,0
NULL,34062,2016-06-03T11:59:24Z,4,3,7
NULL,34073,2016-06-04T08:49:09Z,0,0,0
"A-spurious;A-windows,A-windows;I-wrong,A-spurious;A-windows,A-windows;I-wrong",34083,2016-06-05T05:33:34Z,16,4,20
NULL,34084,2016-06-05T07:33:54Z,0,0,0
NULL,34095,2016-06-05T13:55:09Z,696,1217,1913
NULL,34096,2016-06-05T16:32:19Z,66,33,99
NULL,34102,2016-06-05T19:33:16Z,61,32,93
NULL,34104,2016-06-05T22:26:38Z,2,2,4
"A-mir,A-mir",34109,2016-06-06T15:00:27Z,103,28,131
NULL,34118,2016-06-06T17:45:56Z,0,0,0
NULL,34120,2016-06-06T19:44:53Z,0,0,0
NULL,34125,2016-06-06T22:33:20Z,4,1,5
"relnotes,relnotes,relnotes,relnotes",34128,2016-06-06T23:29:30Z,33,11,44
"A-docs;E-easy,A-docs;E-easy",34133,2016-06-07T07:59:24Z,100,2,102
NULL,34136,2016-06-07T10:39:26Z,27,0,27
NULL,34138,2016-06-07T13:37:04Z,3,3,6
NULL,34139,2016-06-07T14:43:59Z,483,331,814
NULL,34141,2016-06-07T15:31:06Z,137,194,331
NULL,34155,2016-06-07T22:52:19Z,0,15,15
NULL,34164,2016-06-08T18:11:33Z,0,0,0
NULL,34169,2016-06-08T23:53:58Z,871,3,874
NULL,34172,2016-06-09T00:42:00Z,28,0,28
NULL,34180,2016-06-09T14:52:43Z,212,6,218
NULL,34186,2016-06-09T22:37:08Z,63,28,91
NULL,34187,2016-06-09T22:40:30Z,100,60,160
NULL,34190,2016-06-09T22:52:07Z,28,0,28
NULL,34192,2016-06-09T23:05:35Z,0,0,0
NULL,34193,2016-06-09T23:43:32Z,127,18,145
NULL,34196,2016-06-10T08:14:18Z,0,0,0
NULL,34198,2016-06-10T09:53:12Z,153,116,269
NULL,34200,2016-06-10T12:16:47Z,349,262,611
NULL,34207,2016-06-10T21:41:24Z,13,42,55
"metabug,metabug",34213,2016-06-11T01:05:31Z,238,87,325
"A-docs;E-easy,A-docs;E-easy",34230,2016-06-11T21:44:55Z,0,0,0
NULL,34236,2016-06-12T02:10:36Z,0,0,0
NULL,34239,2016-06-12T05:52:09Z,91,26,117
NULL,34241,2016-06-12T15:08:52Z,33,0,33
"A-docs;E-easy,A-docs;E-easy",34242,2016-06-12T20:01:55Z,45,1,46
NULL,34243,2016-06-12T21:22:18Z,23,0,23
NULL,34252,2016-06-13T07:15:20Z,24,0,24
NULL,34253,2016-06-13T08:07:04Z,77,100,177
NULL,34254,2016-06-13T08:08:03Z,0,0,0
"A-book,A-book",34258,2016-06-13T17:23:49Z,63,10,73
NULL,34262,2016-06-13T21:53:11Z,16,0,16
NULL,34290,2016-06-15T21:26:40Z,15,8,23
NULL,34291,2016-06-15T21:59:21Z,126,182,308
NULL,34296,2016-06-16T09:02:48Z,44,0,44
A-testsuite;E-easy,34309,2016-06-16T18:13:59Z,0,0,0
"A-syntaxext,A-syntaxext",34312,2016-06-16T20:17:54Z,859,859,1718
NULL,34315,2016-06-16T23:12:05Z,1037,934,1971
"metabug,metabug",34316,2016-06-17T03:26:20Z,332,411,743
NULL,34317,2016-06-17T04:00:24Z,0,0,0
NULL,34322,2016-06-17T10:09:01Z,3,1,4
NULL,34336,2016-06-18T00:05:39Z,19,4,23
"metabug,metabug",34339,2016-06-18T06:55:35Z,278,317,595
NULL,34342,2016-06-18T13:57:59Z,1,33,34
NULL,34348,2016-06-18T18:57:54Z,21,0,21
"I-ICE,I-ICE",34350,2016-06-18T22:32:07Z,14,0,14
NULL,34351,2016-06-18T22:46:06Z,18,0,18
NULL,34355,2016-06-19T02:16:17Z,12,7,19
NULL,34358,2016-06-19T11:13:14Z,0,0,0
NULL,34363,2016-06-19T14:00:39Z,40,6,46
NULL,34364,2016-06-19T15:28:55Z,25,6,31
NULL,34365,2016-06-19T17:07:43Z,646,818,1464
NULL,34367,2016-06-19T17:52:01Z,20,0,20
"needs-crater,metabug,needs-crater,metabug",34368,2016-06-19T18:56:05Z,24,46,70
"A-parser;A-syntaxext;P-low,A-parser;A-syntaxext;P-low",34374,2016-06-20T03:22:09Z,163,596,759
"metabug,metabug",34385,2016-06-20T18:20:58Z,342,287,629
"B-unstable;T-lang,B-unstable;T-lang",34397,2016-06-21T10:38:17Z,0,0,0
"relnotes,relnotes",34399,2016-06-21T17:16:12Z,26,31,57
NULL,34402,2016-06-21T21:54:29Z,85,7,92
NULL,34408,2016-06-22T08:51:09Z,188,46,234
NULL,34419,2016-06-23T00:35:22Z,34,1,35
NULL,34420,2016-06-23T01:36:14Z,0,0,0
NULL,34422,2016-06-23T05:55:09Z,0,0,0
NULL,34424,2016-06-23T07:10:15Z,3969,3646,7615
"metabug,metabug",34436,2016-06-23T21:08:45Z,157,123,280
NULL,34439,2016-06-23T22:30:09Z,33,10,43
I-ICE;I-nominated;T-lang,34443,2016-06-24T00:28:11Z,44,0,44
NULL,34446,2016-06-24T03:40:02Z,53,88,141
NULL,34450,2016-06-24T11:48:57Z,36,1,37
NULL,34453,2016-06-24T14:16:37Z,18,0,18
NULL,34460,2016-06-24T22:16:57Z,11,0,11
NULL,34464,2016-06-25T08:46:21Z,181,41,222
NULL,34470,2016-06-25T14:41:24Z,0,0,0
NULL,34477,2016-06-25T22:26:27Z,1,1,2
NULL,34479,2016-06-26T02:11:18Z,24,2,26
NULL,34485,2016-06-26T13:40:52Z,1032,29,1061
"A-mir;A-servo;I-nominated;T-compiler,A-mir;A-servo;I-nominated;T-compiler",34491,2016-06-26T23:04:44Z,0,125,125
NULL,34492,2016-06-26T23:35:03Z,260,181,441
A-grammar;A-parser;I-wrong;T-compiler,34495,2016-06-27T03:34:33Z,4,4,8
NULL,34497,2016-06-27T09:47:18Z,42,48,90
NULL,34498,2016-06-27T14:34:55Z,0,0,0
NULL,34499,2016-06-27T15:20:24Z,15,0,15
NULL,34500,2016-06-27T15:20:32Z,0,0,0
NULL,34508,2016-06-27T17:44:24Z,0,0,0
NULL,34512,2016-06-27T21:41:13Z,1,1,2
NULL,34515,2016-06-27T23:30:35Z,52,49,101
NULL,34525,2016-06-28T14:05:17Z,141,75,216
"B-unstable;T-libs,B-unstable;T-libs,A-collections,B-unstable;T-libs,B-RFC-approved;B-unstable",34530,2016-06-28T17:12:23Z,507,194,701
NULL,34533,2016-06-28T18:34:36Z,123,128,251
NULL,34539,2016-06-28T22:37:02Z,214,159,373
NULL,34541,2016-06-29T00:56:37Z,46,47,93
NULL,34542,2016-06-29T01:17:47Z,31,1,32
NULL,34546,2016-06-29T09:47:04Z,22,3,25
NULL,34547,2016-06-29T12:54:37Z,33,23,56
NULL,34550,2016-06-29T14:41:07Z,8,1,9
"beta-nominated,beta-nominated",34552,2016-06-29T15:51:24Z,620,445,1065
NULL,34558,2016-06-29T17:48:38Z,1,1,2
NULL,34561,2016-06-29T19:13:09Z,0,0,0
NULL,34570,2016-06-30T06:25:55Z,251,806,1057
NULL,34573,2016-06-30T11:41:54Z,0,0,0
NULL,34578,2016-06-30T17:29:22Z,1,1,2
NULL,34589,2016-06-30T22:43:28Z,1,32,33
NULL,34594,2016-07-01T09:00:15Z,117,2,119
NULL,34604,2016-07-01T21:48:30Z,106,58,164
NULL,34605,2016-07-01T23:16:55Z,87,8,95
NULL,34608,2016-07-02T02:31:39Z,283,352,635
A-rustbuild;E-easy,34614,2016-07-02T14:33:02Z,12,0,12
NULL,34623,2016-07-03T05:01:56Z,52,5,57
NULL,34627,2016-07-03T10:48:23Z,0,0,0
"beta-nominated,beta-nominated",34635,2016-07-03T17:54:13Z,161,55,216
A-docs,34659,2016-07-05T09:39:38Z,12,2,14
NULL,34660,2016-07-05T09:45:11Z,125,119,244
NULL,34663,2016-07-05T15:08:33Z,0,0,0
NULL,34670,2016-07-05T18:07:24Z,0,0,0
NULL,34682,2016-07-06T13:08:15Z,32,3,35
NULL,34684,2016-07-06T14:58:28Z,24,4,28
NULL,34688,2016-07-06T17:18:40Z,12,6,18
NULL,34690,2016-07-06T18:37:02Z,20,8,28
NULL,34693,2016-07-06T21:07:53Z,0,0,0
A-io;B-unstable;T-libs,34694,2016-07-06T23:02:26Z,121,0,121
NULL,34700,2016-07-07T11:47:34Z,30,1,31
A-docs,34709,2016-07-07T21:03:13Z,62,0,62
NULL,34720,2016-07-08T07:44:21Z,84,90,174
A-docs,34725,2016-07-08T15:22:25Z,236,9,245
NULL,34728,2016-07-09T00:29:39Z,74,40,114
"A-docs,A-docs",34732,2016-07-09T03:14:37Z,4,3,7
A-docs,34733,2016-07-09T04:02:02Z,46,43,89
A-docs,34736,2016-07-09T13:02:14Z,49,0,49
"A-io;B-unstable;T-libs,A-io;B-unstable;T-libs",34739,2016-07-09T17:55:37Z,4,0,4
A-docs,34740,2016-07-09T17:57:55Z,46,3,49
A-docs,34742,2016-07-09T20:43:31Z,3,1,4
A-docs,34749,2016-07-10T13:10:41Z,158,2,160
A-docs,34750,2016-07-10T14:03:12Z,70,0,70
A-compiler;A-lint;I-cleanup,34755,2016-07-10T21:31:34Z,135,254,389
NULL,34757,2016-07-10T22:39:26Z,3,3,6
"B-RFC-approved,B-RFC-approved",34764,2016-07-11T15:30:31Z,389,14,403
B-unstable;T-libs,34768,2016-07-11T20:11:11Z,8,8,16
T-libs,34776,2016-07-12T05:10:27Z,41,23,64
NULL,34778,2016-07-12T10:08:25Z,357,19,376
NULL,34785,2016-07-12T17:19:32Z,0,0,0
A-runtime;E-easy;I-cleanup,34789,2016-07-12T19:31:17Z,1550,2118,3668
A-docs,34804,2016-07-13T15:39:51Z,24,5,29
I-nominated;regression-from-stable-to-beta;T-compiler,34805,2016-07-13T18:27:06Z,74,1,75
NULL,34816,2016-07-14T10:27:55Z,13,1,14
NULL,34819,2016-07-14T15:37:26Z,200,80,280
A-diagnostics;I-wrong,34824,2016-07-14T17:31:59Z,1,2,3
"A-linkage,A-linkage",34830,2016-07-14T21:28:14Z,145,41,186
A-libs;E-mentor;I-slow,34836,2016-07-15T15:20:46Z,11,9,20
NULL,34838,2016-07-15T17:19:32Z,56,30,86
NULL,34841,2016-07-15T20:48:42Z,3,3,6
"A-tools,A-tools",34845,2016-07-16T05:24:36Z,160,21,181
I-ICE;I-nominated;regression-from-stable-to-nightly;T-compiler,34846,2016-07-16T08:46:52Z,33,1,34
NULL,34852,2016-07-16T14:56:00Z,85,45,130
A-docs,34854,2016-07-16T15:32:02Z,65,9,74
A-docs,34855,2016-07-16T16:01:28Z,71,1,72
NULL,34863,2016-07-16T20:31:36Z,0,0,0
NULL,34864,2016-07-16T20:31:44Z,0,0,0
"A-libs;E-mentor;I-slow,A-libs;E-mentor;I-slow",34866,2016-07-16T21:00:19Z,40,23,63
NULL,34873,2016-07-17T00:26:13Z,750,209,959
NULL,34879,2016-07-17T07:24:40Z,25,2,27
NULL,34880,2016-07-17T10:11:01Z,7,7,14
NULL,34883,2016-07-17T13:48:15Z,0,0,0
NULL,34894,2016-07-18T01:06:12Z,0,0,0
NULL,34897,2016-07-18T12:54:17Z,0,0,0
NULL,34898,2016-07-18T13:44:57Z,62,3,65
"A-linkage,T-compiler,I-slow",34899,2016-07-18T14:42:18Z,15,21,36
I-nominated;T-lang,34904,2016-07-18T19:55:21Z,103,73,176
NULL,34907,2016-07-18T22:12:25Z,1017,844,1861
"A-syntaxext;P-high,A-macros;A-parser,A-syntaxext;P-high,A-syntaxext;P-high,A-macros;A-parser,A-syntaxext;P-high",34908,2016-07-18T23:21:08Z,37,3,40
NULL,34910,2016-07-18T23:31:14Z,1,1,2
NULL,34917,2016-07-19T09:56:12Z,78,16,94
A-docs,34919,2016-07-19T12:43:41Z,189,2,191
NULL,34923,2016-07-19T17:57:38Z,1,1,2
"A-parser;A-syntaxext;P-low,A-parser;A-syntaxext;P-low",34925,2016-07-19T20:26:59Z,14,1,15
NULL,34927,2016-07-19T21:38:19Z,1,1,2
A-docs,34935,2016-07-20T12:48:05Z,198,5,203
NULL,34936,2016-07-20T12:49:39Z,0,0,0
NULL,34939,2016-07-20T14:37:18Z,435,26,461
NULL,34942,2016-07-20T22:29:49Z,27,15,42
NULL,34944,2016-07-20T22:56:49Z,0,0,0
NULL,34951,2016-07-21T08:14:03Z,18,5,23
NULL,34954,2016-07-21T14:50:42Z,0,0,0
"A-incr-comp;T-compiler,A-incr-comp;T-compiler",34956,2016-07-21T16:59:46Z,1245,197,1442
NULL,34963,2016-07-21T18:46:42Z,29,2,31
I-ICE;regression-from-stable-to-beta,34964,2016-07-21T19:56:30Z,51,1,52
A-tools;E-easy,34967,2016-07-21T21:00:31Z,1,1,2
NULL,34969,2016-07-21T23:08:56Z,24,1,25
"A-docs;E-easy,A-docs;E-easy",34970,2016-07-22T04:59:09Z,0,0,0
A-docs,34975,2016-07-22T13:01:32Z,19,0,19
T-tools,34980,2016-07-22T20:32:49Z,368,218,586
NULL,34982,2016-07-22T21:05:23Z,50,314,364
NULL,34983,2016-07-22T23:22:53Z,6,1,7
NULL,34986,2016-07-23T00:18:36Z,123,53,176
NULL,34989,2016-07-23T01:45:34Z,4,3,7
E-easy;I-cleanup,34994,2016-07-23T13:04:40Z,0,0,0
"A-docs,A-docs;metabug",34995,2016-07-23T17:14:28Z,28,1,29
NULL,34996,2016-07-23T18:56:55Z,0,0,0
NULL,35003,2016-07-24T02:26:30Z,0,0,0
NULL,35006,2016-07-24T09:48:48Z,73,30,103
A-docs,35009,2016-07-24T14:53:25Z,100,12,112
A-docs,35010,2016-07-24T15:01:34Z,23,5,28
NULL,35013,2016-07-24T19:50:39Z,0,0,0
NULL,35015,2016-07-24T22:38:07Z,114,47,161
NULL,35021,2016-07-25T03:06:33Z,739,616,1355
NULL,35026,2016-07-25T09:41:07Z,0,0,0
NULL,35027,2016-07-25T09:44:50Z,0,0,0
NULL,35028,2016-07-25T09:48:35Z,0,369,369
NULL,35032,2016-07-25T16:50:44Z,314,270,584
NULL,35033,2016-07-25T17:20:20Z,3,0,3
NULL,35034,2016-07-25T17:27:51Z,0,0,0
NULL,35036,2016-07-25T18:46:37Z,0,0,0
NULL,35037,2016-07-25T19:27:48Z,30,3,33
E-easy;E-needstest,35049,2016-07-26T18:32:04Z,11,0,11
NULL,35053,2016-07-26T21:21:14Z,624,415,1039
NULL,35055,2016-07-26T22:44:50Z,74,1,75
NULL,35060,2016-07-27T01:19:03Z,144,21,165
B-RFC-approved;B-unstable;T-lang,35063,2016-07-27T03:22:51Z,43,58,101
NULL,35069,2016-07-27T13:50:27Z,2,7,9
NULL,35072,2016-07-27T17:17:56Z,18,0,18
"B-RFC-approved;T-libs,B-RFC-approved;T-libs",35074,2016-07-27T17:48:24Z,100,2,102
"A-docs,A-docs",35076,2016-07-27T18:59:15Z,59,1,60
"A-incr-comp,A-incr-comp",35079,2016-07-27T21:33:24Z,815,483,1298
NULL,35086,2016-07-28T10:50:12Z,260,161,421
A-docs,35087,2016-07-28T11:07:59Z,101,0,101
"B-unstable,B-unstable",35091,2016-07-28T16:21:04Z,2788,532,3320
NULL,35095,2016-07-28T18:30:24Z,0,0,0
NULL,35098,2016-07-28T20:38:53Z,0,0,0
NULL,35100,2016-07-28T22:14:32Z,206,27,233
I-ICE;P-high;regression-from-stable-to-nightly;T-compiler,35106,2016-07-29T08:43:33Z,9,1,10
"A-docs,A-docs",35109,2016-07-29T12:36:00Z,222,2,224
NULL,35114,2016-07-29T16:13:05Z,335,175,510
B-RFC-approved;B-unstable;T-lang,35116,2016-07-29T17:34:31Z,223,218,441
NULL,35117,2016-07-29T18:38:02Z,9,0,9
NULL,35125,2016-07-30T00:26:18Z,0,0,0
NULL,35127,2016-07-30T08:14:48Z,338,348,686
A-diagnostics,35130,2016-07-30T16:02:25Z,43,7,50
B-RFC-approved;B-unstable;T-lang,35138,2016-07-31T13:27:05Z,330,218,548
NULL,35140,2016-07-31T18:12:44Z,5,2,7
NULL,35143,2016-07-31T20:02:01Z,83,71,154
A-diagnostics,35145,2016-07-31T20:30:38Z,26,40,66
NULL,35151,2016-07-31T23:17:24Z,1,0,1
NULL,35156,2016-08-01T07:49:24Z,0,0,0
NULL,35157,2016-08-01T09:05:43Z,0,6,6
A-incr-comp,35159,2016-08-01T10:09:42Z,29,1,30
NULL,35161,2016-08-01T10:27:39Z,0,0,0
NULL,35163,2016-08-01T15:12:41Z,372,474,846
"A-incr-comp;T-compiler,A-compiler;A-incr-comp;T-compiler,A-incr-comp;T-compiler",35166,2016-08-01T18:18:59Z,1117,579,1696
NULL,35172,2016-08-01T20:58:54Z,92,13,105
NULL,35174,2016-08-01T23:37:26Z,2937,2656,5593
A-docs,35181,2016-08-02T12:00:26Z,19,0,19
NULL,35234,2016-08-03T00:54:07Z,35,15,50
NULL,35235,2016-08-03T01:12:41Z,0,0,0
NULL,35236,2016-08-03T01:55:07Z,270,136,406
NULL,35240,2016-08-03T11:50:37Z,0,0,0
NULL,35260,2016-08-03T18:20:09Z,0,0,0
A-diagnostics;E-easy;E-mentor,35264,2016-08-03T20:40:59Z,39,3,42
A-diagnostics;E-easy;E-mentor,35266,2016-08-03T23:16:56Z,5,2,7
NULL,35267,2016-08-03T23:18:34Z,248,191,439
NULL,35279,2016-08-04T00:15:21Z,37,8,45
A-diagnostics;E-easy;E-mentor,35283,2016-08-04T02:04:36Z,105,105,210
NULL,35285,2016-08-04T08:42:38Z,14,5,19
"B-RFC-approved;B-unstable;T-lang,B-RFC-approved;B-unstable;T-lang",35286,2016-08-04T09:29:17Z,11,1,12
A-diagnostics;E-easy;E-mentor,35288,2016-08-04T10:42:29Z,10,4,14
A-diagnostics;E-easy;E-mentor,35289,2016-08-04T12:10:23Z,33,9,42
NULL,35291,2016-08-04T13:26:54Z,2,0,2
A-diagnostics;E-easy;E-mentor,35294,2016-08-04T14:14:36Z,7,3,10
A-diagnostics;E-easy;E-mentor,35296,2016-08-04T14:33:42Z,13,4,17
A-diagnostics;E-easy,35297,2016-08-04T14:42:32Z,5,0,5
NULL,35298,2016-08-04T15:14:10Z,15,4,19
A-diagnostics;E-easy;E-mentor,35299,2016-08-04T15:56:57Z,6,2,8
E-easy;I-cleanup,35300,2016-08-04T16:47:12Z,43,1,44
A-diagnostics;E-easy;E-mentor,35314,2016-08-04T18:20:50Z,20,4,24
NULL,35317,2016-08-04T18:42:52Z,205,25,230
NULL,35318,2016-08-04T19:11:28Z,12,7,19
A-diagnostics;E-easy;E-mentor,35319,2016-08-04T19:28:40Z,9,4,13
NULL,35320,2016-08-04T19:33:44Z,0,0,0
NULL,35321,2016-08-04T19:33:48Z,0,0,0
NULL,35326,2016-08-04T20:55:32Z,13,5,18
A-diagnostics;E-easy;E-mentor,35328,2016-08-04T20:59:18Z,20,4,24
NULL,35331,2016-08-04T21:19:15Z,9,3,12
NULL,35332,2016-08-04T21:25:30Z,0,0,0
NULL,35333,2016-08-04T21:37:30Z,7,3,10
"A-incr-comp,A-incr-comp",35340,2016-08-04T22:35:46Z,1186,248,1434
NULL,35346,2016-08-04T23:14:19Z,8,3,11
NULL,35348,2016-08-04T23:52:41Z,156,18,174
A-diagnostics;E-easy;E-mentor,35350,2016-08-05T03:46:41Z,10,5,15
NULL,35351,2016-08-05T03:49:53Z,7,3,10
NULL,35352,2016-08-05T04:24:37Z,0,0,0
NULL,35353,2016-08-05T04:25:33Z,14,8,22
NULL,35355,2016-08-05T04:37:36Z,18,5,23
NULL,35356,2016-08-05T04:43:13Z,15,5,20
NULL,35357,2016-08-05T04:51:14Z,6,2,8
"A-diagnostics;E-easy;E-mentor,A-diagnostics;E-easy;E-mentor",35359,2016-08-05T08:48:46Z,11,2,13
A-diagnostics;E-easy;E-mentor,35360,2016-08-05T09:39:10Z,5,2,7
A-diagnostics;E-easy;E-mentor,35362,2016-08-05T11:17:41Z,10,4,14
A-diagnostics;E-easy;E-mentor,35364,2016-08-05T11:27:40Z,6,2,8
NULL,35365,2016-08-05T11:58:12Z,709,72,781
A-diagnostics;E-easy;E-mentor,35366,2016-08-05T12:58:43Z,41,17,58
A-diagnostics;E-easy;E-mentor,35368,2016-08-05T14:08:13Z,12,4,16
A-diagnostics;E-easy;E-mentor,35370,2016-08-05T14:55:49Z,54,19,73
A-docs,35371,2016-08-05T15:37:29Z,6,7,13
"A-diagnostics;E-easy;E-mentor,A-diagnostics;E-easy;E-mentor,A-diagnostics;E-easy;E-mentor",35372,2016-08-05T15:54:16Z,30,8,38
NULL,35373,2016-08-05T16:13:01Z,33,6,39
A-diagnostics;E-easy;E-mentor,35374,2016-08-05T17:22:45Z,8,3,11
A-diagnostics;E-easy;E-mentor,35375,2016-08-05T18:08:19Z,25,3,28
A-diagnostics;E-easy;E-mentor,35376,2016-08-05T18:09:27Z,56,3,59
NULL,35380,2016-08-05T19:12:23Z,14,2,16
A-diagnostics;E-easy;E-mentor,35394,2016-08-05T20:37:39Z,7,4,11
NULL,35395,2016-08-05T21:23:50Z,0,0,0
NULL,35396,2016-08-05T21:24:26Z,7,2,9
NULL,35397,2016-08-05T21:54:09Z,0,0,0
B-RFC-approved;T-compiler;T-tools,35401,2016-08-05T23:13:43Z,31,599,630
A-diagnostics;E-easy;E-mentor,35402,2016-08-05T23:15:40Z,39,15,54
"A-testsuite;E-mentor;I-papercut;P-low,A-testsuite;E-mentor;I-papercut;P-low",35405,2016-08-06T00:18:14Z,58,1,59
A-incr-comp;T-compiler,35406,2016-08-06T00:36:36Z,1117,579,1696
NULL,35407,2016-08-06T01:50:57Z,701,260,961
"A-mir;I-nominated;regression-from-stable-to-nightly;T-compiler,A-linux,A-linux;T-compiler",35409,2016-08-06T02:16:18Z,387,85,472
NULL,35410,2016-08-06T02:29:54Z,8,4,12
A-diagnostics;E-easy;E-mentor,35411,2016-08-06T03:46:40Z,31,10,41
"A-diagnostics;E-easy;E-mentor,A-diagnostics;E-easy;E-mentor",35412,2016-08-06T04:25:06Z,0,0,0
NULL,35413,2016-08-06T06:37:59Z,11,8,19
NULL,35414,2016-08-06T07:12:57Z,26,5,31
NULL,35415,2016-08-06T07:21:44Z,7,5,12
A-diagnostics;E-easy;E-mentor,35417,2016-08-06T08:04:28Z,12,6,18
"A-diagnostics;E-easy;E-mentor,A-diagnostics;E-easy;E-mentor",35419,2016-08-06T11:05:27Z,57,25,82
A-diagnostics;E-easy;E-mentor,35421,2016-08-06T13:37:18Z,8,3,11
B-RFC-approved;T-libs,35425,2016-08-06T17:52:06Z,132,9,141
NULL,35427,2016-08-06T18:45:44Z,26,3,29
B-unstable;T-libs,35429,2016-08-06T19:17:04Z,1,1,2
NULL,35430,2016-08-06T19:43:46Z,0,0,0
NULL,35432,2016-08-06T20:01:33Z,21,0,21
A-diagnostics;E-easy;E-mentor,35434,2016-08-06T20:11:15Z,41,2,43
NULL,35438,2016-08-06T23:06:43Z,0,0,0
NULL,35439,2016-08-06T23:24:57Z,5,2,7
NULL,35441,2016-08-07T00:00:51Z,0,0,0
"A-diagnostics;E-easy;E-mentor,A-diagnostics;E-easy;E-mentor",35443,2016-08-07T01:20:46Z,16,6,22
A-libs;A-runtime;I-slow,35444,2016-08-07T01:56:20Z,68,36,104
NULL,35449,2016-08-07T05:30:42Z,12,8,20
A-macros,35453,2016-08-07T07:22:28Z,41,14,55
NULL,35454,2016-08-07T07:48:25Z,16,10,26
A-diagnostics;E-easy;E-mentor,35455,2016-08-07T07:57:50Z,16,8,24
NULL,35456,2016-08-07T08:00:49Z,74,20,94
NULL,35458,2016-08-07T11:55:57Z,19,0,19
NULL,35462,2016-08-07T14:25:23Z,0,0,0
A-diagnostics;E-easy;E-mentor,35467,2016-08-07T15:52:50Z,9,4,13
A-diagnostics;E-easy;E-mentor,35468,2016-08-07T16:49:38Z,12,5,17
NULL,35469,2016-08-07T16:59:45Z,345,126,471
A-diagnostics;E-easy;E-mentor,35470,2016-08-07T17:23:28Z,8,3,11
NULL,35476,2016-08-07T21:18:03Z,0,0,0
A-diagnostics;E-easy;E-mentor,35480,2016-08-08T00:26:20Z,131,66,197
A-diagnostics;E-easy;E-mentor,35484,2016-08-08T04:36:12Z,14,9,23
NULL,35485,2016-08-08T05:38:30Z,6,1,7
A-diagnostics;E-easy;E-mentor,35486,2016-08-08T06:34:17Z,30,17,47
NULL,35489,2016-08-08T10:27:31Z,1,1,2
A-diagnostics,35491,2016-08-08T12:37:06Z,37,25,62
A-diagnostics;E-easy;E-mentor,35493,2016-08-08T17:17:55Z,0,0,0
A-diagnostics;E-easy;E-mentor,35504,2016-08-08T18:59:41Z,13,5,18
I-nominated;I-unsound,35505,2016-08-08T19:09:21Z,21,0,21
A-diagnostics;E-easy;E-mentor,35507,2016-08-08T19:16:35Z,9,4,13
A-diagnostics;E-easy;E-mentor,35524,2016-08-08T20:23:13Z,5,1,6
NULL,35525,2016-08-08T20:26:00Z,133,56,189
A-diagnostics;E-easy;E-mentor,35526,2016-08-08T20:39:44Z,14,6,20
NULL,35527,2016-08-08T20:54:42Z,123,53,176
NULL,35528,2016-08-08T21:19:40Z,11,5,16
A-diagnostics;E-easy;E-mentor,35530,2016-08-08T21:42:37Z,15,5,20
NULL,35532,2016-08-08T22:08:11Z,1,6,7
I-nominated;regression-from-stable-to-nightly;T-compiler,35534,2016-08-08T22:44:49Z,142,15,157
A-diagnostics;E-easy;E-mentor,35536,2016-08-08T22:53:01Z,4,1,5
A-diagnostics;E-easy;E-mentor,35537,2016-08-08T22:55:37Z,24,7,31
A-diagnostics;E-easy;E-mentor,35541,2016-08-09T00:11:22Z,5,2,7
NULL,35552,2016-08-09T17:38:24Z,17,9,26
NULL,35555,2016-08-09T20:16:10Z,8,3,11
A-diagnostics;E-easy;E-mentor,35556,2016-08-09T20:24:50Z,0,0,0
NULL,35557,2016-08-09T20:44:27Z,13,5,18
NULL,35558,2016-08-09T21:37:21Z,6,2,8
NULL,35561,2016-08-10T05:50:16Z,0,0,0
A-diagnostics;E-easy;E-mentor,35563,2016-08-10T06:59:46Z,0,0,0
NULL,35565,2016-08-10T07:52:43Z,17,7,24
NULL,35567,2016-08-10T12:23:31Z,13,5,18
NULL,35571,2016-08-10T15:51:29Z,0,0,0
NULL,35573,2016-08-10T17:03:19Z,11,3,14
NULL,35574,2016-08-10T18:20:54Z,68,13,81
A-diagnostics;E-easy;E-mentor,35575,2016-08-10T18:56:03Z,0,0,0
NULL,35576,2016-08-10T19:16:07Z,6,0,6
NULL,35577,2016-08-10T19:37:47Z,11,6,17
NULL,35578,2016-08-10T20:15:14Z,0,0,0
NULL,35581,2016-08-10T23:56:31Z,0,0,0
NULL,35585,2016-08-11T02:36:40Z,20,20,40
A-diagnostics;E-easy;E-mentor,35586,2016-08-11T08:03:01Z,14,6,20
NULL,35592,2016-08-11T13:34:02Z,543,376,919
NULL,35596,2016-08-11T18:23:12Z,9,3,12
NULL,35606,2016-08-11T21:47:11Z,1,1,2
"A-io;B-unstable;T-libs,B-RFC-approved;T-libs,B-unstable;T-libs,B-unstable;T-libs,A-io;A-libs,B-RFC-approved;T-libs,B-unstable;T-libs",35607,2016-08-11T22:05:02Z,94,66,160
NULL,35608,2016-08-11T22:30:47Z,0,0,0
NULL,35615,2016-08-12T06:49:14Z,8,2,10
A-diagnostics;E-easy;E-mentor,35616,2016-08-12T08:25:05Z,9,1,10
NULL,35617,2016-08-12T08:46:14Z,19,2,21
NULL,35637,2016-08-13T02:17:54Z,61,10,71
"T-libs,T-tools",35639,2016-08-13T06:37:16Z,0,0,0
NULL,35643,2016-08-13T08:20:44Z,4,1,5
NULL,35644,2016-08-13T08:22:11Z,4,1,5
NULL,35646,2016-08-13T09:35:58Z,5,2,7
NULL,35649,2016-08-13T13:41:44Z,0,0,0
NULL,35652,2016-08-13T14:27:56Z,0,0,0
"B-RFC-approved;T-libs,B-unstable;T-libs",35656,2016-08-13T22:20:01Z,437,24,461
NULL,35660,2016-08-14T02:24:13Z,2,3,5
NULL,35664,2016-08-14T13:27:14Z,85,1,86
T-libs,35665,2016-08-14T16:39:31Z,0,0,0
T-libs,35666,2016-08-14T17:29:53Z,532,217,749
NULL,35669,2016-08-14T19:15:25Z,0,0,0
NULL,35670,2016-08-14T19:34:41Z,10,7,17
NULL,35671,2016-08-14T21:17:15Z,5,2,7
A-diagnostics;E-easy;E-mentor,35672,2016-08-14T21:22:31Z,7,2,9
NULL,35683,2016-08-15T14:41:33Z,0,0,0
A-incr-comp;T-compiler,35684,2016-08-15T15:12:52Z,1217,959,2176
NULL,35686,2016-08-15T17:41:55Z,26,8,34
A-docs,35690,2016-08-15T19:36:14Z,8,3,11
NULL,35691,2016-08-15T20:42:22Z,69,11,80
NULL,35702,2016-08-15T23:19:31Z,368,77,445
NULL,35707,2016-08-16T03:47:25Z,17,0,17
A-docs,35709,2016-08-16T08:18:22Z,23,11,34
A-docs,35710,2016-08-16T08:35:25Z,7,0,7
NULL,35717,2016-08-16T15:14:07Z,0,0,0
"A-incr-comp;I-enhancement;T-compiler,A-incr-comp,A-incr-comp;I-enhancement;T-compiler,A-incr-comp",35718,2016-08-16T15:48:11Z,1459,178,1637
B-RFC-approved;T-libs,35719,2016-08-16T16:00:21Z,173,0,173
NULL,35722,2016-08-16T17:51:03Z,15,5,20
NULL,35726,2016-08-16T19:28:51Z,19,7,26
NULL,35731,2016-08-16T21:57:45Z,5,3,8
A-libs;I-nominated;regression-from-stable-to-nightly;T-libs,35733,2016-08-16T22:08:36Z,11,7,18
NULL,35734,2016-08-16T22:18:10Z,65,0,65
NULL,35739,2016-08-17T01:53:11Z,20,12,32
NULL,35740,2016-08-17T02:42:00Z,2,2,4
NULL,35742,2016-08-17T04:36:29Z,1,1,2
relnotes,35743,2016-08-17T05:19:31Z,0,0,0
NULL,35744,2016-08-17T05:42:28Z,9,5,14
"A-traits;I-unsound;P-high;T-compiler;T-lang,A-traits;I-unsound;P-high;T-compiler;T-lang",35745,2016-08-17T05:57:02Z,151,153,304
relnotes,35747,2016-08-17T13:25:29Z,511,376,887
NULL,35748,2016-08-17T13:58:59Z,1,1,2
NULL,35749,2016-08-17T14:00:30Z,43,0,43
A-mir;I-nominated;regression-from-stable-to-beta;T-compiler,35751,2016-08-17T14:33:12Z,96,20,116
NULL,35756,2016-08-17T18:02:57Z,11,7,18
NULL,35758,2016-08-17T18:17:33Z,10,22,32
A-diagnostics,35765,2016-08-17T20:49:55Z,158,27,185
"beta-nominated,beta-nominated",35769,2016-08-17T22:00:41Z,691,79,770
NULL,35770,2016-08-17T22:10:51Z,5,1,6
NULL,35773,2016-08-18T01:05:47Z,10,2,12
NULL,35778,2016-08-18T05:06:08Z,10,4,14
NULL,35779,2016-08-18T05:28:16Z,0,0,0
NULL,35780,2016-08-18T05:47:18Z,9,3,12
NULL,35804,2016-08-18T20:30:50Z,8,3,11
NULL,35806,2016-08-18T20:55:41Z,21,10,31
NULL,35808,2016-08-18T21:09:56Z,0,0,0
NULL,35812,2016-08-18T22:51:09Z,10,4,14
NULL,35814,2016-08-19T00:56:55Z,3,2,5
NULL,35817,2016-08-19T02:13:29Z,16,1,17
NULL,35818,2016-08-19T04:01:50Z,5,5,10
NULL,35819,2016-08-19T07:55:15Z,0,0,0
A-diagnostics;E-easy;E-mentor,35820,2016-08-19T09:10:29Z,99,51,150
NULL,35826,2016-08-19T15:37:47Z,0,0,0
NULL,35831,2016-08-19T17:22:25Z,19,4,23
NULL,35834,2016-08-19T18:26:09Z,0,0,0
NULL,35835,2016-08-19T20:35:33Z,10,6,16
NULL,35841,2016-08-20T00:59:56Z,12,5,17
A-rustdoc,35846,2016-08-20T01:50:23Z,0,0,0
"A-incr-comp,A-incr-comp;I-enhancement",35854,2016-08-20T11:27:26Z,350,176,526
A-rustdoc,35857,2016-08-20T14:09:38Z,344,126,470
NULL,35858,2016-08-20T17:11:40Z,15,6,21
A-docs,35876,2016-08-21T20:03:45Z,43,19,62
NULL,35877,2016-08-21T20:16:14Z,122,63,185
A-docs,35880,2016-08-21T21:02:16Z,0,0,0
A-docs,35881,2016-08-21T21:19:36Z,17,0,17
NULL,35882,2016-08-21T21:22:12Z,2,3,5
NULL,35883,2016-08-21T22:49:32Z,49,2,51
NULL,35885,2016-08-21T23:51:40Z,1,1,2
NULL,35891,2016-08-22T03:11:06Z,28,0,28
B-RFC-approved;B-unstable;T-lang,35894,2016-08-22T06:59:34Z,508,220,728
NULL,35908,2016-08-22T22:34:23Z,639,139,778
A-compiler,35909,2016-08-22T23:03:55Z,0,0,0
"beta-nominated;T-libs,beta-nominated,beta-nominated",35914,2016-08-23T05:43:09Z,379,94,473
NULL,35927,2016-08-23T15:42:59Z,51,9,60
NULL,35936,2016-08-23T16:09:52Z,52,9,61
NULL,35939,2016-08-23T16:44:00Z,6,3,9
relnotes,35944,2016-08-23T18:11:38Z,0,0,0
relnotes,35945,2016-08-23T18:19:24Z,0,0,0
NULL,35951,2016-08-23T20:48:03Z,64,18,82
"B-RFC-approved;B-unstable;T-lang,B-RFC-approved;B-unstable;T-lang",35954,2016-08-24T00:13:49Z,0,0,0
NULL,35961,2016-08-24T12:16:11Z,21,8,29
NULL,35963,2016-08-24T15:12:07Z,0,0,0
NULL,35969,2016-08-24T17:01:59Z,23,1,24
NULL,35971,2016-08-24T17:35:30Z,246,43,289
NULL,35979,2016-08-25T08:22:53Z,640,267,907
NULL,35983,2016-08-25T11:07:31Z,30,27,57
"A-rustdoc,A-compiler",35984,2016-08-25T12:49:22Z,135,133,268
A-diagnostics;E-easy;E-mentor,35985,2016-08-25T12:58:34Z,34,4,38
NULL,35989,2016-08-25T13:41:25Z,15,7,22
NULL,35994,2016-08-25T19:41:10Z,0,0,0
NULL,36002,2016-08-25T22:13:41Z,1416,1225,2641
NULL,36008,2016-08-26T04:43:00Z,9,1,10
NULL,36009,2016-08-26T05:06:21Z,0,0,0
NULL,36012,2016-08-26T14:14:40Z,0,0,0
B-RFC,36014,2016-08-26T15:33:07Z,9,54,63
"B-RFC-approved;B-unstable;T-lang,relnotes,B-RFC-approved;B-unstable;T-lang,relnotes",36016,2016-08-26T16:32:36Z,2899,362,3261
"A-io;A-libs;I-enhancement,A-io;A-libs;I-enhancement",36019,2016-08-26T18:00:25Z,27,0,27
NULL,36021,2016-08-26T19:20:30Z,0,0,0
"A-infrastructure;E-medium;I-enhancement;T-tools,A-infrastructure;E-medium;I-enhancement;T-tools",36024,2016-08-26T22:18:19Z,259,14,273
"A-incr-comp,A-incr-comp",36025,2016-08-26T22:36:07Z,843,145,988
I-wrong,36027,2016-08-27T02:12:56Z,70,48,118
A-lifetimes;E-mentor;P-backcompat-lang,36029,2016-08-27T02:58:54Z,18,1,19
NULL,36030,2016-08-27T04:01:15Z,1601,3912,5513
"E-easy,E-easy",36034,2016-08-27T09:05:39Z,0,1,1
NULL,36042,2016-08-27T15:59:07Z,0,0,0
NULL,36044,2016-08-27T16:43:42Z,32,9,41
NULL,36045,2016-08-27T16:46:51Z,74,3,77
NULL,36049,2016-08-27T19:43:31Z,469,32,501
NULL,36055,2016-08-27T22:13:37Z,8,3,11
I-ICE,36058,2016-08-27T22:42:15Z,96,0,96
NULL,36062,2016-08-28T02:49:39Z,79,11,90
NULL,36065,2016-08-28T11:05:57Z,69,49,118
NULL,36068,2016-08-28T12:43:55Z,0,0,0
NULL,36070,2016-08-28T14:01:13Z,10,5,15
"A-rustdoc;I-crash,A-rustdoc;I-crash",36078,2016-08-28T16:47:26Z,50,11,61
NULL,36080,2016-08-28T18:22:24Z,10,3,13
NULL,36087,2016-08-28T23:21:37Z,18,0,18
NULL,36090,2016-08-29T00:09:26Z,0,0,0
"A-libs;I-crash,A-libs;I-crash",36104,2016-08-29T17:29:40Z,24,4,28
NULL,36114,2016-08-29T18:36:12Z,26,13,39
A-codegen;I-nominated;regression-from-stable-to-nightly;T-compiler,36117,2016-08-29T19:58:18Z,34,2,36
NULL,36118,2016-08-29T19:59:31Z,8,4,12
NULL,36119,2016-08-29T21:04:18Z,65,45,110
"A-build;I-enhancement;P-low,A-build;I-enhancement;P-low,A-build;I-enhancement;P-low,A-build;I-enhancement;P-low",36120,2016-08-29T22:18:25Z,0,0,0
NULL,36121,2016-08-29T22:38:53Z,9,4,13
A-x86,36123,2016-08-29T23:17:29Z,0,3,3
NULL,36124,2016-08-29T23:51:39Z,3,3,6
NULL,36127,2016-08-30T01:32:17Z,0,0,0
NULL,36128,2016-08-30T01:50:38Z,28,10,38
NULL,36129,2016-08-30T02:36:29Z,1,1,2
NULL,36152,2016-08-30T23:07:53Z,2,2,4
B-reproduce;I-crash,36154,2016-08-31T00:04:45Z,472,49,521
NULL,36160,2016-08-31T04:44:32Z,36,1,37
A-diagnostics;A-plugin,36172,2016-08-31T17:26:44Z,0,0,0
NULL,36173,2016-08-31T19:05:52Z,123,16,139
NULL,36177,2016-08-31T20:53:36Z,309,88,397
NULL,36178,2016-08-31T22:24:37Z,20,3,23
"metabug;T-compiler,metabug;T-compiler",36181,2016-08-31T23:12:16Z,65,0,65
NULL,36190,2016-09-01T13:21:01Z,8,4,12
NULL,36198,2016-09-01T17:54:28Z,33,2,35
NULL,36200,2016-09-01T19:12:55Z,180,66,246
B-RFC-approved;B-unstable;T-lang,36203,2016-09-01T20:59:34Z,392,374,766
NULL,36205,2016-09-01T23:09:18Z,9,4,13
NULL,36206,2016-09-02T00:09:59Z,34,0,34
NULL,36208,2016-09-02T00:43:04Z,0,0,0
NULL,36210,2016-09-02T02:39:10Z,7,2,9
NULL,36212,2016-09-02T09:48:21Z,53,1,54
NULL,36213,2016-09-02T10:20:08Z,9,0,9
NULL,36220,2016-09-02T17:53:03Z,0,0,0
NULL,36222,2016-09-02T18:32:24Z,53,4,57
NULL,36223,2016-09-02T18:47:52Z,7,3,10
NULL,36224,2016-09-02T19:25:44Z,0,0,0
NULL,36227,2016-09-02T22:28:53Z,211,57,268
NULL,36234,2016-09-03T01:31:11Z,6,0,6
"A-codegen;A-unicode;I-enhancement;I-slow,A-codegen;A-unicode;I-enhancement;I-slow,A-codegen;A-unicode;I-enhancement;I-slow,A-codegen;A-unicode;I-enhancement;I-slow",36237,2016-09-03T05:26:28Z,0,0,0
NULL,36240,2016-09-03T09:08:14Z,14,9,23
NULL,36255,2016-09-04T02:22:37Z,681,90,771
"A-build;E-easy,A-build;E-easy",36256,2016-09-04T03:31:01Z,14,0,14
NULL,36266,2016-09-04T18:23:59Z,154,27,181
NULL,36267,2016-09-04T20:26:57Z,40,27,67
NULL,36276,2016-09-05T05:34:08Z,63,22,85
NULL,36281,2016-09-05T10:10:20Z,37,1,38
NULL,36289,2016-09-06T01:52:38Z,33,1,34
NULL,36300,2016-09-06T15:08:23Z,0,0,0
NULL,36303,2016-09-06T16:38:04Z,155,97,252
NULL,36304,2016-09-06T16:57:54Z,16,0,16
NULL,36306,2016-09-06T19:05:17Z,137,35,172
NULL,36308,2016-09-06T21:13:33Z,21,8,29
NULL,36316,2016-09-07T03:59:25Z,113,1,114
NULL,36330,2016-09-07T20:47:42Z,35,13,48
NULL,36333,2016-09-07T22:28:57Z,26,2,28
NULL,36336,2016-09-07T23:55:33Z,0,0,0
NULL,36338,2016-09-08T01:44:15Z,63,5,68
A-linkage,36339,2016-09-08T02:16:44Z,615,211,826
"B-RFC-approved;T-libs,B-RFC-approved;T-libs",36340,2016-09-08T04:06:09Z,404,185,589
NULL,36341,2016-09-08T04:59:19Z,59,0,59
NULL,36344,2016-09-08T09:45:22Z,10,0,10
NULL,36351,2016-09-08T16:20:21Z,40,1,41
NULL,36354,2016-09-08T19:06:14Z,29,5,34
"A-codegen;A-llvm,A-codegen;A-llvm",36355,2016-09-08T21:59:19Z,55,13,68
"A-docs;E-easy,A-docs;E-easy",36364,2016-09-09T15:56:48Z,0,0,0
NULL,36365,2016-09-09T16:22:08Z,56,6,62
NULL,36366,2016-09-09T16:45:00Z,0,0,0
A-diagnostics,36371,2016-09-10T02:41:42Z,0,0,0
"A-docs,A-docs",36372,2016-09-10T04:09:26Z,68,14,82
NULL,36373,2016-09-10T06:46:48Z,0,0,0
NULL,36376,2016-09-10T13:28:57Z,69,6,75
B-unstable;T-libs,36377,2016-09-10T13:43:23Z,163,188,351
NULL,36378,2016-09-10T13:57:51Z,161,18,179
NULL,36383,2016-09-10T15:53:49Z,37,5,42
NULL,36384,2016-09-10T16:10:04Z,293,121,414
NULL,36389,2016-09-10T20:31:57Z,8,3,11
NULL,36395,2016-09-11T01:56:02Z,10,3,13
"A-docs;E-easy,A-docs;E-easy",36396,2016-09-11T11:47:37Z,38,0,38
"A-docs,A-docs",36402,2016-09-11T19:39:35Z,65,21,86
NULL,36404,2016-09-11T22:09:06Z,10,3,13
NULL,36406,2016-09-11T22:54:57Z,83,28,111
NULL,36409,2016-09-12T00:00:49Z,0,0,0
NULL,36411,2016-09-12T01:36:49Z,0,0,0
NULL,36423,2016-09-12T19:40:08Z,16,16,32
"A-docs,A-docs",36424,2016-09-12T20:17:49Z,268,155,423
NULL,36429,2016-09-12T21:50:00Z,7,7,14
NULL,36430,2016-09-12T21:57:21Z,112,1,113
NULL,36433,2016-09-13T00:01:28Z,130,5,135
NULL,36442,2016-09-13T05:48:58Z,5,1,6
NULL,36446,2016-09-13T08:25:50Z,306,137,443
I-ICE,36459,2016-09-13T20:43:13Z,58,4,62
"A-incr-comp;T-compiler,A-incr-comp;T-compiler",36460,2016-09-13T20:57:18Z,92,15,107
NULL,36461,2016-09-13T22:35:02Z,104,22,126
"B-RFC-approved;T-libs,B-RFC-approved;T-libs",36463,2016-09-14T00:23:38Z,182,35,217
NULL,36466,2016-09-14T01:54:26Z,0,0,0
NULL,36468,2016-09-14T02:24:18Z,29,12,41
NULL,36472,2016-09-14T08:34:08Z,235,111,346
"T-lang,T-lang",36482,2016-09-14T23:03:44Z,22,10,32
"A-libs;I-nominated;regression-from-stable-to-beta;T-libs,A-libs;I-nominated;regression-from-stable-to-beta;T-libs",36490,2016-09-15T08:10:47Z,31,38,69
beta-nominated,36491,2016-09-15T12:46:22Z,1399,977,2376
NULL,36496,2016-09-15T16:04:05Z,47,4,51
NULL,36498,2016-09-15T17:18:21Z,8,7,15
NULL,36502,2016-09-15T20:14:39Z,26,5,31
"A-mir;I-nominated;regression-from-stable-to-nightly;T-compiler,A-mir;I-nominated;regression-from-stable-to-nightly;T-compiler",36505,2016-09-15T21:05:56Z,2,1,3
NULL,36508,2016-09-15T22:31:02Z,42,2,44
NULL,36511,2016-09-15T23:28:11Z,0,0,0
NULL,36512,2016-09-15T23:49:49Z,0,0,0
NULL,36520,2016-09-16T01:49:07Z,29,11,40
NULL,36524,2016-09-16T02:32:08Z,49,120,169
NULL,36526,2016-09-16T05:54:35Z,0,0,0
NULL,36536,2016-09-16T16:29:50Z,332,168,500
NULL,36538,2016-09-16T17:50:38Z,48,4,52
NULL,36539,2016-09-16T18:47:48Z,33,1,34
NULL,36545,2016-09-16T21:56:48Z,0,1,1
NULL,36552,2016-09-17T13:15:48Z,0,0,0
NULL,36555,2016-09-17T23:42:11Z,55,58,113
NULL,36557,2016-09-18T04:06:07Z,22,8,30
NULL,36563,2016-09-18T12:24:40Z,6,5,11
NULL,36564,2016-09-18T12:45:23Z,2,2,4
NULL,36565,2016-09-18T15:02:59Z,0,0,0
NULL,36566,2016-09-18T17:02:15Z,20,0,20
"A-docs,A-docs",36571,2016-09-18T23:09:40Z,310,160,470
NULL,36578,2016-09-19T12:09:45Z,2,2,4
NULL,36580,2016-09-19T13:10:10Z,0,0,0
"A-docs,A-docs",36589,2016-09-19T23:01:45Z,4,6,10
"beta-nominated,beta-nominated",36591,2016-09-19T23:56:53Z,75,41,116
A-collections,36595,2016-09-20T07:40:53Z,44,25,69
metabug,36599,2016-09-20T15:04:28Z,121,156,277
NULL,36607,2016-09-21T00:18:08Z,0,0,0
NULL,36618,2016-09-21T09:37:05Z,25,7,32
"A-build,A-build",36619,2016-09-21T11:52:27Z,0,0,0
"beta-nominated,beta-nominated",36620,2016-09-21T12:28:59Z,133,31,164
NULL,36626,2016-09-21T17:22:59Z,0,0,0
NULL,36627,2016-09-21T17:26:09Z,0,0,0
NULL,36628,2016-09-21T17:27:36Z,47,5,52
NULL,36632,2016-09-21T19:14:17Z,2,2,4
NULL,36634,2016-09-21T20:58:05Z,2,2,4
NULL,36635,2016-09-21T21:02:14Z,0,0,0
"A-docs,A-docs",36637,2016-09-21T22:25:36Z,32,2,34
NULL,36649,2016-09-22T17:15:03Z,29,1,30
NULL,36651,2016-09-22T18:25:02Z,401,199,600
NULL,36656,2016-09-22T20:37:41Z,0,0,0
NULL,36665,2016-09-23T02:26:47Z,302,156,458
"A-macros,A-macros",36669,2016-09-23T10:45:48Z,103,280,383
NULL,36672,2016-09-23T15:42:40Z,16,6,22
NULL,36678,2016-09-23T19:09:32Z,79,78,157
NULL,36684,2016-09-23T22:15:46Z,112,75,187
"T-libs,T-libs",36685,2016-09-23T22:59:19Z,0,20,20
beta-accepted;beta-nominated,36686,2016-09-23T23:03:25Z,1,21,22
NULL,36692,2016-09-24T09:43:02Z,68,88,156
NULL,36695,2016-09-24T15:54:04Z,1904,1331,3235
"A-codegen;I-cleanup,A-codegen;I-cleanup,A-codegen;I-cleanup,A-codegen;I-cleanup",36704,2016-09-25T00:32:11Z,103,395,498
NULL,36709,2016-09-25T03:08:59Z,11,0,11
NULL,36713,2016-09-25T07:26:07Z,66,18,84
"A-syntaxext;I-wrong;P-high,A-syntaxext;I-wrong;P-high",36721,2016-09-25T17:10:46Z,100,1,101
NULL,36723,2016-09-25T17:39:05Z,63,4,67
NULL,36754,2016-09-26T19:31:16Z,8,3,11
NULL,36756,2016-09-26T19:52:02Z,8,2,10
NULL,36757,2016-09-26T20:03:40Z,29,17,46
"A-incr-comp,A-incr-comp",36758,2016-09-26T21:27:59Z,202,40,242
NULL,36759,2016-09-26T21:41:05Z,0,0,0
"A-diagnostics;E-easy;E-mentor,A-diagnostics;E-easy;E-mentor",36761,2016-09-26T23:07:55Z,107,35,142
NULL,36764,2016-09-27T00:29:50Z,1710,1061,2771
NULL,36767,2016-09-27T07:24:08Z,210,79,289
NULL,36776,2016-09-27T18:20:39Z,52,1,53
NULL,36777,2016-09-27T18:43:19Z,12,1,13
NULL,36783,2016-09-27T20:13:31Z,17,0,17
NULL,36784,2016-09-27T20:16:32Z,0,7,7
NULL,36787,2016-09-27T20:19:04Z,29,4,33
NULL,36789,2016-09-27T21:49:08Z,40,18,58
"T-libs,T-libs",36791,2016-09-27T22:53:19Z,0,0,0
NULL,36794,2016-09-28T02:38:30Z,83,37,120
NULL,36795,2016-09-28T05:56:31Z,3,3,6
NULL,36796,2016-09-28T06:14:26Z,2,2,4
NULL,36798,2016-09-28T11:58:38Z,89,36,125
NULL,36805,2016-09-28T17:33:58Z,304,139,443
A-docs,36810,2016-09-28T20:03:20Z,19,15,34
NULL,36814,2016-09-29T00:07:13Z,1031,613,1644
"B-RFC-approved;T-libs,B-unstable;T-libs,B-unstable;T-libs,B-RFC-approved;T-libs,B-unstable;T-libs,B-unstable;T-libs",36815,2016-09-29T00:30:55Z,129,80,209
NULL,36818,2016-09-29T03:21:53Z,694,808,1502
I-ICE,36819,2016-09-29T03:53:43Z,22,3,25
NULL,36821,2016-09-29T04:07:13Z,14,3,17
NULL,36822,2016-09-29T04:09:23Z,19,1,20
NULL,36823,2016-09-29T07:16:35Z,110,0,110
NULL,36824,2016-09-29T08:56:21Z,28,6,34
NULL,36828,2016-09-29T12:23:15Z,1,1,2
NULL,36832,2016-09-29T17:15:04Z,29,5,34
"A-incr-comp;A-testsuite;metabug,A-incr-comp;E-mentor",36840,2016-09-29T22:04:37Z,715,0,715
B-RFC-approved;B-unstable;T-lang,36843,2016-09-29T22:51:34Z,20,73,93
NULL,36847,2016-09-30T02:12:02Z,50,13,63
NULL,36853,2016-09-30T09:18:40Z,12,7,19
A-diagnostics;E-easy;E-mentor,36862,2016-09-30T16:12:33Z,10,6,16
B-RFC-approved;B-unstable;T-lang,36868,2016-09-30T18:41:50Z,23,115,138
NULL,36873,2016-09-30T20:54:33Z,72,24,96
NULL,36876,2016-09-30T22:22:02Z,47,2,49
NULL,36882,2016-10-01T07:45:22Z,15,1,16
NULL,36885,2016-10-01T11:08:33Z,150,88,238
NULL,36893,2016-10-01T12:45:22Z,9,0,9
"A-diagnostics,A-diagnostics",36909,2016-10-02T13:45:50Z,16,8,24
NULL,36921,2016-10-03T08:01:33Z,2,8,10
NULL,36929,2016-10-03T15:53:13Z,7,2,9
NULL,36930,2016-10-03T15:54:04Z,10,10,20
NULL,36933,2016-10-03T17:12:11Z,1,1,2
NULL,36937,2016-10-03T18:23:19Z,2,2,4
NULL,36938,2016-10-03T20:19:26Z,18,7,25
"A-incr-comp;A-testsuite;E-mentor,A-incr-comp;A-testsuite;metabug,A-incr-comp;A-testsuite;E-mentor,A-incr-comp;A-testsuite;metabug",36940,2016-10-03T21:02:09Z,1121,0,1121
NULL,36941,2016-10-03T21:52:09Z,20,0,20
"I-nominated;I-wrong;regression-from-stable-to-stable;T-compiler,I-nominated;I-wrong;regression-from-stable-to-stable;T-compiler,I-nominated;I-wrong;regression-from-stable-to-stable;T-compiler,I-nominated;I-wrong;regression-from-stable-to-stable;T-compiler",36942,2016-10-03T22:15:17Z,47,2,49
"regression-from-stable-to-nightly,regression-from-stable-to-nightly,regression-from-stable-to-nightly,regression-from-stable-to-nightly",36951,2016-10-04T05:38:54Z,5,1,6
NULL,36953,2016-10-04T09:54:05Z,354,227,581
"A-docs;E-easy,A-docs;E-easy,A-docs;E-easy",36957,2016-10-04T12:06:03Z,3,3,6
"A-diagnostics,A-diagnostics,A-diagnostics,A-diagnostics,A-diagnostics,A-diagnostics",36964,2016-10-04T17:11:19Z,17,8,25
"A-incr-comp;E-easy;E-mentor,A-incr-comp",36968,2016-10-04T22:13:27Z,0,0,0
"A-incr-comp,A-incr-comp;E-easy;E-mentor,A-incr-comp,A-incr-comp;E-easy;E-mentor",36974,2016-10-05T06:12:32Z,546,16,562
NULL,36986,2016-10-05T22:04:56Z,0,0,0
NULL,37002,2016-10-06T15:35:44Z,925,267,1192
NULL,37006,2016-10-06T19:03:29Z,1,1,2
NULL,37016,2016-10-07T06:36:03Z,903,973,1876
"I-nominated;regression-from-stable-to-beta;T-compiler,I-nominated;regression-from-stable-to-beta;T-compiler,I-nominated;regression-from-stable-to-beta;T-compiler",37023,2016-10-07T09:32:10Z,27,1,28
NULL,37024,2016-10-07T09:45:05Z,366,165,531
NULL,37030,2016-10-07T21:08:40Z,2,2,4
NULL,37035,2016-10-08T00:32:52Z,341,209,550
NULL,37037,2016-10-08T01:53:24Z,48,21,69
NULL,37039,2016-10-08T11:22:44Z,919,989,1908
"A-incr-comp;E-easy;E-mentor,A-incr-comp;E-easy;E-mentor,A-incr-comp;E-easy;E-mentor,A-incr-comp;E-easy;E-mentor",37040,2016-10-08T12:50:07Z,317,0,317
NULL,37054,2016-10-09T10:07:49Z,101,0,101
NULL,37055,2016-10-09T11:02:51Z,19,7,26
NULL,37056,2016-10-09T14:51:06Z,8,0,8
NULL,37058,2016-10-09T17:52:47Z,0,0,0
NULL,37060,2016-10-09T18:42:58Z,11,4,15
NULL,37068,2016-10-10T10:42:24Z,0,0,0
NULL,37072,2016-10-10T16:02:44Z,85,91,176
NULL,37078,2016-10-10T21:38:46Z,14,2,16
"beta-nominated,beta-nominated,beta-nominated,beta-nominated",37080,2016-10-10T23:06:54Z,538,93,631
NULL,37084,2016-10-11T05:23:27Z,316,227,543
NULL,37090,2016-10-11T15:51:27Z,839,241,1080
"beta-nominated;T-compiler,T-libs,beta-nominated;T-compiler,T-libs,T-libs,beta-nominated;T-compiler",37093,2016-10-11T17:26:49Z,0,0,0
NULL,37095,2016-10-11T20:16:13Z,23,1,24
"A-docs,A-docs",37098,2016-10-11T21:48:53Z,131,115,246
"A-const-fn;B-RFC-approved;T-lang,A-const-fn;B-RFC-approved;T-lang",37102,2016-10-12T03:46:05Z,10,2,12
"I-ICE;regression-from-stable-to-stable;T-compiler,I-ICE;regression-from-stable-to-stable;T-compiler",37110,2016-10-12T10:28:03Z,0,0,0
"I-ICE,I-ICE",37111,2016-10-12T10:52:45Z,76,33,109
NULL,37112,2016-10-12T15:02:01Z,110,17,127
"B-RFC-approved,B-RFC-approved;B-unstable;T-lang;T-libs,B-RFC-approved,B-RFC-approved;B-unstable;T-lang;T-libs",37117,2016-10-12T16:53:15Z,1098,36,1134
"beta-accepted;beta-nominated,beta-nominated;T-compiler,T-libs,beta-nominated;T-compiler,beta-accepted;beta-nominated,T-libs",37118,2016-10-12T17:15:29Z,1356,945,2301
NULL,37119,2016-10-12T17:44:12Z,1,1,2
NULL,37124,2016-10-12T18:32:59Z,114,0,114
NULL,37125,2016-10-12T18:43:04Z,0,0,0
"A-resolve,I-nominated,B-RFC-approved;B-unstable;T-lang",37127,2016-10-12T21:02:38Z,50,599,649
"I-ICE;regression-from-stable-to-stable;T-compiler,I-ICE;regression-from-stable-to-stable;T-compiler",37129,2016-10-12T21:21:37Z,38,38,76
NULL,37141,2016-10-13T15:09:32Z,8,0,8
NULL,37143,2016-10-13T16:02:51Z,0,0,0
"A-tools;E-easy;E-mentor,A-tools;E-easy;E-mentor,A-tools;E-easy;E-mentor",37144,2016-10-13T16:09:40Z,1,3,4
"I-nominated;T-compiler,I-nominated;T-compiler",37152,2016-10-13T20:45:18Z,41,27,68
NULL,37153,2016-10-13T21:38:00Z,13,21,34
NULL,37162,2016-10-14T10:15:02Z,33,50,83
NULL,37167,2016-10-14T14:36:24Z,1713,785,2498
NULL,37168,2016-10-14T18:35:51Z,2,2,4
NULL,37170,2016-10-14T19:07:09Z,283,128,411
"beta-nominated,regression-from-stable-to-beta;T-compiler,I-ICE;regression-from-stable-to-stable;T-compiler,beta-nominated,I-nominated;I-wrong;regression-from-stable-to-stable;T-compiler,T-libs,I-ICE;regression-from-stable-to-stable;T-compiler,I-nominated;I-wrong;regression-from-stable-to-stable;T-compiler,beta-nominated,I-nominated;I-wrong;regression-from-stable-to-stable;T-compiler,beta-nominated,regression-from-stable-to-beta;T-compiler,I-ICE;regression-from-stable-to-stable;T-compiler,beta-nominated,T-libs,I-ICE;regression-from-stable-to-stable;T-compiler,I-nominated;I-wrong;regression-from-stable-to-stable;T-compiler,beta-nominated",37173,2016-10-14T19:31:32Z,269,50,319
NULL,37174,2016-10-14T19:48:14Z,711,98,809
NULL,37178,2016-10-14T20:36:22Z,43,1,44
"A-docs,A-docs",37189,2016-10-15T13:45:57Z,5,3,8
NULL,37190,2016-10-15T15:51:45Z,156,52,208
NULL,37191,2016-10-15T18:09:01Z,90,3,93
NULL,37192,2016-10-15T18:13:03Z,190,0,190
NULL,37193,2016-10-15T18:44:22Z,10,7,17
NULL,37194,2016-10-15T19:03:50Z,1,1,2
NULL,37200,2016-10-15T23:00:18Z,4,0,4
NULL,37202,2016-10-16T00:22:59Z,72,225,297
"I-nominated;T-compiler,I-nominated;T-compiler",37208,2016-10-16T08:11:47Z,52,15,67
NULL,37237,2016-10-17T21:07:53Z,14,38,52
beta-nominated,37239,2016-10-18T00:13:03Z,172,53,225
NULL,37241,2016-10-18T02:38:12Z,97,136,233
NULL,37242,2016-10-18T03:01:15Z,0,0,0
"relnotes,relnotes,relnotes",37243,2016-10-18T03:21:55Z,0,0,0
"A-docs;E-easy,A-docs;E-easy,A-docs;E-easy",37244,2016-10-18T05:07:00Z,101,4,105
NULL,37245,2016-10-18T05:19:40Z,112,2,114
NULL,37246,2016-10-18T05:23:02Z,22,1,23
NULL,37247,2016-10-18T05:59:33Z,13,7,20
NULL,37256,2016-10-18T18:05:07Z,13,22,35
NULL,37260,2016-10-18T19:40:29Z,0,0,0
NULL,37261,2016-10-18T21:03:00Z,2,2,4
NULL,37262,2016-10-18T21:53:26Z,0,0,0
"beta-accepted;beta-nominated,beta-nominated;T-compiler",37266,2016-10-19T02:12:31Z,139,128,267
NULL,37267,2016-10-19T02:40:42Z,26,6,32
"beta-nominated,beta-nominated",37269,2016-10-19T05:00:05Z,2675,813,3488
NULL,37270,2016-10-19T05:30:15Z,361,144,505
A-build;E-easy;I-nominated;T-tools,37271,2016-10-19T05:32:15Z,0,0,0
"beta-nominated,beta-nominated",37273,2016-10-19T07:40:20Z,8,7,15
NULL,37280,2016-10-19T16:50:37Z,21,1,22
NULL,37281,2016-10-19T17:27:16Z,27,2,29
NULL,37289,2016-10-19T21:15:02Z,190,252,442
NULL,37294,2016-10-19T23:44:05Z,130,53,183
NULL,37298,2016-10-20T04:02:09Z,10,25,35
"A-libs,A-libs",37299,2016-10-20T05:10:33Z,45,0,45
I-slow;T-libs,37306,2016-10-20T13:15:08Z,146,60,206
NULL,37309,2016-10-20T15:07:06Z,1,1,2
"A-debuginfo,A-debuginfo",37310,2016-10-20T16:53:24Z,99,3,102
"A-libs;I-slow;T-libs,A-libs;I-slow;T-libs",37312,2016-10-20T22:13:03Z,118,50,168
NULL,37324,2016-10-21T14:14:19Z,41,36,77
NULL,37325,2016-10-21T14:30:35Z,152,7,159
NULL,37337,2016-10-21T23:22:00Z,263,133,396
NULL,37341,2016-10-22T08:48:13Z,0,0,0
NULL,37344,2016-10-22T11:14:58Z,39,14,53
NULL,37359,2016-10-23T00:28:37Z,0,0,0
NULL,37360,2016-10-23T02:02:57Z,16,19,35
NULL,37361,2016-10-23T05:32:32Z,74,12,86
NULL,37362,2016-10-23T13:11:19Z,0,0,0
"relnotes,relnotes",37365,2016-10-23T17:26:03Z,18,3,21
NULL,37367,2016-10-23T21:48:43Z,18,7,25
NULL,37370,2016-10-24T02:08:38Z,186,11,197
NULL,37375,2016-10-24T12:53:14Z,39,32,71
"A-incr-comp,A-incr-comp",37378,2016-10-24T18:36:26Z,54,12,66
NULL,37381,2016-10-24T22:03:50Z,0,0,0
NULL,37382,2016-10-24T22:41:30Z,552,597,1149
"A-ARM,A-ARM",37392,2016-10-25T02:36:12Z,45,0,45
NULL,37394,2016-10-25T06:01:00Z,21,16,37
NULL,37396,2016-10-25T07:04:33Z,44,16,60
NULL,37399,2016-10-25T14:06:25Z,3,2,5
NULL,37400,2016-10-25T15:14:55Z,383,575,958
NULL,37401,2016-10-25T15:32:08Z,16,34,50
NULL,37402,2016-10-25T15:46:27Z,1039,1691,2730
NULL,37404,2016-10-25T16:12:02Z,78,44,122
NULL,37405,2016-10-25T16:16:20Z,309,6,315
NULL,37408,2016-10-25T18:58:55Z,631,802,1433
NULL,37410,2016-10-25T21:53:44Z,0,0,0
"A-incr-comp,A-incr-comp",37412,2016-10-26T00:18:05Z,778,829,1607
NULL,37416,2016-10-26T10:56:18Z,0,0,0
NULL,37419,2016-10-26T16:17:10Z,90,59,149
"A-diagnostics;E-easy;I-papercut,A-diagnostics;E-easy;I-papercut",37424,2016-10-27T01:18:30Z,36,3,39
"A-frontend,A-frontend",37426,2016-10-27T01:27:39Z,0,0,0
NULL,37428,2016-10-27T03:56:25Z,69,14,83
NULL,37432,2016-10-27T14:24:40Z,3,0,3
NULL,37438,2016-10-27T23:51:19Z,67,18,85
NULL,37442,2016-10-28T02:06:18Z,47,2,49
"A-diagnostics,A-diagnostics",37443,2016-10-28T03:27:47Z,0,0,0
"regression-from-stable-to-beta;T-compiler,regression-from-stable-to-beta;T-compiler",37445,2016-10-28T04:35:10Z,3,3,6
NULL,37447,2016-10-28T07:34:34Z,14,13,27
NULL,37449,2016-10-28T15:02:08Z,21,0,21
NULL,37450,2016-10-28T15:05:48Z,58,5,63
NULL,37456,2016-10-28T21:21:23Z,82,26,108
NULL,37459,2016-10-28T22:28:50Z,38,21,59
A-codegen,37465,2016-10-29T15:59:31Z,2,2,4
NULL,37470,2016-10-29T21:14:44Z,12,14,26
NULL,37473,2016-10-29T22:48:28Z,20,18,38
NULL,37475,2016-10-29T23:34:51Z,41,1,42
NULL,37481,2016-10-30T06:01:01Z,71,16,87
"A-lang;B-RFC-approved;B-unstable,A-lang;B-RFC-approved;B-unstable",37487,2016-10-30T19:33:56Z,641,216,857
NULL,37488,2016-10-30T21:22:36Z,20,2,22
NULL,37491,2016-10-31T02:16:02Z,14,3,17
NULL,37493,2016-10-31T04:56:40Z,0,0,0
NULL,37494,2016-10-31T11:27:24Z,112,25,137
NULL,37497,2016-10-31T13:05:03Z,511,511,1022
NULL,37498,2016-10-31T14:17:40Z,2,23,25
"B-RFC-approved;T-tools,B-RFC-approved;T-tools",37501,2016-10-31T17:06:23Z,127,4,131
NULL,37506,2016-11-01T02:35:23Z,66,16,82
NULL,37511,2016-11-01T14:07:37Z,0,0,0
"A-codegen;A-incr-comp;I-enhancement;I-slow,A-codegen;A-incr-comp;I-enhancement;I-slow",37513,2016-11-01T14:15:10Z,527,35,562
NULL,37514,2016-11-01T15:15:53Z,251,249,500
"T-libs,T-libs",37517,2016-11-01T15:48:12Z,1,1,2
NULL,37527,2016-11-02T01:09:21Z,32,0,32
NULL,37531,2016-11-02T06:19:03Z,130,11,141
NULL,37540,2016-11-02T19:09:43Z,906,89,995
NULL,37541,2016-11-02T22:12:57Z,97,21,118
NULL,37542,2016-11-02T22:14:27Z,597,501,1098
"A-tools;B-RFC-approved,A-tools;B-RFC-approved",37545,2016-11-03T00:42:39Z,547,92,639
NULL,37547,2016-11-03T01:04:26Z,52,0,52
NULL,37548,2016-11-03T01:31:12Z,0,0,0
"beta-nominated,beta-nominated,beta-nominated,beta-nominated",37549,2016-11-03T01:44:22Z,252,145,397
NULL,37551,2016-11-03T04:39:22Z,573,286,859
NULL,37554,2016-11-03T07:17:51Z,63,24,87
"E-mentor;I-ICE,E-mentor;I-ICE,E-mentor;I-ICE,E-mentor;I-ICE",37557,2016-11-03T11:21:03Z,41,7,48
NULL,37564,2016-11-03T20:59:40Z,19,4,23
beta-nominated,37567,2016-11-03T22:22:33Z,2,2,4
"I-nominated;T-compiler,I-nominated;T-compiler",37569,2016-11-03T22:46:36Z,353,448,801
"A-frontend;A-typesystem;I-completion,A-frontend;E-easy;I-completion,A-frontend;E-easy",37573,2016-11-04T00:22:20Z,20,2,22
"regression-from-stable-to-beta;T-compiler,regression-from-stable-to-beta;T-compiler",37577,2016-11-04T05:48:51Z,5,5,10
NULL,37580,2016-11-04T12:51:18Z,0,0,0
beta-nominated,37581,2016-11-04T14:50:00Z,0,0,0
NULL,37585,2016-11-04T17:55:32Z,11,11,22
NULL,37586,2016-11-04T18:08:58Z,1,1,2
NULL,37595,2016-11-04T22:33:14Z,1,1,2
NULL,37596,2016-11-04T22:55:22Z,17,0,17
"beta-nominated,beta-nominated",37597,2016-11-04T23:49:33Z,4520,2998,7518
NULL,37600,2016-11-05T04:28:04Z,257,0,257
NULL,37602,2016-11-05T08:02:01Z,199,88,287
NULL,37603,2016-11-05T11:35:49Z,142,8,150
beta-nominated,37604,2016-11-05T12:47:16Z,0,0,0
NULL,37607,2016-11-05T21:31:49Z,37,12,49
"A-incr-comp;A-testsuite;E-easy;E-mentor,A-incr-comp;A-testsuite;E-easy;E-mentor",37610,2016-11-06T01:53:17Z,514,0,514
NULL,37611,2016-11-06T04:16:08Z,14,8,22
NULL,37614,2016-11-06T12:01:49Z,298,72,370
NULL,37616,2016-11-06T15:34:02Z,17,0,17
NULL,37617,2016-11-06T15:55:54Z,13,0,13
NULL,37631,2016-11-07T18:55:27Z,0,0,0
NULL,37636,2016-11-07T19:54:37Z,7,2,9
NULL,37641,2016-11-07T23:54:35Z,257,0,257
"regression-from-stable-to-beta;T-compiler,regression-from-stable-to-beta;T-compiler",37642,2016-11-07T23:56:23Z,183,183,366
NULL,37645,2016-11-08T04:32:13Z,82,2,84
"B-unstable;T-libs,B-unstable;T-libs",37652,2016-11-08T19:17:33Z,11,5,16
NULL,37657,2016-11-08T21:20:58Z,621,147,768
NULL,37659,2016-11-08T23:59:23Z,192,46,238
"A-incr-comp,A-incr-comp,A-incr-comp,A-incr-comp",37660,2016-11-09T02:08:18Z,1765,630,2395
NULL,37662,2016-11-09T03:03:47Z,418,0,418
NULL,37670,2016-11-09T18:51:20Z,42643,1380,44023
NULL,37676,2016-11-09T21:50:50Z,4149,3105,7254
NULL,37678,2016-11-10T01:46:29Z,1827,2524,4351
NULL,37688,2016-11-10T12:20:15Z,400,492,892
NULL,37691,2016-11-10T17:26:07Z,1,1,2
NULL,37695,2016-11-10T20:54:13Z,61,6,67
NULL,37696,2016-11-10T21:03:22Z,4,1,5
NULL,37699,2016-11-11T00:22:46Z,1,1,2
NULL,37701,2016-11-11T01:22:17Z,201,212,413
"A-an-interesting-project;A-frontend;E-easy,A-an-interesting-project;A-frontend;E-easy",37703,2016-11-11T04:27:42Z,0,0,0
"regression-from-stable-to-beta;T-compiler,regression-from-stable-to-beta;T-compiler",37705,2016-11-11T05:00:21Z,1,1,2
"B-unstable;T-libs,B-unstable;T-libs",37709,2016-11-11T11:58:51Z,41,30,71
beta-nominated,37722,2016-11-11T21:51:52Z,1,0,1
"T-compiler,T-compiler",37726,2016-11-11T22:34:37Z,0,0,0
NULL,37727,2016-11-11T23:31:56Z,15,2,17
NULL,37728,2016-11-12T01:33:16Z,32,3,35
"A-diagnostics;E-easy,A-diagnostics;E-easy",37729,2016-11-12T07:45:45Z,0,0,0
"beta-nominated;T-tools,T-compiler,beta-nominated;T-tools",37730,2016-11-12T08:38:45Z,4927,1078,6005
NULL,37734,2016-11-12T17:02:36Z,0,0,0
NULL,37740,2016-11-12T23:13:36Z,31,20,51
NULL,37742,2016-11-13T01:19:14Z,7,0,7
NULL,37749,2016-11-13T10:29:19Z,151,20,171
NULL,37753,2016-11-13T17:04:40Z,18,3,21
NULL,37757,2016-11-13T23:39:46Z,6,4,10
NULL,37759,2016-11-14T02:01:36Z,9,9,18
"regression-from-stable-to-beta;T-compiler,regression-from-stable-to-beta;T-compiler",37760,2016-11-14T03:01:24Z,27,9,36
"A-libs;I-nominated;T-libs,A-libs;I-nominated;T-libs",37761,2016-11-14T04:44:02Z,13,9,22
"regression-from-stable-to-beta;T-compiler,regression-from-stable-to-beta;T-compiler",37764,2016-11-14T06:12:20Z,30,129,159
NULL,37769,2016-11-14T16:07:21Z,38,8,46
"regression-from-stable-to-beta;T-compiler,regression-from-stable-to-beta;T-compiler",37770,2016-11-14T16:13:59Z,830,2,832
NULL,37772,2016-11-14T17:38:21Z,23,0,23
NULL,37776,2016-11-15T04:05:19Z,48,14,62
NULL,37780,2016-11-15T15:12:10Z,59,15,74
NULL,37782,2016-11-15T16:35:59Z,4,2,6
NULL,37787,2016-11-15T20:47:38Z,174,9,183
NULL,37789,2016-11-15T21:28:15Z,137,7,144
NULL,37791,2016-11-16T00:33:13Z,161,35,196
"I-ICE,I-ICE",37793,2016-11-16T06:33:45Z,79,11,90
NULL,37802,2016-11-16T18:05:35Z,0,0,0
NULL,37814,2016-11-16T22:39:32Z,2,1,3
NULL,37815,2016-11-16T23:00:27Z,1,1,2
"A-infrastructure,A-infrastructure",37825,2016-11-17T10:19:14Z,0,0,0
NULL,37826,2016-11-17T11:42:50Z,33,0,33
NULL,37830,2016-11-17T16:56:12Z,0,0,0
NULL,37831,2016-11-17T17:08:17Z,264,199,463
"A-libs,A-libs",37834,2016-11-17T17:36:46Z,109,23,132
NULL,37835,2016-11-17T17:39:24Z,17,11,28
NULL,37836,2016-11-17T18:17:26Z,1,1,2
NULL,37837,2016-11-17T18:40:59Z,522,37,559
"B-unstable;T-compiler,B-unstable;T-compiler",37843,2016-11-17T21:51:42Z,1,1,2
NULL,37846,2016-11-18T01:13:54Z,47,4,51
NULL,37849,2016-11-18T05:28:26Z,1,1,2
"I-slow,I-slow",37850,2016-11-18T06:57:09Z,0,0,0
NULL,37851,2016-11-18T07:17:14Z,23,0,23
NULL,37855,2016-11-18T13:48:10Z,276,105,381
NULL,37860,2016-11-18T16:22:35Z,1222,43,1265
"A-diagnostics,A-diagnostics",37863,2016-11-18T16:37:00Z,342,46,388
NULL,37870,2016-11-19T00:18:21Z,0,0,0
NULL,37881,2016-11-19T17:40:36Z,0,2,2
NULL,37886,2016-11-19T21:55:51Z,85,0,85
NULL,37895,2016-11-20T13:50:24Z,45,0,45
NULL,37896,2016-11-20T14:00:06Z,1183,24,1207
B-RFC-approved;B-unstable;T-lang,37900,2016-11-20T18:43:47Z,0,0,0
NULL,37907,2016-11-21T03:41:37Z,0,0,0
NULL,37911,2016-11-21T08:39:37Z,40,10,50
NULL,37912,2016-11-21T11:37:09Z,15,27,42
"A-incr-comp,A-incr-comp",37918,2016-11-21T18:17:13Z,1807,908,2715
NULL,37920,2016-11-21T18:33:52Z,108,8,116
NULL,37931,2016-11-22T12:40:22Z,31,18,49
NULL,37932,2016-11-22T15:47:49Z,0,0,0
NULL,37934,2016-11-22T18:31:13Z,0,0,0
NULL,37937,2016-11-22T20:15:07Z,415,21,436
NULL,37941,2016-11-22T21:00:56Z,20,9,29
NULL,37946,2016-11-23T00:03:33Z,0,0,0
"beta-nominated;T-tools,beta-nominated;T-tools,beta-nominated;T-tools,beta-nominated;T-tools",37954,2016-11-23T04:54:30Z,296,325,621
"A-tools;B-RFC-approved,A-tools;B-RFC-approved",37973,2016-11-24T00:22:08Z,437,155,592
NULL,37974,2016-11-24T02:54:52Z,7,5,12
NULL,37975,2016-11-24T03:12:23Z,0,0,0
NULL,37979,2016-11-24T11:10:26Z,6,1,7
NULL,37982,2016-11-24T16:47:28Z,28,20,48
NULL,37987,2016-11-24T22:20:41Z,22,7,29
NULL,38000,2016-11-25T16:26:18Z,5,1,6
NULL,38005,2016-11-25T18:12:14Z,0,0,0
NULL,38006,2016-11-25T18:58:06Z,515,7,522
"A-rustbuild,A-rustbuild",38008,2016-11-25T21:18:36Z,103,14,117
NULL,38013,2016-11-26T07:21:06Z,4,5,9
NULL,38015,2016-11-26T13:02:15Z,119,14,133
NULL,38017,2016-11-26T16:57:10Z,16,11,27
NULL,38023,2016-11-27T00:21:58Z,50,9,59
NULL,38024,2016-11-27T06:04:43Z,48,27,75
NULL,38027,2016-11-27T13:51:37Z,7,0,7
NULL,38036,2016-11-27T19:36:48Z,15,17,32
NULL,38046,2016-11-28T11:29:56Z,1,0,1
NULL,38047,2016-11-28T13:29:29Z,3,1,4
NULL,38048,2016-11-28T14:23:54Z,26,28,54
"A-libs;T-libs,A-libs;T-libs",38049,2016-11-28T14:43:19Z,44,44,88
"A-rustbuild,A-rustbuild",38050,2016-11-28T15:14:51Z,7,0,7
NULL,38051,2016-11-28T15:51:43Z,32,27,59
NULL,38053,2016-11-28T16:46:14Z,322,564,886
"A-diagnostics;A-typesystem,A-diagnostics;A-typesystem",38057,2016-11-28T19:56:37Z,191,76,267
"I-completion,I-nominated;regression-from-stable-to-beta;T-compiler,I-completion,I-nominated;regression-from-stable-to-beta;T-compiler",38059,2016-11-28T22:19:40Z,89,1,90
NULL,38062,2016-11-28T23:07:40Z,86,13,99
NULL,38065,2016-11-29T02:00:40Z,6,6,12
"A-diagnostics,A-diagnostics",38066,2016-11-29T03:14:58Z,38,8,46
NULL,38069,2016-11-29T07:21:31Z,1172,300,1472
"A-incr-comp;I-enhancement;T-compiler;T-tools,A-incr-comp;I-enhancement;T-compiler;T-tools,A-incr-comp;I-enhancement;T-compiler;T-tools",38072,2016-11-29T15:00:34Z,136,23,159
"A-rustbuild,A-rustbuild",38076,2016-11-29T21:43:07Z,8,0,8
NULL,38083,2016-11-30T04:11:50Z,0,0,0
NULL,38085,2016-11-30T08:10:17Z,15,3,18
"I-cleanup,I-cleanup,I-cleanup",38087,2016-11-30T14:29:42Z,4,26,30
NULL,38089,2016-11-30T17:21:13Z,1,0,1
NULL,38093,2016-11-30T20:11:47Z,86,65,151
needs-crater,38097,2016-12-01T00:42:42Z,264,291,555
NULL,38105,2016-12-01T13:21:29Z,26,24,50
NULL,38106,2016-12-01T13:36:49Z,0,0,0
NULL,38107,2016-12-01T13:45:12Z,15,5,20
"A-docs;E-easy,A-docs;E-easy,A-docs;E-easy",38108,2016-12-01T15:08:22Z,36,1,37
NULL,38109,2016-12-01T15:31:35Z,74,1,75
"A-rustbuild,A-rustbuild,A-rustbuild",38111,2016-12-01T16:29:50Z,1,0,1
"A-codegen,A-codegen,A-codegen",38117,2016-12-01T20:15:42Z,623,243,866
NULL,38122,2016-12-02T01:19:19Z,26,26,52
NULL,38125,2016-12-02T06:18:01Z,0,0,0
"A-llvm;I-nominated;I-wrong;T-compiler,A-llvm;I-nominated;I-wrong;T-compiler",38138,2016-12-03T01:15:29Z,10,11,21
NULL,38144,2016-12-03T17:12:44Z,0,4,4
NULL,38148,2016-12-03T20:39:54Z,738,93,831
"A-diagnostics,A-diagnostics",38150,2016-12-03T23:09:42Z,81,8,89
NULL,38154,2016-12-04T12:24:02Z,2291,1335,3626
A-rustdoc,38161,2016-12-04T19:12:01Z,117,6,123
NULL,38165,2016-12-04T21:51:37Z,779,520,1299
"E-easy;I-cleanup,E-easy;I-cleanup",38168,2016-12-05T02:15:19Z,224,8,232
NULL,38174,2016-12-05T14:20:59Z,0,0,0
NULL,38179,2016-12-05T20:47:42Z,29,13,42
NULL,38182,2016-12-05T21:26:29Z,33,6,39
"A-docs;E-easy,A-docs;E-easy,A-docs;E-easy",38186,2016-12-05T23:37:56Z,4,0,4
NULL,38191,2016-12-06T10:31:31Z,417,365,782
NULL,38192,2016-12-06T12:19:30Z,481,315,796
"A-diagnostics;A-plugin,A-diagnostics;A-plugin",38194,2016-12-06T14:35:56Z,3,15,18
NULL,38195,2016-12-06T16:24:36Z,12,2,14
NULL,38196,2016-12-06T16:39:23Z,19,0,19
NULL,38197,2016-12-06T18:34:58Z,2,7,9
NULL,38205,2016-12-07T01:05:49Z,63,23,86
NULL,38214,2016-12-07T08:23:15Z,193,59,252
NULL,38232,2016-12-08T01:03:53Z,244,258,502
NULL,38233,2016-12-08T01:28:06Z,5,4,9
regression-from-stable-to-nightly,38239,2016-12-08T11:09:23Z,22,0,22
A-llvm,38240,2016-12-08T13:42:43Z,2,2,4
A-incr-comp;T-compiler,38243,2016-12-08T18:14:23Z,68,6,74
"A-rustdoc,A-rustdoc",38244,2016-12-08T18:17:32Z,40,13,53
NULL,38245,2016-12-08T19:23:54Z,326,126,452
NULL,38250,2016-12-08T22:10:48Z,86,7,93
NULL,38252,2016-12-08T23:10:27Z,8,2,10
NULL,38255,2016-12-09T00:26:25Z,0,0,0
NULL,38271,2016-12-09T22:48:34Z,111,28,139
NULL,38274,2016-12-10T00:12:09Z,33,4,37
"A-incr-comp;I-ICE;T-compiler,A-incr-comp;I-ICE;T-compiler",38278,2016-12-10T04:27:30Z,42,22,64
"A-syntaxext;I-wrong;P-low,A-syntaxext;I-wrong;P-low,A-syntaxext;I-wrong;P-low,A-syntaxext;I-wrong;P-low",38279,2016-12-10T07:59:09Z,65,1,66
NULL,38286,2016-12-10T18:30:12Z,3,1,4
NULL,38302,2016-12-11T17:42:15Z,1904,5020,6924
"beta-nominated;T-libs,beta-nominated;T-libs",38304,2016-12-11T17:54:32Z,6,32,38
"B-RFC-approved;T-libs,B-RFC-approved;T-libs",38309,2016-12-12T02:52:20Z,107,0,107
NULL,38310,2016-12-12T03:19:12Z,50,2,52
"A-resolve,A-resolve,A-resolve,A-resolve,A-resolve,A-resolve",38313,2016-12-12T03:59:04Z,78,13,91
NULL,38320,2016-12-12T15:04:05Z,0,0,0
NULL,38325,2016-12-12T19:10:34Z,1255,333,1588
NULL,38328,2016-12-12T21:12:21Z,0,0,0
NULL,38331,2016-12-12T22:41:58Z,16,0,16
NULL,38334,2016-12-13T02:03:44Z,37,3,40
"A-debuginfo;I-enhancement;T-tools,A-debuginfo;I-enhancement;T-tools",38348,2016-12-13T15:28:49Z,0,0,0
NULL,38351,2016-12-13T16:41:50Z,7,7,14
NULL,38357,2016-12-13T23:49:33Z,269,229,498
NULL,38359,2016-12-14T01:28:58Z,152,35,187
NULL,38366,2016-12-14T17:52:03Z,0,0,0
NULL,38368,2016-12-14T19:00:33Z,105,12,117
"B-unstable;T-libs,B-unstable;T-libs,B-unstable;T-libs,B-unstable;E-easy;T-libs,B-unstable;T-libs,B-unstable;I-enhancement;T-libs,B-RFC-approved;T-libs,B-unstable;T-libs,A-io;A-libs;I-enhancement,B-unstable;T-libs,B-RFC-approved;T-libs,B-unstable;T-libs,B-unstable;E-easy;T-libs,B-unstable;T-libs,B-unstable;T-libs,B-unstable;T-libs,B-unstable;E-easy;T-libs,B-unstable;I-enhancement;T-libs,A-io;A-libs;I-enhancement,B-unstable;I-enhancement;T-libs,B-RFC-approved;T-libs,A-io;A-libs;I-enhancement",38369,2016-12-14T20:42:24Z,83,149,232
"I-ICE,I-ICE,regression-from-stable-to-nightly,A-compiler;regression-from-stable-to-nightly;T-compiler,I-ICE",38375,2016-12-14T23:19:49Z,24,2,26
"beta-nominated,beta-nominated;T-tools,beta-nominated;T-tools,beta-nominated",38377,2016-12-15T00:00:10Z,163,15,178
NULL,38387,2016-12-15T16:29:43Z,0,0,0
NULL,38393,2016-12-15T17:58:03Z,18,1,19
NULL,38397,2016-12-15T21:08:48Z,17,0,17
"A-rustbuild;regression-from-stable-to-nightly;T-tools,A-rustbuild;regression-from-stable-to-nightly;T-tools",38398,2016-12-15T21:11:21Z,1,1,2
NULL,38401,2016-12-15T23:38:33Z,1439,42,1481
NULL,38405,2016-12-16T03:49:58Z,6,0,6
NULL,38407,2016-12-16T10:16:33Z,0,0,0
"A-llvm,A-llvm,A-llvm",38411,2016-12-16T17:51:29Z,2,2,4
"A-ARM,A-ARM,A-ARM",38413,2016-12-16T19:04:07Z,11,2,13
NULL,38414,2016-12-16T20:05:24Z,203,168,371
NULL,38415,2016-12-16T21:21:45Z,27,27,54
"A-libs,A-libs,A-libs,A-libs",38421,2016-12-17T00:53:23Z,328,328,656
NULL,38422,2016-12-17T01:58:07Z,1,1,2
"A-tools;B-RFC-approved,A-tools;B-RFC-approved",38426,2016-12-17T03:53:18Z,148,5,153
NULL,38440,2016-12-17T22:17:44Z,17,1,18
A-docs,38443,2016-12-18T01:32:17Z,38,6,44
A-incr-comp;E-mentor;I-enhancement,38449,2016-12-18T04:15:27Z,2280,2757,5037
NULL,38450,2016-12-18T10:37:24Z,0,0,0
NULL,38466,2016-12-19T07:59:46Z,448,363,811
"A-rustbuild,A-rustbuild",38468,2016-12-19T09:12:47Z,18,3,21
NULL,38469,2016-12-19T15:56:41Z,6,2,8
NULL,38470,2016-12-19T17:50:20Z,10,14,24
NULL,38472,2016-12-19T19:43:23Z,2,1,3
beta-nominated,38477,2016-12-19T21:53:32Z,1,1,2
"B-RFC-approved;B-unstable;T-lang,B-RFC-approved;B-unstable;T-lang",38482,2016-12-20T01:22:45Z,2232,485,2717
NULL,38483,2016-12-20T02:16:11Z,9,5,14
NULL,38486,2016-12-20T02:35:10Z,15,0,15
NULL,38493,2016-12-20T10:49:02Z,3,2,5
NULL,38496,2016-12-20T17:39:19Z,7,1,8
NULL,38497,2016-12-20T17:41:31Z,1,1,2
"T-libs,beta-nominated",38499,2016-12-20T19:16:52Z,2615,1526,4141
"beta-nominated,beta-nominated,beta-nominated,beta-nominated",38503,2016-12-20T22:47:37Z,15,15,30
NULL,38505,2016-12-21T01:10:27Z,6,0,6
NULL,38506,2016-12-21T02:53:19Z,10,5,15
NULL,38507,2016-12-21T03:36:29Z,3,0,3
NULL,38511,2016-12-21T14:01:50Z,137,226,363
NULL,38517,2016-12-21T18:59:32Z,3,2,5
NULL,38523,2016-12-21T23:05:35Z,36,36,72
"A-rustbuild,A-rustbuild,A-rustbuild",38534,2016-12-22T07:53:03Z,0,0,0
NULL,38536,2016-12-22T08:06:37Z,25,20,45
NULL,38537,2016-12-22T08:26:24Z,58,0,58
"A-frontend;I-cleanup,A-frontend;I-cleanup",38538,2016-12-22T08:40:04Z,0,6,6
NULL,38539,2016-12-22T08:40:23Z,5,2,7
"A-codegen,A-codegen",38542,2016-12-22T12:26:38Z,149,4,153
NULL,38549,2016-12-22T16:01:24Z,1,1,2
NULL,38551,2016-12-22T17:26:43Z,95,1,96
"A-diagnostics,A-diagnostics",38552,2016-12-22T17:50:46Z,99,15,114
NULL,38555,2016-12-22T19:04:21Z,0,0,0
NULL,38559,2016-12-22T21:33:53Z,345,4,349
"I-ICE;P-high;T-compiler,I-ICE;P-high;T-compiler,I-ICE;P-high;T-compiler",38566,2016-12-23T02:29:43Z,37,17,54
NULL,38574,2016-12-23T14:59:54Z,32,64,96
NULL,38581,2016-12-23T20:20:42Z,12,8,20
"A-rustbuild,A-rustbuild",38583,2016-12-23T23:02:23Z,0,0,0
"A-incr-comp;A-rustbuild;I-compiletime;I-enhancement;T-compiler,A-incr-comp;A-rustbuild;I-compiletime;I-enhancement;T-compiler",38589,2016-12-24T16:25:12Z,26,14,40
NULL,38594,2016-12-24T19:29:35Z,848,48,896
"I-nominated;regression-from-stable-to-nightly;T-compiler,I-nominated;regression-from-stable-to-nightly;T-compiler",38600,2016-12-25T16:48:22Z,93,38,131
NULL,38603,2016-12-25T17:57:14Z,57,5,62
"A-diagnostics,A-diagnostics",38605,2016-12-25T19:31:38Z,120,8,128
"A-diagnostics;A-traits,A-diagnostics;A-traits",38606,2016-12-25T20:51:49Z,30,0,30
NULL,38607,2016-12-25T21:01:04Z,61,4,65
NULL,38617,2016-12-26T18:47:32Z,55,1,56
NULL,38622,2016-12-26T23:11:02Z,24,12,36
NULL,38626,2016-12-27T00:13:13Z,5,9,14
"A-docs,A-docs,A-docs",38630,2016-12-27T05:45:48Z,34,0,34
NULL,38639,2016-12-27T18:12:13Z,13,6,19
"A-docs;E-easy;E-help-wanted,A-docs;E-easy;E-help-wanted,A-docs;E-easy;E-help-wanted",38648,2016-12-28T09:29:48Z,163,163,326
NULL,38654,2016-12-28T17:20:47Z,65,24,89
"A-rustbuild;regression-from-stable-to-nightly;T-tools,A-rustbuild;regression-from-stable-to-nightly;T-tools,A-rustbuild;regression-from-stable-to-nightly;T-tools",38658,2016-12-28T18:54:37Z,11,1,12
NULL,38660,2016-12-28T19:58:39Z,1,1,2
"A-libs,A-libs",38661,2016-12-28T20:17:59Z,93,36,129
"B-RFC-approved,B-RFC-approved",38664,2016-12-28T22:49:43Z,20,29,49
NULL,38670,2016-12-29T01:49:52Z,97,65,162
NULL,38671,2016-12-29T03:11:05Z,1,2,3
NULL,38675,2016-12-29T14:17:48Z,8,3,11
"regression-from-stable-to-nightly;T-compiler,regression-from-stable-to-nightly;T-compiler",38689,2016-12-29T21:04:22Z,285,1,286
A-spurious,38695,2016-12-30T00:01:30Z,45,0,45
NULL,38697,2016-12-30T01:26:42Z,1067,300,1367
A-rustdoc;I-wrong;regression-from-stable-to-nightly;T-tools,38698,2016-12-30T01:37:27Z,0,0,0
"A-frontend;E-easy,E-easy;I-cleanup,I-completion,A-frontend;E-easy,E-easy;I-cleanup,A-frontend;A-typesystem;I-completion",38699,2016-12-30T04:30:11Z,765,7,772
NULL,38701,2016-12-30T12:53:38Z,1306,1572,2878
"A-docs,A-docs",38704,2016-12-30T15:40:13Z,0,0,0
"A-infrastructure;I-nominated;T-tools,A-infrastructure;I-nominated;T-tools",38708,2016-12-30T17:42:05Z,52,7,59
NULL,38709,2016-12-30T17:58:27Z,6,0,6
"beta-nominated,beta-nominated,beta-nominated,beta-nominated",38716,2016-12-30T21:29:40Z,276,125,401
NULL,38726,2016-12-31T01:51:53Z,291,12,303
"T-tools,T-tools",38731,2016-12-31T04:08:44Z,486,34,520
NULL,38736,2016-12-31T06:32:44Z,10,1,11
NULL,38737,2016-12-31T06:44:47Z,60,2,62
NULL,38745,2016-12-31T18:39:50Z,446,443,889
NULL,38752,2017-01-01T08:14:00Z,0,0,0
NULL,38753,2017-01-01T09:35:19Z,15,10,25
NULL,38765,2017-01-01T20:19:22Z,9,1,10
NULL,38779,2017-01-02T18:21:33Z,148,97,245
NULL,38791,2017-01-03T01:56:23Z,26,1,27
"A-diagnostics;I-nominated;T-compiler,A-diagnostics;I-nominated;T-compiler",38792,2017-01-03T02:15:41Z,50,7,57
"A-macros;regression-from-stable-to-beta;T-compiler,A-macros;regression-from-stable-to-beta;T-compiler",38793,2017-01-03T02:51:33Z,42,1,43
A-testsuite;A-windows;E-easy;I-wrong,38796,2017-01-03T12:27:20Z,0,0,0
"A-testsuite;A-windows;E-easy;I-wrong,A-testsuite;A-windows;E-easy;I-wrong",38797,2017-01-03T12:35:34Z,67,18,85
NULL,38798,2017-01-03T17:51:33Z,22,1,23
NULL,38813,2017-01-04T02:27:59Z,1120,1407,2527
NULL,38815,2017-01-04T05:46:21Z,2,1,3
"regression-from-stable-to-beta,regression-from-stable-to-beta",38817,2017-01-04T06:55:33Z,17,17,34
"A-mir,A-mir",38822,2017-01-04T15:07:35Z,123,24,147
NULL,38826,2017-01-04T16:03:34Z,0,0,0
NULL,38833,2017-01-04T23:22:24Z,87,79,166
NULL,38834,2017-01-04T23:24:11Z,0,0,0
NULL,38835,2017-01-04T23:46:31Z,153,29,182
NULL,38837,2017-01-05T01:21:13Z,40,13,53
NULL,38840,2017-01-05T04:28:54Z,4,3,7
NULL,38855,2017-01-05T19:41:09Z,26,1,27
"I-enhancement;T-libs,I-enhancement;T-libs",38856,2017-01-05T20:58:53Z,99,3,102
"A-rustbuild;regression-from-stable-to-nightly;T-tools,A-rustbuild;regression-from-stable-to-nightly;T-tools",38858,2017-01-05T22:33:28Z,10,1,11
NULL,38859,2017-01-05T23:09:13Z,23,1,24
NULL,38861,2017-01-06T01:51:39Z,44,24,68
NULL,38867,2017-01-06T07:00:47Z,1,0,1
NULL,38871,2017-01-06T11:24:54Z,0,0,0
"beta-nominated,beta-accepted;beta-nominated;T-compiler,beta-nominated,beta-nominated;T-compiler,beta-nominated;T-compiler,beta-nominated;T-compiler,beta-accepted;beta-nominated;T-compiler",38872,2017-01-06T14:58:06Z,883,241,1124
NULL,38876,2017-01-06T16:27:19Z,0,0,0
"A-android;A-spurious,A-android;A-spurious",38883,2017-01-06T18:32:13Z,39,42,81
"beta-nominated;T-compiler,beta-nominated;T-compiler,beta-nominated;T-compiler,beta-nominated;T-compiler",38884,2017-01-06T18:56:59Z,264,40,304
"A-diagnostics;A-resolve;E-easy,A-diagnostics;A-resolve;E-easy",38890,2017-01-06T21:18:21Z,304,294,598
NULL,38897,2017-01-06T23:55:23Z,270,190,460
NULL,38902,2017-01-07T03:02:47Z,0,0,0
NULL,38914,2017-01-08T03:09:03Z,225,20,245
"A-traits;B-RFC-approved;B-unstable;T-lang,A-traits;B-RFC-approved;B-unstable;T-lang",38920,2017-01-08T11:47:11Z,122,67,189
NULL,38925,2017-01-08T13:44:15Z,24,5,29
"A-diagnostics;E-mentor,A-diagnostics;E-mentor",38927,2017-01-08T17:01:48Z,157,19,176
NULL,38929,2017-01-08T19:39:07Z,17,9,26
NULL,38943,2017-01-09T15:15:15Z,0,0,0
NULL,38949,2017-01-09T22:48:39Z,5,1,6
NULL,38955,2017-01-10T06:34:55Z,242,67,309
"E-easy;E-mentor;T-doc,E-easy;E-mentor;T-doc",38956,2017-01-10T10:39:36Z,3,2,5
NULL,38957,2017-01-10T11:06:29Z,0,0,0
NULL,38958,2017-01-10T11:27:49Z,346,49,395
"B-RFC-approved;B-unstable;T-lang,B-RFC-approved;B-unstable;T-lang,B-RFC-approved;B-unstable;T-lang",38959,2017-01-10T12:51:52Z,27,1,28
NULL,38960,2017-01-10T14:36:58Z,10,6,16
NULL,38961,2017-01-10T15:24:41Z,36,11,47
NULL,38968,2017-01-10T22:28:27Z,0,0,0
"B-RFC-approved,B-RFC-approved",38970,2017-01-10T22:53:43Z,26,4,30
NULL,38983,2017-01-11T03:26:38Z,251,17,268
relnotes,38984,2017-01-11T04:33:39Z,25,4,29
beta-nominated,38989,2017-01-11T07:52:51Z,22,13,35
NULL,38992,2017-01-11T14:38:18Z,31,14,45
NULL,39002,2017-01-11T22:13:19Z,257,0,257
NULL,39008,2017-01-12T07:15:35Z,10,6,16
NULL,39010,2017-01-12T08:51:28Z,0,0,0
NULL,39011,2017-01-12T13:23:42Z,0,0,0
NULL,39019,2017-01-12T21:06:10Z,25,3,28
NULL,39021,2017-01-12T23:01:06Z,15,0,15
NULL,39022,2017-01-13T00:03:36Z,0,0,0
NULL,39023,2017-01-13T00:47:30Z,0,0,0
NULL,39026,2017-01-13T01:28:17Z,13,1,14
NULL,39030,2017-01-13T09:42:35Z,337,74,411
A-spurious,39036,2017-01-13T18:11:53Z,0,2,2
"A-debuginfo;A-testsuite,A-debuginfo;A-testsuite",39039,2017-01-13T18:36:32Z,54,9,63
NULL,39042,2017-01-13T20:58:30Z,394,55,449
NULL,39043,2017-01-13T21:30:16Z,0,0,0
"A-diagnostics,A-diagnostics",39048,2017-01-13T23:17:41Z,20,0,20
"A-spurious,A-spurious",39055,2017-01-14T03:15:13Z,2,2,4
NULL,39062,2017-01-14T13:24:59Z,77,2,79
NULL,39066,2017-01-14T18:00:17Z,205,81,286
"T-tools,T-tools",39068,2017-01-14T19:51:54Z,152,77,229
NULL,39071,2017-01-14T23:52:55Z,3,9,12
"B-unstable;T-libs,B-unstable;T-libs,B-unstable;T-libs",39075,2017-01-15T07:49:50Z,5,247,252
"regression-from-stable-to-beta,regression-from-stable-to-beta",39077,2017-01-15T11:11:09Z,14,4,18
A-incr-comp;A-rustbuild;I-compiletime;I-enhancement;T-compiler,39086,2017-01-15T22:55:30Z,17,5,22
"A-docs;E-easy,A-docs;E-easy",39091,2017-01-16T09:11:23Z,34,1,35
"A-frontend;E-easy;I-wrong,I-completion,A-frontend;E-easy;I-completion,A-frontend;E-easy;I-wrong,I-completion,A-frontend;E-easy;I-completion",39096,2017-01-16T10:11:18Z,0,0,0
NULL,39100,2017-01-16T16:51:21Z,4,0,4
NULL,39102,2017-01-16T18:08:12Z,6,2,8
NULL,39108,2017-01-16T21:48:27Z,111,15,126
NULL,39110,2017-01-16T23:29:48Z,239,373,612
T-tools,39111,2017-01-17T00:38:44Z,243,86,329
T-tools,39112,2017-01-17T00:51:35Z,1,1,2
"A-diagnostics,A-diagnostics",39116,2017-01-17T04:02:16Z,133,3,136
NULL,39120,2017-01-17T07:44:28Z,92,2,94
"relnotes;T-tools,A-debuginfo;I-enhancement;T-tools,relnotes;T-tools,A-debuginfo;I-enhancement;T-tools",39130,2017-01-17T16:41:42Z,0,0,0
NULL,39136,2017-01-17T21:22:40Z,4,0,4
NULL,39138,2017-01-17T22:17:18Z,13,1,14
NULL,39139,2017-01-17T22:17:35Z,310,67,377
"beta-nominated;T-compiler,beta-nominated,beta-nominated,beta-nominated",39140,2017-01-17T22:52:24Z,521,21,542
beta-nominated;T-compiler,39141,2017-01-17T23:28:20Z,2,1,3
"I-crash;regression-from-stable-to-nightly;T-compiler,I-crash;regression-from-stable-to-nightly;T-compiler",39142,2017-01-17T23:32:56Z,49,30,79
NULL,39143,2017-01-17T23:33:24Z,18,0,18
NULL,39149,2017-01-18T06:19:31Z,26,1,27
NULL,39150,2017-01-18T06:31:00Z,17,8,25
NULL,39156,2017-01-18T16:15:12Z,227,3,230
NULL,39157,2017-01-18T16:30:43Z,74,2,76
NULL,39158,2017-01-18T17:09:18Z,565,469,1034
T-tools,39167,2017-01-19T00:11:15Z,3,8,11
"beta-nominated,beta-nominated",39170,2017-01-19T01:57:07Z,26,4,30
NULL,39176,2017-01-19T09:35:26Z,12,1,13
NULL,39179,2017-01-19T10:40:15Z,24,2,26
NULL,39180,2017-01-19T10:56:13Z,236,42,278
NULL,39184,2017-01-19T16:36:10Z,20,18,38
NULL,39189,2017-01-19T19:11:05Z,38,7,45
"A-codegen;E-help-wanted,A-codegen;E-help-wanted,A-codegen;E-help-wanted",39193,2017-01-19T21:34:18Z,15,0,15
"A-metadata;B-unstable;metabug;T-compiler,A-metadata;B-unstable;metabug;T-compiler",39195,2017-01-19T23:08:01Z,1,3,4
"B-RFC-approved,B-RFC-approved,B-RFC-approved",39196,2017-01-19T23:12:05Z,24,6,30
NULL,39197,2017-01-19T23:28:04Z,26,0,26
"needs-crater,beta-nominated;T-compiler,beta-nominated,needs-crater,beta-nominated,beta-nominated;T-compiler",39199,2017-01-19T23:49:54Z,4974,927,5901
NULL,39202,2017-01-20T07:22:55Z,144,1,145
A-docs,39210,2017-01-20T21:33:53Z,9,1,10
NULL,39229,2017-01-21T18:41:29Z,0,0,0
NULL,39231,2017-01-21T20:47:49Z,0,0,0
NULL,39234,2017-01-21T23:01:57Z,182,4,186
NULL,39243,2017-01-22T16:54:09Z,13,4,17
T-tools,39245,2017-01-22T18:21:49Z,1398,25,1423
NULL,39247,2017-01-22T22:22:43Z,10,4,14
NULL,39250,2017-01-22T23:36:29Z,4,2,6
NULL,39258,2017-01-23T19:27:54Z,4,0,4
NULL,39260,2017-01-23T21:40:54Z,45,11,56
NULL,39265,2017-01-23T23:44:42Z,3,34,37
NULL,39271,2017-01-24T17:23:36Z,172,0,172
NULL,39281,2017-01-24T23:03:57Z,38,13,51
NULL,39282,2017-01-24T23:17:40Z,2,55,57
"T-tools,T-tools,T-tools",39284,2017-01-25T00:05:20Z,512,1,513
"A-libs,A-libs,A-libs,A-libs",39289,2017-01-25T06:18:05Z,70,0,70
NULL,39291,2017-01-25T12:34:31Z,65,14,79
NULL,39296,2017-01-25T16:08:21Z,43,36,79
NULL,39303,2017-01-25T21:46:36Z,0,0,0
NULL,39305,2017-01-25T22:13:20Z,1799,1856,3655
NULL,39306,2017-01-25T22:29:47Z,7,1,8
"B-unstable;T-libs,B-unstable;T-libs,B-unstable;T-libs,B-RFC-approved;T-libs,B-unstable;T-libs,B-unstable;T-libs,B-unstable;T-libs,B-unstable;T-libs,B-unstable;T-libs,B-unstable;T-libs,B-unstable;T-libs,B-RFC-approved;T-libs",39307,2017-01-26T00:43:16Z,26,371,397
"A-rustdoc;E-easy;I-wrong,A-rustdoc;E-easy;I-wrong,A-rustdoc;E-easy;I-wrong",39312,2017-01-26T06:44:24Z,1,1,2
NULL,39319,2017-01-26T15:54:30Z,5,11,16
NULL,39329,2017-01-26T23:06:37Z,147,117,264
NULL,39335,2017-01-27T05:52:55Z,53,1,54
"B-unstable;T-lang,B-unstable;T-lang",39337,2017-01-27T08:48:17Z,0,0,0
NULL,39340,2017-01-27T16:00:12Z,2,1,3
"T-libs,T-libs",39353,2017-01-27T22:41:32Z,782,447,1229
NULL,39354,2017-01-27T22:53:35Z,4,0,4
NULL,39358,2017-01-28T11:57:16Z,0,0,0
"A-docs,A-docs",39374,2017-01-28T21:53:39Z,13,5,18
"A-windows,A-windows",39379,2017-01-29T04:49:21Z,1,5,6
"A-mir,A-mir,A-mir",39383,2017-01-29T06:22:35Z,2,5,7
"A-rustbuild,A-rustbuild",39392,2017-01-29T11:47:37Z,1,1,2
"A-build;A-rustbuild,A-build;A-rustbuild",39400,2017-01-29T22:16:05Z,3773,50,3823
"B-RFC-approved;B-unstable;T-lang,B-RFC-approved;B-unstable;T-lang,B-RFC-approved;T-libs,B-RFC-approved;B-unstable;T-lang,B-RFC-approved;T-libs,B-RFC-approved;T-libs",39408,2017-01-30T13:35:26Z,36,4,40
NULL,39411,2017-01-30T19:54:00Z,2,2,4
"A-macros,A-macros,A-macros,A-macros,A-macros,A-macros,A-macros,A-macros,A-macros",39419,2017-01-31T06:34:42Z,762,766,1528
I-slow,39422,2017-01-31T12:54:05Z,0,0,0
A-incr-comp;T-compiler,39424,2017-01-31T17:08:11Z,1209,479,1688
NULL,39431,2017-01-31T21:51:05Z,75,8148,8223
A-incr-comp;T-compiler,39434,2017-01-31T23:04:17Z,290,131,421
"A-diagnostics,A-diagnostics",39441,2017-02-01T06:29:01Z,0,0,0
NULL,39442,2017-02-01T10:37:59Z,483,342,825
NULL,39443,2017-02-01T12:02:57Z,42,1,43
B-unstable;T-lang,39444,2017-02-01T13:11:13Z,17,66,83
NULL,39457,2017-02-02T07:32:16Z,134,115,249
"A-diagnostics,A-diagnostics,A-diagnostics",39458,2017-02-02T09:54:00Z,0,0,0
"E-easy;E-mentor;T-doc,E-easy;E-mentor;T-doc,E-easy;E-mentor;T-doc",39459,2017-02-02T11:38:26Z,46,0,46
NULL,39462,2017-02-02T14:56:41Z,79,7,86
"A-libs;I-nominated;I-unsound;T-libs,A-libs;I-nominated;I-unsound;T-libs,A-libs;I-nominated;I-unsound;T-libs",39466,2017-02-02T19:28:04Z,1,1,2
NULL,39470,2017-02-02T21:22:34Z,75,137,212
NULL,39472,2017-02-02T21:40:31Z,3,3,6
"B-RFC-approved;T-libs,B-RFC-approved;T-libs,B-RFC-approved;T-libs",39477,2017-02-03T01:45:28Z,1,1,2
"A-rustbuild;I-wrong;T-tools,A-rustbuild;I-wrong;T-tools,A-rustbuild;I-wrong;T-tools",39478,2017-02-03T03:25:02Z,2,1,3
NULL,39481,2017-02-03T07:16:27Z,6,5,11
NULL,39485,2017-02-03T13:17:11Z,11,36,47
NULL,39486,2017-02-03T13:47:21Z,1,1,2
"A-asmjs;A-linkage;A-wasm,E-help-wanted,E-help-wanted,A-asmjs;A-linkage;A-wasm,E-help-wanted,A-asmjs;A-linkage;A-wasm",39490,2017-02-03T16:15:22Z,168,6,174
"beta-nominated;T-libs,beta-nominated;T-libs,beta-nominated;T-libs",39493,2017-02-03T17:16:45Z,1,1,2
NULL,39501,2017-02-03T20:27:50Z,667,486,1153
NULL,39509,2017-02-03T22:21:07Z,3,1,4
"B-unstable;T-libs,B-unstable;T-libs,B-unstable;T-libs",39512,2017-02-03T23:30:14Z,30,32,62
"beta-nominated;T-libs,beta-nominated;T-libs",39515,2017-02-04T01:03:43Z,0,0,0
"beta-nominated;T-libs,beta-nominated;T-libs",39516,2017-02-04T01:05:17Z,10,2,12
"regression-from-stable-to-beta,regression-from-stable-to-beta,regression-from-stable-to-beta",39518,2017-02-04T01:34:50Z,39,3,42
NULL,39521,2017-02-04T04:04:28Z,0,0,0
"A-debuginfo;A-testsuite,A-debuginfo;A-testsuite,A-debuginfo;A-testsuite,A-debuginfo;A-testsuite",39530,2017-02-04T10:55:50Z,10,10,20
"beta-accepted;beta-nominated,beta-accepted;beta-nominated",39533,2017-02-04T13:41:26Z,21,6,27
"A-diagnostics;A-macros;beta-nominated;T-compiler,beta-accepted;beta-nominated",39536,2017-02-04T14:46:59Z,0,0,0
"A-diagnostics;A-macros;beta-nominated;T-compiler,beta-accepted;beta-nominated",39537,2017-02-04T14:48:15Z,0,0,0
NULL,39552,2017-02-05T05:31:10Z,1,1,2
NULL,39554,2017-02-05T07:01:07Z,44,6,50
NULL,39556,2017-02-05T08:15:47Z,0,0,0
NULL,39560,2017-02-05T09:41:44Z,182,46,228
NULL,39561,2017-02-05T10:17:30Z,1442,1372,2814
"T-libs,T-libs,T-libs,T-libs",39562,2017-02-05T13:27:17Z,0,0,0
"T-libs,T-libs",39563,2017-02-05T14:14:58Z,1344,576,1920
"beta-nominated;T-libs,beta-nominated;T-libs",39565,2017-02-05T16:59:15Z,0,0,0
"beta-nominated;T-libs,beta-nominated,beta-nominated;T-libs,beta-nominated",39566,2017-02-05T17:41:47Z,0,0,0
"beta-nominated,beta-nominated;T-libs,beta-nominated,beta-nominated;T-libs",39567,2017-02-05T17:45:16Z,871,593,1464
"A-macros;I-needs-decision,A-macros;I-needs-decision",39572,2017-02-05T23:29:41Z,325,313,638
NULL,39574,2017-02-06T07:33:52Z,2,1,3
NULL,39581,2017-02-06T14:13:57Z,0,0,0
"A-codegen;A-compiler;A-concurrency;A-incr-comp;I-compiletime;T-compiler,A-codegen;A-compiler;A-concurrency;A-incr-comp;I-compiletime;T-compiler,A-codegen;A-compiler;A-concurrency;A-incr-comp;I-compiletime;T-compiler,A-codegen;A-compiler;A-concurrency;A-incr-comp;I-compiletime;T-compiler,A-codegen;A-compiler;A-concurrency;A-incr-comp;I-compiletime;T-compiler",39583,2017-02-06T15:21:44Z,8,4,12
NULL,39586,2017-02-06T16:47:59Z,388,267,655
NULL,39591,2017-02-06T18:40:18Z,1,27,28
"A-docs;B-RFC-approved;T-doc,A-docs;B-RFC-approved;T-doc,A-docs;B-RFC-approved;T-doc,A-docs;B-RFC-approved;T-doc,A-docs;B-RFC-approved;T-doc,A-docs;B-RFC-approved;T-doc",39593,2017-02-06T20:06:59Z,32,20,52
NULL,39594,2017-02-06T20:25:16Z,192,1,193
NULL,39597,2017-02-06T21:15:34Z,108,47,155
NULL,39598,2017-02-06T21:29:56Z,1,3,4
"beta-accepted;beta-nominated,beta-accepted;beta-nominated,beta-accepted;beta-nominated,beta-accepted;beta-nominated,beta-accepted;beta-nominated",39600,2017-02-06T21:36:33Z,2,0,2
NULL,39602,2017-02-06T23:50:18Z,33,1,34
NULL,39604,2017-02-07T00:57:15Z,0,3,3
"beta-accepted;beta-nominated,beta-accepted;beta-nominated,beta-accepted;beta-nominated,beta-accepted;beta-nominated,beta-accepted;beta-nominated,beta-accepted;beta-nominated",39605,2017-02-07T01:49:04Z,0,0,0
"beta-accepted;beta-nominated,beta-nominated,beta-accepted;beta-nominated,beta-nominated,beta-accepted;beta-nominated,beta-nominated,beta-accepted;beta-nominated,beta-nominated,beta-accepted;beta-nominated,beta-nominated",39609,2017-02-07T03:10:29Z,0,0,0
"beta-accepted;beta-nominated,beta-nominated,beta-accepted;beta-nominated,beta-nominated",39613,2017-02-07T05:39:00Z,0,0,0
"A-incr-comp;I-ICE,A-incr-comp;I-ICE",39619,2017-02-07T17:42:49Z,19,12,31
NULL,39624,2017-02-07T19:51:09Z,1,1,2
"beta-accepted;beta-nominated,beta-nominated,beta-accepted;beta-nominated",39632,2017-02-08T00:20:25Z,0,0,0
"A-docs;B-RFC-approved;T-doc,A-docs;B-RFC-approved;T-doc",39633,2017-02-08T00:24:01Z,587,1199,1786
NULL,39638,2017-02-08T03:54:33Z,4129,8275,12404
NULL,39642,2017-02-08T11:35:30Z,4,3,7
"beta-accepted;beta-nominated,beta-accepted;beta-nominated",39643,2017-02-08T13:44:46Z,0,0,0
beta-accepted;beta-nominated,39645,2017-02-08T15:20:01Z,1922,1606,3528
NULL,39647,2017-02-08T15:33:00Z,6,1,7
NULL,39652,2017-02-08T20:54:44Z,0,0,0
"A-diagnostics,A-diagnostics,A-diagnostics",39655,2017-02-08T22:07:18Z,203,62,265
NULL,39659,2017-02-08T22:46:39Z,858,0,858
NULL,39663,2017-02-09T00:14:17Z,0,0,0
NULL,39667,2017-02-09T00:58:18Z,5,0,5
NULL,39668,2017-02-09T01:03:01Z,9,2,11
"I-ICE;regression-from-stable-to-beta,A-macros;I-ICE,I-ICE;regression-from-stable-to-beta,A-macros;I-ICE",39674,2017-02-09T03:58:44Z,42,3,45
beta-accepted;beta-nominated,39677,2017-02-09T04:55:52Z,928,46,974
NULL,39678,2017-02-09T06:22:26Z,51,1,52
NULL,39680,2017-02-09T09:35:55Z,68,22,90
"I-crash;P-high;T-compiler;T-lang,I-crash;P-high;T-compiler;T-lang",39682,2017-02-09T11:18:02Z,46,15,61
"I-crash;P-high;T-compiler;T-lang,I-crash;P-high;T-compiler;T-lang",39683,2017-02-09T11:42:32Z,9,1,10
beta-nominated,39686,2017-02-09T13:47:37Z,279,187,466
NULL,39693,2017-02-09T17:09:06Z,1,0,1
NULL,39694,2017-02-09T17:14:25Z,127,36,163
NULL,39700,2017-02-09T18:59:25Z,18,1,19
NULL,39707,2017-02-09T21:58:21Z,13,52,65
"beta-nominated;T-compiler,beta-nominated;T-compiler",39712,2017-02-10T00:43:27Z,101,78,179
"A-frontend;E-easy,E-easy;I-cleanup,A-frontend;E-easy,E-easy;I-cleanup",39713,2017-02-10T01:59:26Z,175,50,225
A-libs;B-RFC-approved,39715,2017-02-10T07:19:14Z,0,0,0
"A-libs;B-RFC-approved,A-libs;B-RFC-approved",39716,2017-02-10T09:08:58Z,27,0,27
"A-testsuite;T-compiler,A-testsuite;T-compiler",39717,2017-02-10T09:14:31Z,14,0,14
beta-accepted;beta-nominated,39718,2017-02-10T15:50:31Z,0,0,0
NULL,39721,2017-02-10T18:11:26Z,31,23,54
NULL,39728,2017-02-10T21:40:46Z,106,39932,40038
NULL,39730,2017-02-11T00:13:45Z,29,5,34
"beta-accepted;beta-nominated,beta-accepted;beta-nominated,beta-accepted;beta-nominated,beta-nominated,beta-accepted;beta-nominated,beta-nominated;T-libs",39734,2017-02-11T02:27:23Z,47,7,54
beta-accepted;beta-nominated,39735,2017-02-11T04:41:06Z,0,0,0
beta-accepted;beta-nominated,39736,2017-02-11T04:41:41Z,63,58,121
NULL,39744,2017-02-11T19:42:32Z,0,0,0
NULL,39750,2017-02-11T22:32:40Z,17,6,23
"A-diagnostics;E-mentor,A-diagnostics;E-mentor",39752,2017-02-12T00:16:52Z,300,123,423
"A-docs,A-docs",39757,2017-02-12T02:19:57Z,0,0,0
NULL,39758,2017-02-12T02:26:47Z,44,36,80
NULL,39759,2017-02-12T04:31:52Z,18,1,19
"E-easy;E-mentor;T-doc,A-lang;B-RFC-approved;B-unstable",39761,2017-02-12T06:17:59Z,5,45,50
NULL,39765,2017-02-12T14:20:29Z,193,40,233
NULL,39769,2017-02-12T18:16:35Z,110,63,173
NULL,39772,2017-02-12T23:26:27Z,25,1,26
NULL,39774,2017-02-13T00:16:59Z,0,1,1
NULL,39780,2017-02-13T03:38:41Z,0,0,0
NULL,39787,2017-02-13T15:58:54Z,90,39,129
A-libs;B-RFC-approved,39793,2017-02-13T19:32:54Z,62,62,124
"T-libs,beta-nominated;T-compiler,T-libs",39800,2017-02-14T02:12:12Z,0,0,0
NULL,39804,2017-02-14T04:34:06Z,86,3,89
"beta-nominated;T-compiler,T-libs",39805,2017-02-14T04:36:17Z,0,0,0
NULL,39813,2017-02-14T10:51:55Z,23,9,32
NULL,39814,2017-02-14T13:35:02Z,0,0,0
"beta-nominated;T-compiler,T-libs",39816,2017-02-14T13:51:07Z,0,0,0
"beta-nominated;T-compiler,T-libs",39818,2017-02-14T15:07:38Z,1045,40,1085
NULL,39832,2017-02-14T23:06:08Z,48,1,49
"T-libs,T-libs,T-libs,T-libs",39833,2017-02-15T01:23:31Z,0,0,0
NULL,39834,2017-02-15T02:15:10Z,50,1,51
NULL,39836,2017-02-15T04:08:07Z,4,4,8
"A-tools;B-RFC-approved,A-tools;B-RFC-approved",39837,2017-02-15T04:12:58Z,12,1,13
NULL,39843,2017-02-15T10:43:36Z,95,0,95
"A-docs;E-easy;E-mentor,A-docs;E-easy;E-mentor",39845,2017-02-15T12:03:13Z,73,0,73
"A-docs;B-RFC-approved;T-doc,A-docs;B-RFC-approved;T-doc",39855,2017-02-15T19:59:01Z,5362,4449,9811
NULL,39857,2017-02-15T20:54:43Z,14,7,21
NULL,39862,2017-02-15T22:33:44Z,3,3,6
T-libs,39863,2017-02-15T22:39:59Z,0,0,0
"E-medium;E-mentor;I-enhancement;T-compiler,E-medium;E-mentor;I-enhancement;T-compiler",39864,2017-02-15T22:53:19Z,443,199,642
"A-docs;B-RFC-approved;T-doc,A-docs;B-RFC-approved;T-doc",39866,2017-02-15T23:51:51Z,1502,569,2071
T-libs,39869,2017-02-16T00:49:50Z,0,0,0
NULL,39871,2017-02-16T01:55:34Z,10,30,40
NULL,39874,2017-02-16T02:51:32Z,49,10,59
NULL,39885,2017-02-16T17:21:46Z,0,0,0
I-crash;T-compiler,39887,2017-02-16T18:56:54Z,35,1,36
A-rustbuild,39888,2017-02-16T19:02:53Z,22,3,25
NULL,39892,2017-02-16T23:01:25Z,21,13,34
NULL,39899,2017-02-17T03:20:40Z,0,0,0
NULL,39903,2017-02-17T05:41:41Z,47,1,48
A-diagnostics,39905,2017-02-17T07:01:48Z,37,30,67
"A-diagnostics,A-diagnostics",39906,2017-02-17T07:51:31Z,0,0,0
NULL,39907,2017-02-17T09:13:13Z,0,0,0
NULL,39913,2017-02-17T17:16:23Z,362,260,622
"E-medium;E-mentor;I-enhancement;T-compiler,E-medium;E-mentor;I-enhancement;T-compiler",39921,2017-02-17T23:14:51Z,159,5,164
"A-borrow-checker;I-nominated;I-unsound;T-compiler,A-borrow-checker;I-nominated;I-unsound;T-compiler",39927,2017-02-18T12:08:30Z,266,401,667
NULL,39933,2017-02-18T17:10:16Z,27,20,47
"T-libs,T-libs",39937,2017-02-18T20:08:26Z,5,5,10
NULL,39939,2017-02-18T21:37:14Z,119,65,184
A-diagnostics;E-mentor,39953,2017-02-19T09:39:54Z,92,43,135
NULL,39956,2017-02-19T12:27:44Z,0,0,0
NULL,39960,2017-02-19T14:41:42Z,14,0,14
NULL,39973,2017-02-20T13:50:16Z,0,0,0
NULL,39976,2017-02-20T14:40:58Z,116,108,224
NULL,39977,2017-02-20T14:42:31Z,235,279,514
"A-typesystem;regression-from-stable-to-nightly;T-compiler,A-typesystem;regression-from-stable-to-nightly;T-compiler",39980,2017-02-20T17:23:16Z,154,37,191
NULL,39981,2017-02-20T17:42:56Z,483,373,856
NULL,39986,2017-02-20T20:55:53Z,0,0,0
"T-libs,T-libs",39988,2017-02-20T21:19:53Z,11,23,34
NULL,39990,2017-02-20T22:30:02Z,6,2,8
"A-incr-comp,A-incr-comp",39993,2017-02-21T03:37:00Z,5,3,8
NULL,39995,2017-02-21T08:48:28Z,36,8,44
"A-traits;B-RFC-approved;B-unstable;T-lang,A-compiler;A-traits;I-ICE,A-traits;B-RFC-approved;B-unstable;T-lang,A-compiler;A-traits;I-ICE",40008,2017-02-21T18:31:06Z,4934,5954,10888
"T-libs,T-libs",40009,2017-02-21T19:00:36Z,136,21,157
NULL,40018,2017-02-21T22:14:54Z,682,240,922
NULL,40019,2017-02-21T22:23:13Z,12,12,24
NULL,40020,2017-02-21T22:36:51Z,5,2,7
NULL,40023,2017-02-21T23:46:44Z,0,0,0
NULL,40024,2017-02-21T23:57:55Z,16,15,31
"B-RFC-approved;T-lang,B-RFC-approved;T-lang",40025,2017-02-22T02:20:43Z,275,3,278
"B-unstable;T-lang,B-unstable;T-lang",40027,2017-02-22T07:42:57Z,8,94,102
NULL,40031,2017-02-22T14:24:06Z,5,3,8
NULL,40035,2017-02-22T14:56:22Z,6,0,6
"B-RFC-approved;T-tools,B-RFC-approved;T-tools",40037,2017-02-22T15:31:11Z,50,14,64
"A-incr-comp,A-incr-comp",40038,2017-02-22T17:03:25Z,82,3,85
NULL,40039,2017-02-22T21:14:49Z,88,0,88
NULL,40040,2017-02-22T22:32:34Z,0,0,0
needs-crater,40043,2017-02-23T00:13:47Z,294,267,561
NULL,40045,2017-02-23T02:09:57Z,0,0,0
"beta-nominated,beta-nominated,beta-nominated;T-compiler,beta-nominated;T-compiler,beta-nominated,beta-nominated,beta-nominated;T-compiler,beta-nominated;T-compiler",40046,2017-02-23T03:02:35Z,1102,602,1704
NULL,40047,2017-02-23T05:09:03Z,26,2,28
NULL,40048,2017-02-23T05:39:13Z,4,21,25
NULL,40053,2017-02-23T10:51:01Z,0,0,0
NULL,40059,2017-02-23T13:56:49Z,0,0,0
"I-ICE;regression-from-stable-to-beta;T-compiler,I-ICE;regression-from-stable-to-beta;T-compiler",40064,2017-02-23T17:09:13Z,62,7,69
"A-docs,A-docs",40069,2017-02-24T00:53:59Z,20,2,22
NULL,40072,2017-02-24T12:23:02Z,223,40,263
NULL,40080,2017-02-24T17:08:05Z,0,0,0
"A-spurious,A-spurious",40084,2017-02-24T21:19:43Z,81,82,163
"beta-nominated,beta-nominated,beta-nominated",40089,2017-02-25T10:24:47Z,0,0,0
"beta-nominated,beta-nominated,beta-nominated",40091,2017-02-25T12:13:44Z,1520,536,2056
NULL,40097,2017-02-25T21:20:39Z,0,0,0
NULL,40098,2017-02-25T21:47:37Z,0,0,0
NULL,40099,2017-02-25T22:33:51Z,0,0,0
NULL,40101,2017-02-25T23:04:02Z,23,1,24
NULL,40105,2017-02-26T01:53:34Z,0,0,0
NULL,40111,2017-02-26T04:21:57Z,3,19,22
NULL,40117,2017-02-26T18:45:23Z,16,2,18
NULL,40123,2017-02-27T15:09:35Z,57,29,86
A-macros;A-plugin;B-RFC-approved,40129,2017-02-27T20:11:28Z,213,10,223
NULL,40130,2017-02-27T20:47:29Z,2,2,4
NULL,40137,2017-02-28T02:59:38Z,0,0,0
NULL,40138,2017-02-28T04:10:01Z,0,0,0
NULL,40143,2017-02-28T10:23:20Z,0,0,0
NULL,40147,2017-02-28T11:17:30Z,0,0,0
NULL,40148,2017-02-28T13:33:11Z,663,362,1025
NULL,40150,2017-02-28T17:23:21Z,86,1,87
NULL,40160,2017-02-28T21:22:05Z,0,0,0
"E-easy;I-ICE,A-mir;I-ICE,E-easy;I-ICE,A-mir;I-ICE",40163,2017-02-28T23:33:05Z,235,136,371
NULL,40164,2017-02-28T23:38:44Z,168,83,251
NULL,40166,2017-03-01T00:09:25Z,23,1,24
A-macros;needs-crater,40167,2017-03-01T03:55:32Z,1521,1297,2818
NULL,40168,2017-03-01T04:14:55Z,9,1,10
NULL,40173,2017-03-01T11:26:47Z,2,2,4
NULL,40178,2017-03-01T17:06:06Z,133,129,262
"regression-from-stable-to-nightly,regression-from-stable-to-nightly,regression-from-stable-to-nightly",40188,2017-03-01T20:42:23Z,69,2,71
"A-docs;E-easy;E-mentor,A-docs;E-easy;E-mentor",40191,2017-03-01T22:14:09Z,8,0,8
NULL,40199,2017-03-01T23:47:19Z,207,11,218
NULL,40206,2017-03-02T10:29:44Z,55,23,78
NULL,40211,2017-03-02T16:46:01Z,0,0,0
"A-docs;B-RFC-approved;T-doc,A-docs;B-RFC-approved;T-doc",40213,2017-03-02T17:32:18Z,4,5316,5320
NULL,40215,2017-03-02T19:51:50Z,0,0,0
NULL,40216,2017-03-02T19:53:52Z,411,144,555
NULL,40218,2017-03-02T22:32:40Z,0,0,0
"A-docs;B-RFC-approved;T-doc,A-docs;B-RFC-approved;T-doc",40222,2017-03-03T02:08:39Z,4,5645,5649
"regression-from-stable-to-stable,regression-from-stable-to-stable",40224,2017-03-03T02:19:13Z,2433,2592,5025
"E-medium;E-mentor;I-enhancement;T-compiler,E-medium;E-mentor;I-enhancement;T-compiler",40229,2017-03-03T09:54:24Z,641,272,913
"A-rustbuild,A-rustbuild,A-rustbuild,A-rustbuild",40236,2017-03-03T15:27:27Z,179,154,333
NULL,40237,2017-03-03T15:29:17Z,74,24,98
NULL,40241,2017-03-03T17:34:31Z,37,1,38
NULL,40242,2017-03-03T17:42:02Z,18,0,18
NULL,40243,2017-03-03T17:47:45Z,0,0,0
NULL,40245,2017-03-03T20:53:44Z,4,4,8
NULL,40249,2017-03-03T23:41:20Z,0,0,0
NULL,40252,2017-03-04T02:55:31Z,14,1,15
NULL,40254,2017-03-04T09:12:46Z,5,4,9
"A-llvm;A-NVPTX,A-llvm;A-NVPTX",40257,2017-03-04T11:59:02Z,2,2,4
NULL,40265,2017-03-04T18:59:09Z,20,2,22
"I-cleanup,I-cleanup",40266,2017-03-04T19:39:58Z,6,8,14
NULL,40268,2017-03-05T00:05:04Z,54,85,139
NULL,40272,2017-03-05T08:21:24Z,45,21,66
"I-ICE,I-ICE,I-ICE,I-ICE",40276,2017-03-05T15:16:38Z,118,0,118
NULL,40279,2017-03-05T19:39:07Z,72,6,78
"B-RFC-approved;T-libs,B-RFC-approved;T-libs,B-RFC-approved;T-libs,B-RFC-approved;T-libs",40281,2017-03-05T21:26:05Z,28,13,41
NULL,40285,2017-03-06T00:20:04Z,39,1,40
NULL,40286,2017-03-06T01:08:19Z,0,0,0
NULL,40287,2017-03-06T03:05:59Z,61,28,89
NULL,40296,2017-03-06T15:41:13Z,130,0,130
NULL,40297,2017-03-06T15:47:47Z,30,677,707
NULL,40302,2017-03-06T17:42:24Z,0,0,0
NULL,40318,2017-03-07T13:41:46Z,0,0,0
NULL,40319,2017-03-07T14:34:59Z,249,130,379
NULL,40326,2017-03-07T18:08:25Z,1,1,2
NULL,40329,2017-03-07T20:28:04Z,26,18,44
"A-docs;B-RFC-approved;T-doc,A-docs;B-RFC-approved;T-doc",40332,2017-03-07T21:41:14Z,118,17522,17640
NULL,40333,2017-03-07T22:41:06Z,4,0,4
NULL,40335,2017-03-07T22:51:18Z,8,0,8
NULL,40336,2017-03-07T23:17:00Z,23,0,23
NULL,40339,2017-03-08T00:27:05Z,0,0,0
"B-RFC-approved;B-unstable;T-lang,B-RFC-approved;B-unstable;T-lang",40340,2017-03-08T01:12:46Z,57,54,111
NULL,40351,2017-03-08T06:33:51Z,0,0,0
NULL,40357,2017-03-08T13:44:02Z,0,0,0
NULL,40361,2017-03-08T16:19:34Z,0,0,0
"A-incr-comp;E-medium;E-mentor;T-compiler,A-incr-comp;E-medium;E-mentor;T-compiler",40362,2017-03-08T16:30:46Z,0,0,0
NULL,40368,2017-03-08T18:54:11Z,435,5780,6215
NULL,40369,2017-03-08T19:27:00Z,124,88,212
"I-crash;P-high;T-compiler;T-lang,I-crash;P-high;T-compiler;T-lang",40373,2017-03-08T20:22:26Z,43,2,45
NULL,40378,2017-03-09T02:49:23Z,0,0,0
A-spurious,40382,2017-03-09T03:49:45Z,87,22,109
NULL,40385,2017-03-09T11:30:03Z,57,4,61
NULL,40389,2017-03-09T14:33:38Z,184,26,210
NULL,40390,2017-03-09T14:38:17Z,183,5,188
NULL,40393,2017-03-09T15:56:12Z,0,0,0
NULL,40397,2017-03-09T18:05:36Z,0,0,0
NULL,40398,2017-03-09T19:50:26Z,53,20,73
"beta-nominated;needs-crater;T-compiler,beta-nominated,beta-nominated,beta-nominated,beta-nominated",40401,2017-03-09T21:44:19Z,418,68,486
NULL,40403,2017-03-09T23:11:48Z,0,0,0
NULL,40404,2017-03-09T23:54:45Z,51,8,59
NULL,40409,2017-03-10T04:42:20Z,183,7,190
"regression-from-stable-to-beta,beta-nominated;T-compiler,A-macros,A-macros;needs-crater",40411,2017-03-10T06:33:56Z,0,0,0
NULL,40412,2017-03-10T11:36:38Z,0,0,0
"A-diagnostics,A-diagnostics",40413,2017-03-10T11:54:21Z,0,0,0
NULL,40414,2017-03-10T12:09:45Z,0,0,0
NULL,40415,2017-03-10T13:14:34Z,0,0,0
needs-crater,40418,2017-03-10T15:10:53Z,0,0,0
"A-rustdoc,A-rustdoc",40419,2017-03-10T15:21:46Z,47,19,66
needs-crater,40420,2017-03-10T16:32:20Z,0,0,0
NULL,40422,2017-03-10T17:14:41Z,52,1,53
needs-crater,40427,2017-03-10T20:53:29Z,0,0,0
needs-crater,40428,2017-03-10T21:08:36Z,0,0,0
needs-crater,40429,2017-03-10T21:09:06Z,0,0,0
NULL,40431,2017-03-10T22:50:17Z,1,1,2
"needs-crater,needs-crater",40432,2017-03-10T22:51:51Z,968,898,1866
NULL,40433,2017-03-10T23:30:05Z,29,0,29
"B-RFC-approved;T-libs,B-RFC-approved;T-libs",40434,2017-03-11T02:14:41Z,449,8,457
NULL,40436,2017-03-11T08:43:06Z,0,0,0
needs-crater,40440,2017-03-11T15:13:54Z,0,0,0
"B-RFC-approved;B-unstable;T-lang,B-RFC-approved;B-unstable;T-lang",40441,2017-03-11T15:56:26Z,61,3,64
NULL,40445,2017-03-11T19:15:59Z,37,1,38
"needs-crater,needs-crater",40446,2017-03-11T19:57:51Z,527,232,759
NULL,40448,2017-03-12T03:00:08Z,23,15,38
NULL,40453,2017-03-12T10:12:53Z,1,1,2
NULL,40455,2017-03-12T16:48:51Z,356,135,491
NULL,40466,2017-03-13T04:23:41Z,2,19,21
NULL,40479,2017-03-13T17:50:05Z,7,2,9
NULL,40482,2017-03-13T18:37:40Z,19,0,19
NULL,40489,2017-03-13T19:51:49Z,0,0,0
NULL,40492,2017-03-13T21:54:15Z,0,0,0
"A-docs,A-docs",40496,2017-03-13T23:14:47Z,3,3,6
"A-rustdoc,A-rustdoc",40497,2017-03-14T00:37:44Z,1,1,2
NULL,40500,2017-03-14T02:19:48Z,61,1,62
NULL,40505,2017-03-14T04:45:18Z,31,13,44
NULL,40506,2017-03-14T04:57:58Z,0,0,0
NULL,40513,2017-03-14T13:06:58Z,0,0,0
NULL,40514,2017-03-14T13:12:53Z,2,0,2
NULL,40515,2017-03-14T14:41:10Z,16,8,24
"A-libs;A-windows,A-libs;A-windows",40516,2017-03-14T14:56:24Z,110,55,165
A-incr-comp;T-compiler,40518,2017-03-14T15:36:28Z,1541,859,2400
NULL,40521,2017-03-14T17:44:03Z,127,28,155
NULL,40523,2017-03-14T18:39:43Z,18,0,18
"beta-nominated,beta-nominated,beta-nominated,beta-nominated,beta-nominated,beta-nominated",40525,2017-03-14T19:30:06Z,0,0,0
NULL,40530,2017-03-14T22:32:36Z,0,0,0
"A-macros,A-macros",40532,2017-03-14T22:35:56Z,77,59,136
NULL,40542,2017-03-15T08:33:55Z,51,1,52
NULL,40544,2017-03-15T13:08:27Z,0,0,0
"A-spurious,A-spurious",40545,2017-03-15T14:15:24Z,18,3,21
A-spurious,40548,2017-03-15T14:37:54Z,15,8,23
NULL,40550,2017-03-15T15:29:35Z,0,0,0
NULL,40554,2017-03-15T19:35:36Z,558,813,1371
"B-RFC-approved;B-unstable;T-lang,B-RFC-approved;B-unstable;T-lang",40556,2017-03-15T20:49:22Z,78,107,185
NULL,40564,2017-03-16T01:15:52Z,28,4,32
"A-diagnostics,A-diagnostics,A-diagnostics;A-docs;I-enhancement;T-compiler;T-tools,A-diagnostics,A-diagnostics,A-diagnostics;A-docs;I-enhancement;T-compiler;T-tools",40565,2017-03-16T02:23:16Z,164,17,181
NULL,40567,2017-03-16T04:14:39Z,49,1,50
"A-traits;I-ICE;I-nominated,A-traits;I-ICE;I-nominated",40570,2017-03-16T13:58:44Z,732,910,1642
"A-spurious,A-spurious",40575,2017-03-16T14:56:28Z,66,54,120
NULL,40581,2017-03-16T20:15:07Z,11,15,26
NULL,40583,2017-03-16T20:48:00Z,33,1,34
"B-RFC-approved;T-libs,B-RFC-approved;T-libs",40586,2017-03-16T21:47:59Z,10,0,10
NULL,40587,2017-03-16T22:00:46Z,37,6,43
NULL,40588,2017-03-16T23:12:24Z,20,0,20
NULL,40589,2017-03-17T00:52:50Z,17,1,18
NULL,40590,2017-03-17T01:00:28Z,2,0,2
"beta-nominated,beta-accepted;beta-nominated,beta-nominated",40591,2017-03-17T01:20:35Z,0,0,0
"beta-nominated,beta-accepted;beta-nominated,beta-nominated,beta-nominated,beta-accepted;beta-nominated,beta-nominated",40592,2017-03-17T01:23:48Z,0,0,0
"beta-nominated,beta-accepted;beta-nominated,beta-nominated",40595,2017-03-17T04:20:17Z,0,0,0
beta-accepted;beta-nominated,40596,2017-03-17T05:19:16Z,0,0,0
"A-macros;A-parser,A-diagnostics",40597,2017-03-17T09:41:24Z,932,1408,2340
NULL,40598,2017-03-17T12:49:11Z,1008,705,1713
"beta-accepted;beta-nominated,beta-nominated,beta-nominated",40600,2017-03-17T14:47:07Z,141,159,300
"B-RFC-approved;T-libs,B-RFC-approved;T-libs",40601,2017-03-17T15:02:48Z,1069,113,1182
NULL,40603,2017-03-17T15:53:49Z,4,4,8
"A-infrastructure,A-infrastructure",40605,2017-03-17T16:34:36Z,14,9,23
NULL,40608,2017-03-17T17:32:52Z,7,7,14
"beta-accepted;beta-nominated,beta-nominated;T-compiler,beta-nominated,beta-nominated,beta-nominated;needs-crater;T-compiler",40615,2017-03-17T21:02:35Z,0,0,0
"beta-nominated,beta-nominated;needs-crater;T-compiler,beta-accepted;beta-nominated,beta-nominated;T-compiler,beta-nominated",40616,2017-03-17T21:06:58Z,0,0,0
"beta-accepted;beta-nominated,beta-nominated,beta-nominated,beta-nominated,beta-accepted;beta-nominated,beta-nominated",40618,2017-03-17T21:58:11Z,0,0,0
B-RFC-approved;T-libs,40619,2017-03-17T22:30:10Z,31,0,31
NULL,40620,2017-03-17T23:15:08Z,41,6,47
beta-accepted;beta-nominated,40626,2017-03-18T04:20:28Z,0,0,0
"B-RFC-approved;B-unstable;T-lang,B-RFC-approved;B-unstable;T-lang",40627,2017-03-18T04:26:33Z,205,35,240
beta-accepted;beta-nominated,40629,2017-03-18T05:49:13Z,0,0,0
beta-accepted;beta-nominated,40633,2017-03-18T13:52:01Z,0,0,0
NULL,40634,2017-03-18T14:34:25Z,9,0,9
beta-accepted;beta-nominated,40635,2017-03-18T15:51:48Z,0,0,0
NULL,40636,2017-03-18T16:29:55Z,57,11,68
"beta-nominated;T-compiler,beta-accepted;beta-nominated,beta-nominated;needs-crater;T-compiler",40643,2017-03-18T23:01:06Z,0,0,0
"beta-accepted;beta-nominated,beta-nominated;needs-crater;T-compiler,beta-nominated;T-compiler",40644,2017-03-18T23:34:33Z,0,0,0
"beta-nominated;T-compiler,beta-accepted;beta-nominated,beta-nominated;T-compiler,beta-accepted;beta-nominated",40645,2017-03-19T00:15:38Z,0,0,0
NULL,40647,2017-03-19T04:10:07Z,0,0,0
beta-nominated;T-compiler,40651,2017-03-19T14:18:24Z,216,28,244
NULL,40656,2017-03-19T21:27:48Z,0,0,0
NULL,40658,2017-03-19T23:44:11Z,1442,1819,3261
"beta-nominated;needs-crater;T-compiler,beta-nominated;needs-crater;T-compiler",40659,2017-03-20T00:51:14Z,934,955,1889
NULL,40664,2017-03-20T05:38:42Z,29,4,33
"A-incr-comp,A-incr-comp",40668,2017-03-20T09:43:16Z,44,49,93
NULL,40669,2017-03-20T13:08:47Z,0,0,0
"beta-nominated;T-compiler,beta-nominated;needs-crater;T-compiler",40675,2017-03-20T14:54:36Z,138,23,161
"A-docs,A-docs",40682,2017-03-20T19:25:01Z,20,1,21
NULL,40684,2017-03-20T21:14:56Z,22,81,103
NULL,40686,2017-03-20T21:31:38Z,12,14,26
NULL,40688,2017-03-20T21:41:34Z,0,0,0
NULL,40689,2017-03-20T21:43:07Z,33,5,38
NULL,40693,2017-03-21T03:45:06Z,874,17908,18782
"A-mir;I-cleanup;I-needs-decision;T-compiler,A-mir;I-cleanup;I-needs-decision;T-compiler",40700,2017-03-21T12:58:20Z,0,0,0
NULL,40701,2017-03-21T14:10:30Z,0,0,0
NULL,40702,2017-03-21T15:11:03Z,648,24,672
NULL,40706,2017-03-21T16:49:07Z,31,12,43
A-docs;E-easy,40723,2017-03-22T01:18:48Z,22,1,23
NULL,40726,2017-03-22T03:57:42Z,0,0,0
NULL,40728,2017-03-22T07:20:34Z,2,10,12
NULL,40734,2017-03-22T12:48:56Z,34,4,38
NULL,40735,2017-03-22T15:06:56Z,0,0,0
NULL,40737,2017-03-22T16:41:51Z,448,63,511
NULL,40747,2017-03-22T22:18:20Z,0,0,0
NULL,40748,2017-03-22T23:30:36Z,232,113,345
NULL,40752,2017-03-23T03:38:04Z,1711,931,2642
NULL,40753,2017-03-23T05:02:24Z,2,2,4
NULL,40758,2017-03-23T13:42:50Z,337,198,535
NULL,40759,2017-03-23T14:08:30Z,2,0,2
"A-diagnostics,A-diagnostics,A-diagnostics",40763,2017-03-23T17:23:00Z,12,0,12
NULL,40764,2017-03-23T17:29:32Z,52,59,111
NULL,40767,2017-03-23T18:28:24Z,0,0,0
NULL,40771,2017-03-23T19:30:15Z,108,85,193
NULL,40775,2017-03-23T22:17:50Z,99,0,99
A-spurious,40777,2017-03-23T23:09:41Z,33,29,62
NULL,40779,2017-03-23T23:27:40Z,40,2,42
"A-infrastructure;E-help-wanted,A-infrastructure;E-help-wanted",40780,2017-03-24T00:03:51Z,97,10,107
beta-nominated,40785,2017-03-24T03:06:49Z,0,0,0
NULL,40786,2017-03-24T03:27:18Z,876,22,898
"A-borrow-checker;A-docs,A-borrow-checker;A-docs",40797,2017-03-24T16:48:16Z,3,3,6
NULL,40805,2017-03-24T22:56:21Z,89,100,189
beta-nominated,40806,2017-03-24T23:13:17Z,188,122,310
"beta-accepted;beta-nominated,beta-accepted;beta-nominated",40810,2017-03-25T02:07:55Z,0,0,0
NULL,40811,2017-03-25T02:22:23Z,128,20,148
"A-docs,A-docs",40812,2017-03-25T03:31:35Z,9,11,20
NULL,40813,2017-03-25T04:06:26Z,20,1,21
NULL,40814,2017-03-25T05:06:04Z,81,2,83
NULL,40815,2017-03-25T06:08:19Z,95,15,110
"A-diagnostics,A-diagnostics",40816,2017-03-25T06:46:56Z,186,30,216
"A-docs,A-docs",40818,2017-03-25T09:08:27Z,22,22,44
"A-docs,A-docs",40819,2017-03-25T10:28:03Z,3,1,4
"A-docs,A-docs",40824,2017-03-25T16:01:15Z,33,0,33
I-nominated;T-lang,40825,2017-03-25T16:25:29Z,0,0,0
"I-nominated;T-lang,I-nominated;T-lang",40826,2017-03-25T16:30:35Z,258,147,405
"A-docs,A-docs",40829,2017-03-25T21:24:23Z,3,2,5
NULL,40832,2017-03-25T22:54:02Z,34,24,58
NULL,40836,2017-03-26T11:21:01Z,69,36,105
"A-docs;E-easy;E-help-wanted;E-mentor;T-doc,A-docs;E-easy;E-help-wanted;E-mentor;T-doc",40837,2017-03-26T12:07:24Z,15,9,24
"A-docs,A-docs",40838,2017-03-26T15:51:01Z,476,140,616
NULL,40840,2017-03-26T16:41:51Z,0,0,0
NULL,40841,2017-03-26T17:00:18Z,427,225,652
NULL,40847,2017-03-27T00:53:08Z,1574,479,2053
"regression-from-stable-to-beta,regression-from-stable-to-beta",40849,2017-03-27T05:27:16Z,22,3,25
"I-ICE;regression-from-stable-to-stable,I-ICE;regression-from-stable-to-stable",40863,2017-03-27T19:17:50Z,43,11,54
"A-spurious,A-spurious,A-spurious,A-spurious",40865,2017-03-27T20:10:36Z,6,22,28
"beta-nominated;T-compiler,beta-nominated;T-compiler,beta-nominated;T-compiler,beta-nominated;T-compiler",40867,2017-03-27T20:24:40Z,974,592,1566
"A-docs,A-docs",40869,2017-03-27T20:50:59Z,19,0,19
"B-RFC-approved;T-tools,B-RFC-approved;T-tools",40870,2017-03-27T21:16:35Z,3,39,42
NULL,40873,2017-03-28T07:00:03Z,27,3,30
beta-accepted;beta-nominated;T-compiler,40884,2017-03-29T00:11:17Z,0,0,0
NULL,40886,2017-03-29T01:35:08Z,0,0,0
NULL,40887,2017-03-29T02:03:23Z,113,5,118
"A-rustdoc;regression-from-stable-to-beta,A-rustdoc;regression-from-stable-to-beta",40888,2017-03-29T02:46:48Z,9,5,14
NULL,40889,2017-03-29T03:19:26Z,544,148,692
T-libs,40899,2017-03-29T12:57:09Z,1368,256,1624
"A-docs,A-docs",40904,2017-03-29T14:05:46Z,14,0,14
A-docs,40907,2017-03-29T17:23:46Z,3,1,4
NULL,40911,2017-03-29T20:53:34Z,371,45,416
NULL,40914,2017-03-29T22:29:50Z,0,0,0
NULL,40917,2017-03-30T00:34:44Z,1,3,4
"A-rustdoc;P-high;regression-from-stable-to-nightly;T-doc,A-rustdoc;P-high;regression-from-stable-to-nightly;T-doc",40919,2017-03-30T01:49:44Z,232,32,264
NULL,40927,2017-03-30T14:12:10Z,29,10,39
"T-libs,T-libs",40929,2017-03-30T15:30:34Z,9,0,9
NULL,40930,2017-03-30T16:48:13Z,0,0,0
NULL,40932,2017-03-30T17:17:53Z,0,0,0
"A-docs;metabug,A-docs,A-docs;metabug,A-docs",40934,2017-03-30T18:28:42Z,16,38,54
"A-docs,A-docs",40935,2017-03-30T20:39:58Z,38,9,47
NULL,40939,2017-03-31T05:09:57Z,1562,842,2404
NULL,40948,2017-03-31T15:06:24Z,0,0,0
NULL,40950,2017-03-31T15:43:40Z,330,129,459
relnotes,40969,2017-03-31T19:47:17Z,0,0,0
"relnotes,relnotes",40972,2017-03-31T20:48:30Z,137,41,178
"regression-from-stable-to-beta,regression-from-stable-to-beta",40975,2017-03-31T23:00:35Z,57,11,68
NULL,40976,2017-03-31T23:20:50Z,15,0,15
"A-docs,A-docs",40981,2017-04-01T00:23:25Z,172,46,218
NULL,40984,2017-04-01T03:09:50Z,0,0,0
NULL,40986,2017-04-01T04:41:37Z,0,0,0
"A-docs,A-docs,A-docs,A-docs",40987,2017-04-01T06:11:48Z,133,50,183
"A-docs,A-docs",40988,2017-04-01T07:50:06Z,58,8,66
"A-docs,A-docs",40992,2017-04-01T12:01:49Z,8,3,11
"beta-accepted;beta-nominated;T-compiler,beta-accepted;beta-nominated",40995,2017-04-01T13:44:18Z,139,54,193
"regression-from-stable-to-beta,regression-from-stable-to-beta",40996,2017-04-01T13:59:25Z,1,1,2
"A-docs,A-docs",40997,2017-04-01T13:59:54Z,15,8,23
"A-infrastructure,A-infrastructure",40998,2017-04-01T14:22:18Z,996,66,1062
"A-docs,A-docs",40999,2017-04-01T16:53:06Z,21,3,24
NULL,41002,2017-04-01T19:25:39Z,0,0,0
NULL,41008,2017-04-02T03:22:19Z,13,24,37
NULL,41010,2017-04-02T05:16:11Z,0,0,0
"A-spurious,A-rustbuild,A-spurious,A-rustbuild",41011,2017-04-02T05:19:33Z,165,139,304
NULL,41015,2017-04-02T13:24:59Z,3,0,3
"beta-accepted;beta-nominated,beta-nominated,beta-nominated,beta-accepted;beta-nominated",41016,2017-04-02T13:29:38Z,85,89,174
NULL,41017,2017-04-02T14:07:00Z,0,0,0
NULL,41018,2017-04-02T14:10:57Z,0,0,0
NULL,41024,2017-04-02T21:08:26Z,0,0,0
NULL,41026,2017-04-02T22:28:11Z,22,20,42
NULL,41034,2017-04-03T12:59:12Z,0,0,0
NULL,41035,2017-04-03T14:18:25Z,0,15,15
NULL,41037,2017-04-03T14:56:33Z,10,10,20
NULL,41039,2017-04-03T18:45:41Z,9,13,22
NULL,41040,2017-04-03T18:47:26Z,0,0,0
NULL,41041,2017-04-03T18:49:35Z,0,0,0
NULL,41047,2017-04-03T22:08:21Z,27,24,51
"A-rustdoc;P-high;regression-from-stable-to-nightly;T-doc,A-rustdoc;P-high;regression-from-stable-to-nightly;T-doc",41049,2017-04-03T22:25:22Z,0,0,0
NULL,41050,2017-04-03T23:03:23Z,46,3,49
NULL,41051,2017-04-03T23:32:19Z,91,89,180
"relnotes,relnotes",41052,2017-04-04T01:53:26Z,53,11,64
NULL,41055,2017-04-04T06:24:36Z,33,12,45
NULL,41056,2017-04-04T09:24:45Z,161,131,292
NULL,41059,2017-04-04T13:41:19Z,1009,67,1076
NULL,41061,2017-04-04T15:13:06Z,55,6,61
"I-papercut,I-papercut",41062,2017-04-04T16:00:01Z,52,11,63
NULL,41063,2017-04-04T16:22:50Z,42,34,76
"A-rustdoc;P-high;regression-from-stable-to-nightly;T-doc,A-rustdoc;P-high;regression-from-stable-to-nightly;T-doc",41066,2017-04-04T19:40:45Z,60,40,100
NULL,41067,2017-04-04T20:09:36Z,0,0,0
NULL,41068,2017-04-04T20:19:35Z,0,0,0
NULL,41070,2017-04-04T20:22:46Z,0,0,0
"beta-nominated;T-compiler,beta-nominated;T-compiler,beta-nominated,beta-nominated;T-compiler,beta-nominated;T-compiler,beta-nominated",41071,2017-04-04T21:15:57Z,100,59,159
"A-spurious,A-spurious",41076,2017-04-04T22:56:30Z,37,37,74
NULL,41077,2017-04-04T23:43:28Z,139,39,178
NULL,41080,2017-04-05T07:40:24Z,5,10,15
NULL,41084,2017-04-05T15:33:23Z,137,133,270
NULL,41085,2017-04-05T16:02:55Z,21,4,25
NULL,41086,2017-04-05T16:44:41Z,522,245,767
NULL,41087,2017-04-05T16:53:11Z,15,6,21
"A-spurious,A-spurious",41089,2017-04-05T17:40:02Z,7,4,11
"A-docs,A-docs",41090,2017-04-05T18:41:51Z,21,0,21
NULL,41092,2017-04-05T19:35:35Z,148,0,148
NULL,41093,2017-04-05T19:49:53Z,0,0,0
beta-nominated,41094,2017-04-05T20:26:13Z,0,0,0
NULL,41096,2017-04-05T21:28:15Z,57,14,71
beta-nominated,41098,2017-04-05T23:01:14Z,1275,1087,2362
NULL,41100,2017-04-06T03:22:29Z,0,0,0
NULL,41101,2017-04-06T03:25:22Z,0,0,0
NULL,41102,2017-04-06T03:51:44Z,285,173,458
NULL,41108,2017-04-06T10:22:49Z,24,8,32
A-rustdoc;P-high;regression-from-stable-to-nightly;T-doc,41111,2017-04-06T12:51:55Z,44,26,70
A-rustdoc;P-high;regression-from-stable-to-nightly;T-doc,41112,2017-04-06T12:53:16Z,296,483,779
NULL,41113,2017-04-06T13:02:52Z,0,0,0
NULL,41115,2017-04-06T13:54:11Z,0,0,0
NULL,41116,2017-04-06T16:06:52Z,0,0,0
NULL,41121,2017-04-06T18:55:10Z,3488,1745,5233
"A-docs,A-docs",41122,2017-04-06T20:37:49Z,6,2,8
"A-docs,A-docs",41125,2017-04-06T22:55:29Z,164,33,197
NULL,41129,2017-04-07T01:34:26Z,0,0,0
"E-needstest,E-needstest",41133,2017-04-07T03:26:37Z,0,0,0
NULL,41134,2017-04-07T04:57:53Z,0,0,0
NULL,41138,2017-04-07T13:20:12Z,347,196,543
NULL,41143,2017-04-07T15:35:37Z,23,11,34
"B-RFC-approved;B-unstable;T-lang,B-RFC-approved;B-unstable;T-lang",41145,2017-04-07T16:04:43Z,3,60,63
"I-nominated;regression-from-stable-to-beta,I-nominated;regression-from-stable-to-beta",41148,2017-04-07T21:22:15Z,174,38,212
NULL,41150,2017-04-07T22:39:30Z,0,0,0
NULL,41153,2017-04-08T00:28:45Z,72,15,87
NULL,41156,2017-04-08T06:55:11Z,149,18,167
"regression-from-stable-to-nightly,regression-from-stable-to-nightly",41166,2017-04-08T20:11:08Z,1,1,2
NULL,41168,2017-04-08T20:47:51Z,6,6,12
NULL,41171,2017-04-09T11:50:11Z,0,0,0
NULL,41172,2017-04-09T16:10:47Z,39,0,39
NULL,41173,2017-04-09T16:33:03Z,17,9,26
NULL,41174,2017-04-09T23:31:48Z,28,3,31
A-docs,41179,2017-04-10T04:12:18Z,24,1,25
NULL,41181,2017-04-10T04:41:22Z,0,0,0
NULL,41188,2017-04-10T15:21:19Z,0,0,0
"B-RFC-approved;T-libs,B-RFC-approved;T-libs,B-RFC-approved;T-libs",41192,2017-04-10T17:07:44Z,128,26,154
"A-diagnostics,A-diagnostics",41205,2017-04-10T21:51:38Z,485,32,517
NULL,41206,2017-04-10T22:05:18Z,40,9,49
NULL,41207,2017-04-10T22:29:04Z,65,0,65
NULL,41214,2017-04-11T11:43:22Z,80,18,98
"A-docs,A-docs",41217,2017-04-11T13:45:16Z,52,3,55
NULL,41226,2017-04-11T18:29:55Z,0,0,0
"A-rustbuild,A-rustbuild",41227,2017-04-11T19:00:18Z,167,42,209
NULL,41233,2017-04-11T21:23:15Z,1,1,2
NULL,41236,2017-04-11T22:02:39Z,235,298,533
NULL,41237,2017-04-11T22:36:18Z,401,133,534
A-incr-comp,41238,2017-04-11T23:40:59Z,0,0,0
NULL,41241,2017-04-12T04:02:44Z,0,0,0
NULL,41242,2017-04-12T04:06:06Z,0,0,0
NULL,41245,2017-04-12T09:19:22Z,200,179,379
NULL,41246,2017-04-12T12:45:49Z,2049,724,2773
NULL,41249,2017-04-12T16:15:56Z,101,42,143
NULL,41250,2017-04-12T16:19:33Z,51,1,52
A-diagnostics;E-easy,41256,2017-04-12T19:03:22Z,0,0,0
NULL,41258,2017-04-12T21:13:09Z,60,8,68
NULL,41262,2017-04-12T23:09:26Z,17,17,34
NULL,41264,2017-04-13T00:48:18Z,11,4,15
NULL,41265,2017-04-13T00:49:24Z,0,0,0
NULL,41266,2017-04-13T02:19:51Z,33,33,66
NULL,41268,2017-04-13T10:11:43Z,80,29,109
regression-from-stable-to-beta,41269,2017-04-13T11:44:30Z,0,0,0
NULL,41275,2017-04-13T17:01:39Z,0,0,0
NULL,41276,2017-04-13T17:03:24Z,0,0,0
NULL,41277,2017-04-13T17:04:17Z,117,67,184
NULL,41279,2017-04-13T18:30:48Z,92,47,139
NULL,41280,2017-04-13T19:18:42Z,225,4,229
NULL,41282,2017-04-13T20:02:30Z,191,81,272
NULL,41283,2017-04-13T20:44:32Z,2,2,4
NULL,41292,2017-04-14T01:02:44Z,7,5,12
NULL,41293,2017-04-14T01:11:36Z,137,0,137
NULL,41294,2017-04-14T02:01:29Z,334,401,735
"T-doc,T-doc",41295,2017-04-14T02:57:14Z,310,303,613
NULL,41303,2017-04-14T17:17:16Z,1,1,2
NULL,41305,2017-04-14T21:41:07Z,789,67,856
NULL,41307,2017-04-14T23:23:17Z,457,246,703
NULL,41308,2017-04-15T00:36:53Z,2,2,4
NULL,41309,2017-04-15T00:39:30Z,203,22,225
NULL,41312,2017-04-15T02:05:42Z,367,55,422
NULL,41316,2017-04-15T09:19:15Z,38,87,125
NULL,41320,2017-04-15T13:25:06Z,0,31,31
NULL,41321,2017-04-15T14:41:52Z,45,36,81
NULL,41325,2017-04-15T21:14:22Z,190,206,396
"A-incr-comp;T-compiler,A-incr-comp;T-compiler",41327,2017-04-15T23:22:07Z,0,0,0
NULL,41330,2017-04-16T14:03:40Z,0,0,0
"I-nominated;T-lang,I-nominated;T-lang",41332,2017-04-16T18:26:47Z,227,248,475
NULL,41339,2017-04-17T13:11:02Z,0,0,0
NULL,41342,2017-04-17T16:18:22Z,26,14,40
S-waiting-on-author,41345,2017-04-17T17:26:22Z,742,43,785
"A-docs,A-docs",41348,2017-04-17T21:27:51Z,257,120,377
"T-libs,T-libs",41350,2017-04-17T22:15:34Z,0,0,0
NULL,41357,2017-04-18T03:21:20Z,452,469,921
NULL,41360,2017-04-18T11:09:15Z,22,156,178
NULL,41363,2017-04-18T13:22:18Z,0,0,0
NULL,41364,2017-04-18T13:51:21Z,4,80,84
"beta-accepted;beta-nominated,beta-accepted;beta-nominated",41369,2017-04-18T15:59:10Z,1,1,2
NULL,41371,2017-04-18T17:54:59Z,0,0,0
NULL,41373,2017-04-18T18:05:47Z,151,296,447
NULL,41378,2017-04-18T21:07:54Z,26,3,29
S-waiting-on-review,41379,2017-04-18T21:26:04Z,0,0,0
S-waiting-on-review,41381,2017-04-18T23:19:14Z,0,0,0
S-waiting-on-review,41382,2017-04-18T23:20:41Z,0,0,0
S-waiting-on-review,41383,2017-04-18T23:52:18Z,0,0,0
"S-waiting-on-review,S-waiting-on-review",41385,2017-04-19T01:26:56Z,0,0,0
NULL,41387,2017-04-19T04:35:12Z,0,0,0
NULL,41390,2017-04-19T05:38:37Z,30,1,31
NULL,41395,2017-04-19T13:20:33Z,0,0,0
NULL,41397,2017-04-19T15:16:47Z,64,12,76
NULL,41400,2017-04-19T17:12:34Z,0,0,0
NULL,41405,2017-04-19T22:32:05Z,37,9,46
NULL,41406,2017-04-19T22:55:20Z,65,13,78
NULL,41408,2017-04-19T23:06:47Z,331,219,550
NULL,41409,2017-04-19T23:42:36Z,0,0,0
NULL,41411,2017-04-20T01:55:42Z,590,446,1036
NULL,41412,2017-04-20T04:39:30Z,0,0,0
NULL,41413,2017-04-20T05:39:57Z,197,49,246
NULL,41418,2017-04-20T13:16:33Z,143,1,144
"A-debuginfo;I-enhancement;T-tools,A-debuginfo;I-enhancement;T-tools,relnotes;T-tools,A-debuginfo;I-enhancement;T-tools,A-debuginfo;I-enhancement;T-tools,relnotes;T-tools",41419,2017-04-20T14:54:06Z,0,0,0
"A-spurious,A-spurious",41420,2017-04-20T15:38:21Z,24,4,28
NULL,41421,2017-04-20T16:36:10Z,0,0,0
NULL,41424,2017-04-20T17:33:14Z,142,61,203
"beta-nominated,beta-nominated",41427,2017-04-20T20:22:05Z,96,22,118
NULL,41428,2017-04-20T20:52:38Z,0,0,0
NULL,41432,2017-04-20T23:14:33Z,57,2,59
NULL,41433,2017-04-21T00:01:12Z,5,2,7
NULL,41434,2017-04-21T00:02:32Z,0,0,0
NULL,41435,2017-04-21T00:08:18Z,39,0,39
NULL,41436,2017-04-21T00:34:33Z,0,0,0
"B-unstable;I-nominated;T-libs,B-unstable;I-nominated;T-libs",41439,2017-04-21T06:29:44Z,106,3,109
NULL,41440,2017-04-21T08:16:52Z,0,0,0
NULL,41441,2017-04-21T08:37:33Z,0,0,0
"A-docs,A-docs",41442,2017-04-21T08:39:30Z,16,6,22
NULL,41445,2017-04-21T12:40:37Z,139,8,147
NULL,41449,2017-04-21T17:40:06Z,18,0,18
NULL,41451,2017-04-21T19:42:31Z,0,0,0
NULL,41454,2017-04-22T02:24:10Z,0,0,0
NULL,41455,2017-04-22T02:38:53Z,0,0,0
NULL,41458,2017-04-22T03:13:29Z,0,0,0
NULL,41459,2017-04-22T03:29:16Z,227,38,265
NULL,41462,2017-04-22T06:40:43Z,0,0,0
NULL,41463,2017-04-22T08:15:54Z,151,0,151
NULL,41464,2017-04-22T13:02:59Z,579,415,994
NULL,41476,2017-04-23T06:25:38Z,231,0,231
"A-diagnostics,A-diagnostics",41488,2017-04-23T22:39:41Z,399,24,423
"A-associated-items;A-traits;A-typesystem,A-associated-items;A-traits;A-typesystem",41494,2017-04-24T05:07:23Z,37,0,37
NULL,41499,2017-04-24T11:21:23Z,7,0,7
NULL,41500,2017-04-24T11:47:26Z,2,1,3
NULL,41501,2017-04-24T14:28:51Z,72,13,85
NULL,41503,2017-04-24T14:48:44Z,0,0,0
NULL,41506,2017-04-24T16:33:25Z,0,0,0
NULL,41508,2017-04-24T17:15:52Z,547,313,860
"A-incr-comp,A-incr-comp",41510,2017-04-24T18:15:23Z,0,0,0
NULL,41513,2017-04-24T19:23:58Z,0,0,0
NULL,41516,2017-04-24T22:25:13Z,0,0,0
NULL,41518,2017-04-24T23:04:29Z,1,1,2
"A-macros;E-easy,A-macros;E-easy",41520,2017-04-24T23:46:30Z,38,16,54
NULL,41522,2017-04-25T01:22:45Z,0,0,0
"A-diagnostics;I-papercut,A-diagnostics;I-papercut",41523,2017-04-25T03:33:27Z,63,20,83
"A-docs,A-docs",41526,2017-04-25T08:10:42Z,8,9,17
"T-doc,T-doc",41527,2017-04-25T09:36:51Z,9,4,13
NULL,41528,2017-04-25T09:38:56Z,3,2,5
NULL,41530,2017-04-25T10:35:18Z,12,0,12
NULL,41531,2017-04-25T10:40:11Z,35,1,36
NULL,41533,2017-04-25T11:42:27Z,0,0,0
"A-incr-comp,A-incr-comp",41534,2017-04-25T13:31:50Z,20,13,33
NULL,41535,2017-04-25T14:42:43Z,3,1,4
"S-waiting-on-review,S-waiting-on-review",41539,2017-04-25T17:35:38Z,0,0,0
"needs-crater,needs-crater",41542,2017-04-25T21:09:00Z,78,2,80
"A-docs,A-docs",41543,2017-04-25T22:24:53Z,22,11,33
NULL,41547,2017-04-26T00:19:37Z,62,12,74
NULL,41550,2017-04-26T02:58:51Z,18,0,18
NULL,41551,2017-04-26T03:06:02Z,221,16,237
S-waiting-on-review,41554,2017-04-26T13:00:20Z,0,0,0
S-waiting-on-review,41558,2017-04-26T15:26:49Z,0,0,0
NULL,41559,2017-04-26T16:42:53Z,72,57,129
A-spurious,41563,2017-04-26T20:40:13Z,1,1,2
A-diagnostics;T-compiler,41564,2017-04-26T21:09:32Z,146,19,165
NULL,41565,2017-04-26T21:35:54Z,425,327,752
S-waiting-on-review,41566,2017-04-26T22:08:21Z,0,0,0
S-waiting-on-review,41567,2017-04-26T22:11:11Z,340,90,430
NULL,41571,2017-04-27T01:37:41Z,2,1,3
NULL,41572,2017-04-27T02:06:29Z,19,8,27
NULL,41573,2017-04-27T02:53:18Z,0,0,0
NULL,41578,2017-04-27T13:47:35Z,49,2,51
beta-nominated,41579,2017-04-27T14:54:46Z,0,0,0
NULL,41582,2017-04-27T17:03:44Z,23,4,27
NULL,41583,2017-04-27T17:07:46Z,47,7,54
beta-nominated,41585,2017-04-27T18:58:26Z,0,0,0
NULL,41588,2017-04-27T19:52:16Z,17,77,94
"I-wrong;T-libs,I-wrong;T-libs",41590,2017-04-27T21:57:43Z,0,0,0
"beta-nominated,beta-nominated",41591,2017-04-27T23:59:19Z,395,70,465
"A-incr-comp,A-incr-comp",41593,2017-04-28T02:50:51Z,24,23,47
NULL,41594,2017-04-28T03:20:32Z,0,0,0
NULL,41595,2017-04-28T03:42:40Z,0,0,0
NULL,41596,2017-04-28T03:44:05Z,0,0,0
NULL,41598,2017-04-28T04:29:38Z,69,21,90
NULL,41600,2017-04-28T07:02:04Z,43,24,67
"A-traits,A-traits",41605,2017-04-28T13:35:46Z,59,18,77
NULL,41608,2017-04-28T16:07:13Z,28,0,28
"A-incr-comp,A-incr-comp",41611,2017-04-28T18:06:31Z,56,58,114
"A-docs,A-docs",41612,2017-04-28T18:20:44Z,36,0,36
NULL,41614,2017-04-28T21:44:18Z,0,0,0
NULL,41618,2017-04-29T03:02:37Z,0,0,0
A-spurious,41623,2017-04-29T07:31:38Z,37,37,74
NULL,41624,2017-04-29T07:49:41Z,25,5,30
NULL,41627,2017-04-29T11:57:07Z,0,0,0
NULL,41629,2017-04-29T12:26:07Z,5,7,12
NULL,41632,2017-04-29T14:35:04Z,20,0,20
NULL,41634,2017-04-29T17:54:32Z,0,0,0
NULL,41637,2017-04-29T20:18:58Z,23,0,23
NULL,41639,2017-04-29T23:18:18Z,1168,209,1377
"A-diagnostics;T-compiler,A-diagnostics;T-compiler",41640,2017-04-29T23:34:06Z,12,2,14
NULL,41641,2017-04-29T23:59:37Z,0,0,0
NULL,41643,2017-04-30T03:44:32Z,430,531,961
beta-nominated,41651,2017-04-30T12:57:55Z,204,230,434
"A-incr-comp,A-incr-comp",41653,2017-04-30T15:08:15Z,24,18,42
NULL,41656,2017-04-30T18:10:56Z,2,1,3
NULL,41659,2017-04-30T19:21:10Z,44,12,56
NULL,41666,2017-05-01T01:54:25Z,1,1,2
NULL,41668,2017-05-01T08:12:41Z,63,2,65
B-RFC-approved;B-unstable;T-lang,41673,2017-05-01T13:19:24Z,57,0,57
NULL,41676,2017-05-01T17:50:46Z,1,1,2
NULL,41678,2017-05-01T19:25:58Z,89,17,106
NULL,41687,2017-05-01T22:05:54Z,0,1,1
NULL,41688,2017-05-02T00:39:08Z,1,1,2
B-RFC-approved;T-lang,41692,2017-05-02T03:23:28Z,69,0,69
B-RFC-approved;T-lang,41693,2017-05-02T03:57:41Z,45,41,86
S-waiting-on-author,41702,2017-05-02T13:10:00Z,1387,1232,2619
NULL,41705,2017-05-02T14:35:58Z,0,4221,4221
NULL,41706,2017-05-02T14:36:30Z,0,0,0
NULL,41711,2017-05-02T17:41:25Z,23,0,23
NULL,41716,2017-05-02T21:36:25Z,249,81,330
"S-waiting-on-author,S-waiting-on-author",41717,2017-05-03T01:21:23Z,1355,5523,6878
NULL,41720,2017-05-03T04:06:27Z,25,4,29
A-docs,41721,2017-05-03T05:15:30Z,6,4,10
"A-diagnostics,A-diagnostics",41722,2017-05-03T08:29:02Z,36,0,36
"A-incr-comp,A-incr-comp",41724,2017-05-03T14:05:35Z,114,100,214
NULL,41725,2017-05-03T14:51:42Z,0,0,0
NULL,41728,2017-05-03T17:08:47Z,21,0,21
NULL,41730,2017-05-03T18:03:22Z,11,0,11
NULL,41735,2017-05-03T22:34:04Z,108,43,151
NULL,41739,2017-05-04T06:13:41Z,1,1,2
"A-docs,A-docs",41741,2017-05-04T09:12:27Z,2,1,3
NULL,41746,2017-05-04T12:23:43Z,1,1,2
"B-unstable;T-compiler;T-tools,B-unstable;T-compiler;T-tools",41751,2017-05-04T16:38:45Z,16,68,84
NULL,41752,2017-05-04T17:00:45Z,0,0,0
"B-unstable;T-lang,A-tools;B-RFC-approved,B-unstable;T-lang,A-tools;B-RFC-approved",41757,2017-05-04T21:03:09Z,16,28,44
NULL,41759,2017-05-04T22:13:06Z,0,0,0
NULL,41760,2017-05-05T00:35:06Z,0,0,0
NULL,41761,2017-05-05T00:55:02Z,40,0,40
NULL,41762,2017-05-05T01:35:32Z,9,18,27
"A-incr-comp,A-incr-comp",41766,2017-05-05T08:00:17Z,0,0,0
"A-docs,A-docs",41768,2017-05-05T10:06:39Z,22,0,22
NULL,41769,2017-05-05T14:04:32Z,3,1,4
NULL,41771,2017-05-05T18:43:37Z,103,33,136
NULL,41772,2017-05-05T21:29:02Z,60,7,67
S-waiting-on-review,41773,2017-05-05T21:35:31Z,1490,950,2440
NULL,41777,2017-05-06T01:21:59Z,61,2,63
"S-waiting-on-review,A-incr-comp,S-waiting-on-review,A-incr-comp",41780,2017-05-06T09:54:16Z,0,0,0
NULL,41785,2017-05-06T13:34:40Z,73,27,100
NULL,41788,2017-05-06T15:40:58Z,1,1,2
NULL,41791,2017-05-06T20:22:31Z,6,2,8
"A-docs,A-docs",41809,2017-05-07T14:06:42Z,91,61,152
A-docs,41811,2017-05-07T15:30:07Z,12,0,12
"A-docs,A-docs",41814,2017-05-07T17:37:26Z,20,23,43
NULL,41815,2017-05-07T17:42:52Z,68,13,81
NULL,41824,2017-05-08T11:34:37Z,2725,0,2725
NULL,41827,2017-05-08T13:39:26Z,25,1,26
NULL,41828,2017-05-08T14:07:36Z,109,17,126
NULL,41830,2017-05-08T16:10:50Z,1,1,2
"T-compiler,T-compiler",41838,2017-05-08T21:44:03Z,55,8,63
"A-rustbuild,A-rustbuild,A-rustbuild",41843,2017-05-08T23:50:43Z,256,74,330
NULL,41844,2017-05-09T01:03:53Z,0,0,0
S-waiting-on-review,41845,2017-05-09T01:18:03Z,0,0,0
NULL,41846,2017-05-09T02:34:54Z,381,59,440
NULL,41848,2017-05-09T03:53:53Z,0,0,0
NULL,41853,2017-05-09T11:31:37Z,53,15,68
"A-docs,A-docs",41854,2017-05-09T12:26:17Z,56,6,62
NULL,41856,2017-05-09T13:39:39Z,148,6,154
NULL,41859,2017-05-09T16:59:31Z,12,12,24
"A-diagnostics,A-diagnostics",41862,2017-05-09T18:51:57Z,35,2,37
NULL,41869,2017-05-10T01:16:15Z,0,0,0
"A-docs,A-docs",41870,2017-05-10T02:30:00Z,287,57,344
NULL,41872,2017-05-10T03:50:13Z,0,0,0
NULL,41873,2017-05-10T10:39:44Z,49,1,50
"A-debuginfo;A-testsuite,A-debuginfo;A-testsuite,A-debuginfo;A-testsuite,A-debuginfo;A-testsuite",41877,2017-05-10T11:40:25Z,5,0,5
NULL,41881,2017-05-10T13:03:57Z,0,0,0
NULL,41887,2017-05-10T15:18:35Z,212,79,291
NULL,41889,2017-05-10T16:27:32Z,0,1,1
"beta-nominated,beta-nominated",41899,2017-05-10T22:03:24Z,344,6,350
"S-waiting-on-review,S-waiting-on-review",41901,2017-05-11T01:04:13Z,0,0,0
"B-unstable;T-libs,B-unstable;T-libs,B-unstable;T-libs,B-unstable;T-libs",41904,2017-05-11T04:19:20Z,27,77,104
S-waiting-on-review,41905,2017-05-11T04:21:29Z,296,128,424
NULL,41907,2017-05-11T09:00:51Z,138,19,157
NULL,41910,2017-05-11T13:50:56Z,13,2,15
NULL,41913,2017-05-11T14:59:26Z,84,23,107
NULL,41920,2017-05-11T20:11:57Z,67,1,68
NULL,41923,2017-05-11T21:16:15Z,21,2,23
"regression-from-stable-to-beta;T-compiler,regression-from-stable-to-beta;T-compiler",41926,2017-05-11T22:42:39Z,41,40,81
NULL,41927,2017-05-11T23:38:56Z,0,0,0
"S-waiting-on-review,beta-nominated,beta-nominated,S-waiting-on-review,beta-nominated;S-waiting-on-review;T-compiler",41929,2017-05-12T00:21:11Z,0,0,0
"beta-nominated;S-waiting-on-review;T-compiler,S-waiting-on-review,S-waiting-on-review,beta-nominated,beta-nominated,beta-nominated;S-waiting-on-review;T-compiler,S-waiting-on-review,S-waiting-on-review,beta-nominated,beta-nominated",41930,2017-05-12T00:22:24Z,0,0,0
"A-rustbuild;E-easy;E-mentor,A-rustbuild;E-easy;E-mentor",41932,2017-05-12T03:14:16Z,137,143,280
NULL,41934,2017-05-12T06:39:42Z,1,96,97
"A-infrastructure;I-papercut,A-infrastructure;I-papercut",41935,2017-05-12T07:18:11Z,5,0,5
NULL,41937,2017-05-12T09:47:24Z,106,2,108
"B-unstable;T-lang,B-unstable;T-lang",41939,2017-05-12T11:16:29Z,74,51,125
"S-waiting-on-review,S-waiting-on-review,beta-nominated,beta-nominated",41945,2017-05-12T13:00:11Z,0,0,0
NULL,41946,2017-05-12T13:07:41Z,33,3,36
"S-waiting-on-review,S-waiting-on-review",41947,2017-05-12T13:23:25Z,0,0,0
"A-rustdoc,A-rustdoc",41950,2017-05-12T13:33:13Z,8,4,12
"S-waiting-on-review,S-waiting-on-review",41954,2017-05-12T15:36:09Z,0,0,0
"beta-nominated,beta-nominated",41955,2017-05-12T16:08:38Z,42,42,84
"A-rustbuild;A-windows-msvc,A-rustbuild;A-windows-msvc",41959,2017-05-12T18:48:53Z,0,0,0
NULL,41961,2017-05-12T19:31:02Z,103,41,144
"S-waiting-on-review,S-waiting-on-review,S-waiting-on-review,S-waiting-on-review",41965,2017-05-13T00:57:39Z,475,384,859
"A-testsuite,A-testsuite",41968,2017-05-13T10:17:21Z,250,35,285
S-waiting-on-review,41972,2017-05-13T14:04:50Z,0,0,0
A-rustbuild;A-windows-msvc,41973,2017-05-13T15:43:42Z,0,0,0
"A-rustbuild;A-windows-msvc,A-rustbuild;A-windows-msvc",41975,2017-05-13T17:13:17Z,20,19,39
"S-waiting-on-review,S-waiting-on-author",41977,2017-05-13T17:58:00Z,0,0,0
"A-docs,A-docs",41980,2017-05-13T19:23:26Z,22,0,22
"A-docs,A-docs",41981,2017-05-13T19:24:31Z,28,3,31
"A-docs,A-docs",41982,2017-05-13T19:44:57Z,23,0,23
NULL,41983,2017-05-13T19:45:03Z,0,0,0
"S-waiting-on-author,S-waiting-on-review",41987,2017-05-14T02:55:14Z,196,81,277
NULL,41989,2017-05-14T04:20:01Z,0,0,0
NULL,41990,2017-05-14T12:49:49Z,29,0,29
"A-docs,A-docs",41994,2017-05-14T17:47:42Z,38,11,49
"A-docs,A-docs",41995,2017-05-14T18:34:43Z,30,15,45
NULL,41999,2017-05-14T21:53:47Z,0,0,0
"regression-from-stable-to-beta,regression-from-stable-to-beta",42005,2017-05-15T09:28:59Z,36,5,41
NULL,42006,2017-05-15T09:49:32Z,18,5,23
T-doc,42010,2017-05-15T15:20:44Z,0,0,0
T-doc,42012,2017-05-15T15:25:37Z,0,0,0
NULL,42014,2017-05-15T16:23:46Z,0,4,4
"A-lang;B-RFC-approved;B-unstable,A-lang;B-RFC-approved;B-unstable",42016,2017-05-15T20:16:24Z,7,115,122
NULL,42017,2017-05-15T20:18:20Z,4,4,8
"T-doc,T-doc",42022,2017-05-16T01:28:43Z,0,0,0
"regression-from-stable-to-beta;T-compiler,regression-from-stable-to-beta;T-compiler",42023,2017-05-16T01:32:39Z,154,11,165
"A-docs,A-docs",42024,2017-05-16T03:57:14Z,23,0,23
"A-rustdoc,A-rustdoc",42027,2017-05-16T07:39:25Z,58,2,60
"T-doc,beta-nominated;S-waiting-on-review;T-compiler",42032,2017-05-16T11:43:22Z,0,0,0
NULL,42033,2017-05-16T11:47:08Z,438,90,528
"beta-nominated;S-waiting-on-review;T-compiler,T-doc",42038,2017-05-16T14:18:37Z,158,45,203
"regression-from-stable-to-beta,regression-from-stable-to-beta",42039,2017-05-16T14:57:44Z,1,1,2
"regression-from-stable-to-beta,regression-from-stable-to-beta",42040,2017-05-16T14:59:46Z,1,1,2
NULL,42049,2017-05-16T23:31:53Z,617,547,1164
NULL,42052,2017-05-17T08:36:43Z,198,86,284
"beta-nominated,beta-nominated,beta-nominated,beta-nominated,beta-nominated",42053,2017-05-17T11:03:54Z,298,232,530
NULL,42058,2017-05-17T13:49:14Z,70,2,72
"A-testsuite;A-wasm;E-help-wanted;I-wrong,A-testsuite;A-wasm;E-help-wanted;I-wrong",42059,2017-05-17T15:21:18Z,58,30,88
NULL,42062,2017-05-17T19:33:15Z,15,15,30
"B-RFC-approved;B-unstable;T-lang,S-waiting-on-review,B-RFC-approved;B-unstable;T-lang",42068,2017-05-17T21:28:05Z,42,62,104
NULL,42069,2017-05-17T21:28:21Z,33,4,37
NULL,42073,2017-05-17T23:07:20Z,1,1,2
NULL,42074,2017-05-17T23:12:01Z,0,0,0
NULL,42076,2017-05-18T03:37:39Z,176,133,309
NULL,42080,2017-05-18T07:40:14Z,3,3,6
"B-RFC-approved;B-unstable;T-lang,S-waiting-on-review,B-RFC-approved;B-unstable;T-lang,B-RFC-approved;B-unstable;T-lang,S-waiting-on-review,B-RFC-approved;B-unstable;T-lang",42083,2017-05-18T11:59:48Z,62,7,69
NULL,42086,2017-05-18T16:52:52Z,1,1,2
"B-RFC-approved,B-RFC-approved",42088,2017-05-18T18:16:32Z,0,0,0
NULL,42089,2017-05-18T18:59:12Z,4,3,7
S-waiting-on-author,42090,2017-05-18T21:52:17Z,0,0,0
"A-docs,A-docs,A-docs",42091,2017-05-18T23:11:07Z,33,16,49
"A-driver,A-driver",42092,2017-05-18T23:15:03Z,19,3,22
"beta-nominated;S-waiting-on-review;T-compiler,S-waiting-on-author,beta-nominated;S-waiting-on-review;T-compiler,S-waiting-on-author",42094,2017-05-18T23:54:59Z,0,0,0
beta-nominated;S-waiting-on-review;T-compiler,42095,2017-05-18T23:55:23Z,0,0,0
NULL,42096,2017-05-19T02:30:34Z,3,3,6
NULL,42098,2017-05-19T04:34:38Z,1,0,1
A-debuginfo,42100,2017-05-19T11:10:02Z,87,14,101
NULL,42103,2017-05-19T18:47:20Z,17,5,22
"beta-nominated;S-waiting-on-review;T-compiler,S-waiting-on-author",42105,2017-05-19T20:16:27Z,947,513,1460
NULL,42110,2017-05-20T09:24:17Z,0,0,0
NULL,42123,2017-05-20T16:35:25Z,8,0,8
NULL,42124,2017-05-20T16:53:34Z,1,1,2
NULL,42125,2017-05-20T17:03:02Z,665,8,673
NULL,42126,2017-05-20T19:26:00Z,37,1,38
NULL,42127,2017-05-20T19:33:01Z,2,2,4
NULL,42128,2017-05-20T19:35:08Z,259,26,285
NULL,42130,2017-05-20T23:48:17Z,129,54,183
NULL,42131,2017-05-21T03:36:50Z,2,0,2
NULL,42132,2017-05-21T04:58:46Z,1,1,2
B-RFC-approved,42134,2017-05-21T08:50:16Z,149,255,404
NULL,42136,2017-05-21T13:39:50Z,107,224,331
NULL,42141,2017-05-21T19:43:55Z,8,0,8
NULL,42144,2017-05-21T22:39:12Z,3,3,6
"B-unstable;I-nominated;T-libs,B-unstable;I-nominated;T-libs",42145,2017-05-22T01:53:08Z,60,23,83
NULL,42146,2017-05-22T02:16:13Z,135,47,182
NULL,42147,2017-05-22T06:16:40Z,1,2,3
NULL,42149,2017-05-22T07:33:08Z,20,54,74
"A-diagnostics,A-diagnostics",42150,2017-05-22T11:48:12Z,248,252,500
NULL,42160,2017-05-22T23:11:45Z,43,0,43
"beta-nominated;T-libs,beta-nominated;S-waiting-on-review;T-compiler",42161,2017-05-23T01:18:11Z,46,83,129
B-RFC-approved;T-lang,42162,2017-05-23T01:25:14Z,0,0,0
NULL,42165,2017-05-23T04:15:49Z,319,186,505
NULL,42167,2017-05-23T09:38:41Z,96,1,97
"B-unstable;I-nominated;T-libs,B-unstable;I-nominated;T-libs",42169,2017-05-23T10:12:53Z,7,7,14
NULL,42175,2017-05-23T17:05:51Z,78,139,217
NULL,42186,2017-05-24T06:45:55Z,21,18,39
"A-diagnostics;E-mentor;T-compiler,A-diagnostics;E-mentor;T-compiler",42196,2017-05-24T16:42:12Z,66,32,98
"beta-nominated,beta-nominated",42197,2017-05-24T17:18:33Z,48,44,92
"S-waiting-on-bors,S-waiting-on-bors,S-waiting-on-bors,S-waiting-on-review;T-libs,S-waiting-on-bors,S-waiting-on-bors",42212,2017-05-25T01:50:12Z,603,643,1246
NULL,42214,2017-05-25T01:58:31Z,21,6,27
NULL,42217,2017-05-25T06:23:06Z,21,0,21
"A-rustbuild;E-easy;E-help-wanted,A-rustbuild;E-easy;E-help-wanted",42218,2017-05-25T06:45:23Z,62,24,86
"A-windows-msvc,A-windows-msvc",42225,2017-05-25T18:56:07Z,63,533,596
NULL,42227,2017-05-25T20:35:59Z,16,16,32
NULL,42230,2017-05-25T22:10:19Z,129,0,129
"S-waiting-on-bors,relnotes,S-waiting-on-bors",42233,2017-05-26T03:09:43Z,0,0,0
NULL,42236,2017-05-26T08:33:11Z,23,2,25
"S-waiting-on-bors,S-waiting-on-bors,S-waiting-on-review,S-waiting-on-review",42242,2017-05-26T11:54:32Z,0,0,0
S-waiting-on-bors,42245,2017-05-26T14:20:31Z,168,40,208
NULL,42249,2017-05-26T17:08:56Z,13,10,23
NULL,42251,2017-05-26T20:51:02Z,52,7,59
"S-waiting-on-review,S-waiting-on-review",42254,2017-05-26T23:13:22Z,0,0,0
"S-waiting-on-bors,S-waiting-on-review,S-waiting-on-review",42257,2017-05-27T12:23:24Z,0,0,0
"S-waiting-on-bors,S-waiting-on-review,S-waiting-on-review",42258,2017-05-27T14:06:41Z,0,0,0
NULL,42260,2017-05-27T15:18:22Z,18,3,21
NULL,42262,2017-05-27T16:16:30Z,29,44,73
"A-rustbuild,A-rustbuild",42263,2017-05-27T17:23:19Z,178,84,262
NULL,42264,2017-05-27T18:00:02Z,344,185,529
NULL,42268,2017-05-27T20:12:27Z,0,0,0
NULL,42269,2017-05-27T20:34:23Z,0,0,0
NULL,42270,2017-05-27T21:41:00Z,0,0,0
NULL,42271,2017-05-27T22:44:35Z,85,1,86
"S-waiting-on-review,S-waiting-on-review",42272,2017-05-28T00:29:06Z,0,0,0
NULL,42275,2017-05-28T02:50:58Z,138,33,171
S-waiting-on-review,42276,2017-05-28T02:54:06Z,155,1235,1390
NULL,42277,2017-05-28T06:50:03Z,4,14,18
"A-codegen;A-typesystem;I-cleanup,A-codegen;A-typesystem;I-cleanup,A-codegen;A-typesystem;I-cleanup,A-codegen;A-typesystem;I-cleanup",42281,2017-05-28T13:48:28Z,1479,2147,3626
NULL,42282,2017-05-28T14:22:20Z,10,4,14
NULL,42283,2017-05-28T14:30:07Z,26,0,26
"A-traits;I-cleanup;T-compiler,A-traits;I-cleanup;T-compiler",42297,2017-05-29T15:11:46Z,91,59,150
NULL,42302,2017-05-29T20:50:25Z,51,16,67
NULL,42304,2017-05-29T23:40:30Z,296,49,345
NULL,42305,2017-05-30T00:44:48Z,0,0,0
NULL,42306,2017-05-30T03:08:59Z,99,29,128
NULL,42310,2017-05-30T07:21:50Z,45,15,60
NULL,42313,2017-05-30T14:49:43Z,1377,118,1495
"E-easy;I-cleanup,E-easy;I-cleanup",42314,2017-05-30T15:52:03Z,1,1,2
NULL,42316,2017-05-30T17:13:30Z,0,0,0
NULL,42318,2017-05-30T21:02:17Z,38,14,52
S-waiting-on-review,42321,2017-05-31T01:27:19Z,0,0,0
NULL,42324,2017-05-31T05:22:39Z,66,1,67
"S-waiting-on-review,S-waiting-on-review",42328,2017-05-31T09:03:08Z,0,0,0
NULL,42329,2017-05-31T09:38:26Z,2,2,4
NULL,42330,2017-05-31T10:26:56Z,50,19,69
"A-allocators;A-windows;I-unsound,A-allocators;A-windows;I-unsound",42331,2017-05-31T12:57:31Z,37,17,54
NULL,42332,2017-05-31T14:57:52Z,289,350,639
NULL,42334,2017-05-31T15:05:47Z,64,19,83
NULL,42335,2017-05-31T15:28:16Z,1,19,20
S-waiting-on-review,42336,2017-05-31T16:52:51Z,171,73,244
NULL,42338,2017-05-31T18:41:02Z,150,0,150
NULL,42343,2017-06-01T00:30:35Z,6,6,12
"S-waiting-on-review,relnotes,needs-crater",42345,2017-06-01T02:13:13Z,0,0,0
"S-waiting-on-review,needs-crater",42346,2017-06-01T02:14:39Z,0,0,0
"needs-crater;S-waiting-on-review,S-waiting-on-review,needs-crater",42348,2017-06-01T04:09:27Z,660,523,1183
T-libs,42358,2017-06-01T19:15:58Z,0,0,0
NULL,42361,2017-06-01T21:26:23Z,32,3,35
"A-diagnostics,A-diagnostics",42362,2017-06-01T22:05:14Z,97,15,112
NULL,42363,2017-06-01T22:20:29Z,115,31,146
beta-nominated;S-waiting-on-review;T-compiler,42364,2017-06-01T22:39:18Z,36,5,41
"T-libs,relnotes,T-libs,relnotes",42367,2017-06-01T23:36:12Z,0,0,0
NULL,42368,2017-06-01T23:57:59Z,36,7,43
"T-libs,T-libs",42377,2017-06-02T12:49:22Z,0,0,0
"T-dev-tools,T-dev-tools",42378,2017-06-02T12:59:40Z,500,0,500
"relnotes,T-libs",42379,2017-06-02T13:54:29Z,0,0,0
"T-libs,relnotes",42381,2017-06-02T15:10:50Z,184,614,798
"S-waiting-on-author,S-waiting-on-author",42382,2017-06-02T16:58:53Z,0,6,6
NULL,42387,2017-06-02T19:40:49Z,52,6,58
"A-traits;I-cleanup;T-compiler,A-traits;I-cleanup;T-compiler",42388,2017-06-02T19:58:51Z,341,294,635
A-diagnostics;E-easy,42391,2017-06-02T20:25:19Z,30,16,46
NULL,42396,2017-06-03T01:04:38Z,28,142,170
NULL,42400,2017-06-03T05:00:56Z,160,48,208
NULL,42402,2017-06-03T07:41:07Z,1,0,1
NULL,42410,2017-06-03T17:42:56Z,35,2,37
NULL,42415,2017-06-03T19:47:45Z,6,6,12
NULL,42428,2017-06-04T18:18:59Z,73,41,114
NULL,42429,2017-06-04T18:37:57Z,9,0,9
NULL,42430,2017-06-04T18:46:57Z,122,8,130
"I-nominated;T-libs,I-nominated;T-libs,I-nominated;T-libs",42431,2017-06-04T18:47:34Z,40,46,86
NULL,42433,2017-06-04T19:56:58Z,319,17,336
"S-waiting-on-review,S-waiting-on-review",42443,2017-06-05T10:42:08Z,116,6,122
S-waiting-on-review,42445,2017-06-05T15:44:04Z,0,0,0
"B-RFC-approved;T-libs,B-RFC-approved;T-libs",42456,2017-06-05T21:45:34Z,0,0,0
NULL,42466,2017-06-06T01:55:07Z,1,0,1
"A-docs,A-docs",42469,2017-06-06T03:31:22Z,13,5,18
P-high,42472,2017-06-06T04:33:54Z,39,109,148
"regression-from-stable-to-nightly,regression-from-stable-to-nightly",42480,2017-06-06T15:53:20Z,48,2,50
NULL,42481,2017-06-06T16:20:13Z,11,9,20
"regression-from-stable-to-nightly,regression-from-stable-to-nightly",42482,2017-06-06T16:54:23Z,39,0,39
NULL,42485,2017-06-06T18:02:45Z,1,1,2
NULL,42490,2017-06-06T20:19:24Z,39,9,48
NULL,42492,2017-06-06T21:59:12Z,417,206,623
"S-waiting-on-review,S-waiting-on-review",42494,2017-06-07T02:36:38Z,149,123,272
NULL,42496,2017-06-07T03:03:24Z,61,2,63
NULL,42504,2017-06-07T11:49:31Z,464,348,812
NULL,42519,2017-06-07T22:15:37Z,255,111,366
NULL,42521,2017-06-08T01:32:23Z,23,6,29
NULL,42522,2017-06-08T01:58:47Z,119,32,151
NULL,42523,2017-06-08T02:26:36Z,3171,3029,6200
"A-const-fn;B-RFC-approved;T-lang,A-const-fn;B-RFC-approved;T-lang",42526,2017-06-08T03:58:32Z,131,1,132
NULL,42527,2017-06-08T06:09:54Z,707,19,726
NULL,42533,2017-06-08T12:25:25Z,35,28,63
NULL,42534,2017-06-08T13:27:45Z,0,0,0
NULL,42536,2017-06-08T15:55:58Z,0,0,0
NULL,42537,2017-06-08T16:39:28Z,1007,785,1792
"B-RFC-approved;T-libs,B-RFC-approved;T-libs",42541,2017-06-08T17:43:21Z,33,10,43
NULL,42554,2017-06-09T01:18:12Z,0,0,0
"A-lint;I-wishlist,A-lint;I-wishlist",42563,2017-06-09T14:32:05Z,440,625,1065
"B-RFC-approved;T-libs,B-RFC-approved;T-libs",42565,2017-06-09T17:29:54Z,587,66,653
"beta-nominated,beta-nominated",42567,2017-06-09T18:46:12Z,11,9,20
NULL,42568,2017-06-09T19:58:53Z,47,17,64
A-wasm;E-help-wanted,42571,2017-06-09T21:11:35Z,77,1,78
NULL,42572,2017-06-09T22:17:42Z,20,20,40
NULL,42573,2017-06-09T22:29:30Z,23,18,41
NULL,42578,2017-06-10T03:33:56Z,140,9,149
"A-docs,A-docs",42579,2017-06-10T06:21:16Z,11,9,20
A-diagnostics;E-easy,42580,2017-06-10T10:50:49Z,15,4,19
NULL,42584,2017-06-10T18:17:07Z,0,0,0
NULL,42585,2017-06-10T19:20:35Z,154,32,186
NULL,42588,2017-06-11T02:45:55Z,96,38,134
NULL,42592,2017-06-11T12:53:42Z,60,28,88
NULL,42593,2017-06-11T13:27:42Z,257,81,338
"A-incr-comp,A-incr-comp",42598,2017-06-12T08:00:05Z,122,93,215
NULL,42604,2017-06-12T16:01:37Z,81,19,100
NULL,42605,2017-06-12T16:39:50Z,99,62,161
NULL,42608,2017-06-12T18:06:22Z,37,18,55
"beta-nominated,beta-nominated,beta-nominated,beta-nominated,beta-nominated,beta-nominated",42609,2017-06-12T18:11:16Z,139,29,168
NULL,42612,2017-06-12T20:30:52Z,420,1273,1693
NULL,42613,2017-06-12T20:43:52Z,450,134,584
NULL,42614,2017-06-12T21:54:02Z,401,46,447
NULL,42616,2017-06-12T22:56:21Z,48,2,50
"B-RFC-approved;T-libs,B-RFC-approved;T-libs",42620,2017-06-13T00:47:10Z,116,0,116
NULL,42623,2017-06-13T03:38:36Z,38,36,74
"A-incr-comp;S-waiting-on-author,A-incr-comp;S-waiting-on-author",42625,2017-06-13T10:28:09Z,156,4,160
NULL,42626,2017-06-13T11:16:07Z,0,0,0
A-incr-comp;A-macros,42627,2017-06-13T11:52:29Z,93,87,180
NULL,42631,2017-06-13T14:04:25Z,182,98,280
NULL,42636,2017-06-13T19:37:57Z,70,27,97
NULL,42642,2017-06-13T20:28:22Z,61,66,127
NULL,42643,2017-06-13T20:34:49Z,0,0,0
NULL,42644,2017-06-13T21:15:05Z,233,86,319
NULL,42648,2017-06-13T23:06:06Z,2347,2516,4863
NULL,42649,2017-06-13T23:28:28Z,145,37,182
NULL,42654,2017-06-14T16:37:54Z,60,13,73
"B-unstable;T-lang,B-unstable;T-lang",42656,2017-06-14T17:33:46Z,3,67,70
NULL,42660,2017-06-14T19:49:26Z,1,1,2
NULL,42661,2017-06-14T19:52:44Z,1,1,2
NULL,42662,2017-06-14T20:39:56Z,1,1,2
"A-diagnostics;metabug;T-compiler,A-diagnostics;T-compiler,A-diagnostics;metabug;T-compiler,A-diagnostics;T-compiler",42669,2017-06-15T06:52:00Z,615,51,666
NULL,42684,2017-06-15T19:52:44Z,0,0,0
NULL,42690,2017-06-16T04:32:47Z,125,71,196
NULL,42695,2017-06-16T13:48:47Z,8,9,17
"A-libs,A-libs",42697,2017-06-16T14:26:38Z,29,0,29
NULL,42705,2017-06-16T18:05:03Z,78,43,121
NULL,42709,2017-06-16T22:16:55Z,20,10,30
NULL,42712,2017-06-17T06:10:51Z,80,45,125
NULL,42717,2017-06-17T16:05:46Z,6,4,10
NULL,42722,2017-06-17T19:44:52Z,14,239,253
"I-ICE,I-ICE",42724,2017-06-17T23:00:56Z,288,0,288
"B-RFC-approved,B-RFC-approved,B-RFC-approved",42727,2017-06-18T01:53:19Z,2828,1169,3997
NULL,42728,2017-06-18T06:38:56Z,4,1,5
NULL,42730,2017-06-18T07:35:33Z,51,15,66
NULL,42731,2017-06-18T12:34:58Z,21,0,21
NULL,42732,2017-06-18T14:27:53Z,71,3,74
"A-lifetimes,A-typesystem",42734,2017-06-18T15:03:56Z,124,0,124
NULL,42735,2017-06-18T15:59:48Z,11,0,11
NULL,42738,2017-06-18T16:34:15Z,323,39,362
NULL,42739,2017-06-18T17:18:31Z,0,0,0
NULL,42740,2017-06-18T17:21:40Z,2,2,4
"A-codegen;A-mir;I-slow;regression-from-stable-to-stable;T-compiler,A-codegen;A-mir;I-slow;regression-from-stable-to-stable;T-compiler",42750,2017-06-19T14:03:49Z,104,2,106
NULL,42751,2017-06-19T15:47:30Z,99,13,112
"A-lint,A-lint",42756,2017-06-19T19:45:39Z,10,11,21
NULL,42762,2017-06-20T03:01:01Z,2,2,4
"A-incr-comp,A-incr-comp",42769,2017-06-20T09:55:49Z,0,0,0
NULL,42771,2017-06-20T12:11:21Z,7,2,9
NULL,42772,2017-06-20T12:32:48Z,1,1,2
NULL,42777,2017-06-20T18:19:16Z,560,237,797
"beta-nominated;S-waiting-on-review;T-compiler,S-waiting-on-review,S-waiting-on-review;T-libs",42780,2017-06-20T20:28:33Z,278,18,296
NULL,42782,2017-06-20T22:39:04Z,111,0,111
NULL,42785,2017-06-21T00:06:03Z,9,9,18
NULL,42797,2017-06-21T13:16:59Z,68,12,80
NULL,42802,2017-06-21T14:40:18Z,124,15,139
NULL,42803,2017-06-21T15:45:05Z,27,3,30
A-rustbuild,42804,2017-06-21T16:07:14Z,41,0,41
NULL,42805,2017-06-21T16:09:05Z,8,0,8
NULL,42807,2017-06-21T17:29:20Z,29,39,68
"B-unstable;T-lang,B-unstable;T-lang",42809,2017-06-21T19:32:19Z,64,266,330
beta-accepted;beta-nominated,42815,2017-06-22T01:36:20Z,0,0,0
beta-accepted;beta-nominated,42817,2017-06-22T02:13:59Z,0,0,0
NULL,42819,2017-06-22T06:04:58Z,86,61,147
NULL,42821,2017-06-22T08:31:58Z,22,22,44
A-libs,42822,2017-06-22T10:04:46Z,35,0,35
NULL,42824,2017-06-22T12:30:13Z,66,8,74
NULL,42826,2017-06-22T14:29:44Z,98,1,99
NULL,42829,2017-06-22T17:44:40Z,14,10,24
A-docs,42831,2017-06-22T18:56:51Z,4,7,11
"I-nominated;I-unsound;T-compiler,I-nominated;I-unsound;T-compiler",42840,2017-06-22T21:30:05Z,239,169,408
"beta-nominated;T-compiler,beta-nominated;S-waiting-on-review;T-compiler,beta-nominated,beta-nominated;T-compiler,beta-nominated;S-waiting-on-review;T-compiler,beta-accepted;beta-nominated,beta-nominated;T-compiler,beta-accepted;beta-nominated,beta-nominated;T-compiler,beta-accepted;beta-nominated,beta-accepted;beta-nominated,beta-nominated,beta-accepted;beta-nominated,beta-nominated;T-compiler,beta-nominated;S-waiting-on-review;T-compiler,beta-accepted;beta-nominated,beta-nominated;T-compiler,beta-accepted;beta-nominated,beta-nominated,beta-accepted;beta-nominated,beta-accepted;beta-nominated",42841,2017-06-22T21:31:07Z,0,0,0
S-waiting-on-review,42845,2017-06-22T23:19:28Z,0,0,0
"S-waiting-on-review,S-waiting-on-review",42846,2017-06-23T00:34:27Z,0,0,0
NULL,42854,2017-06-23T10:52:26Z,6,6,12
S-waiting-on-review,42856,2017-06-23T12:02:16Z,668,286,954
NULL,42859,2017-06-23T14:52:09Z,195,15,210
NULL,42864,2017-06-23T17:25:54Z,4,0,4
NULL,42871,2017-06-24T00:28:54Z,6,6,12
NULL,42874,2017-06-24T04:16:18Z,73,17,90
NULL,42883,2017-06-24T15:21:43Z,0,0,0
NULL,42884,2017-06-24T16:27:15Z,99,81,180
NULL,42885,2017-06-24T17:20:10Z,28,1,29
NULL,42886,2017-06-24T18:29:10Z,103,8,111
NULL,42887,2017-06-24T21:24:57Z,99,32,131
NULL,42901,2017-06-25T18:35:08Z,28,1,29
NULL,42902,2017-06-25T18:35:27Z,185,122,307
NULL,42904,2017-06-25T20:35:40Z,181,60,241
NULL,42910,2017-06-26T11:28:22Z,0,0,0
"A-macros,A-macros,A-macros,A-macros",42913,2017-06-26T15:52:01Z,317,6,323
beta-nominated;T-libs,42916,2017-06-26T16:32:56Z,63,48,111
"A-spurious,A-spurious",42917,2017-06-26T18:52:06Z,1,1,2
NULL,42919,2017-06-26T23:14:37Z,63,41,104
NULL,42922,2017-06-27T03:34:14Z,336,136,472
NULL,42925,2017-06-27T10:10:53Z,30,9,39
"beta-accepted;beta-nominated,beta-accepted;beta-nominated,beta-nominated,beta-nominated;T-compiler,beta-nominated;S-waiting-on-review;T-compiler,beta-accepted;beta-nominated,beta-nominated;T-compiler",42927,2017-06-27T11:20:28Z,405,201,606
NULL,42928,2017-06-27T13:06:45Z,0,0,0
NULL,42930,2017-06-27T15:12:40Z,2,2,4
NULL,42931,2017-06-27T15:36:36Z,18,2,20
NULL,42932,2017-06-27T16:21:46Z,416,154,570
NULL,42938,2017-06-27T19:42:00Z,150,60,210
NULL,42948,2017-06-28T09:04:16Z,2,2,4
NULL,42952,2017-06-28T17:23:42Z,0,0,0
"A-diagnostics,A-diagnostics",42953,2017-06-28T18:10:07Z,28,0,28
"B-unstable;T-libs,B-unstable;T-libs",42959,2017-06-28T23:22:42Z,219,87,306
NULL,42961,2017-06-29T04:33:06Z,0,0,0
S-waiting-on-author,42964,2017-06-29T08:40:14Z,492,188,680
NULL,42965,2017-06-29T12:28:45Z,0,0,0
NULL,42968,2017-06-29T16:40:00Z,0,0,0
NULL,42969,2017-06-29T16:49:33Z,64,55,119
NULL,42972,2017-06-29T20:10:51Z,28,21,49
NULL,42973,2017-06-29T20:40:01Z,34,3,37
NULL,42978,2017-06-30T09:27:02Z,0,0,0
A-rustbuild,42985,2017-06-30T17:00:20Z,5,9,14
NULL,42989,2017-06-30T17:59:36Z,0,0,0
NULL,42990,2017-06-30T18:00:09Z,0,0,0
NULL,42992,2017-06-30T19:29:05Z,0,0,0
NULL,42995,2017-06-30T20:44:49Z,697,115,812
NULL,42996,2017-06-30T21:24:46Z,20,81,101
"A-diagnostics,A-diagnostics",43001,2017-07-01T00:13:09Z,29,0,29
NULL,43002,2017-07-01T01:17:46Z,5,26,31
NULL,43006,2017-07-01T13:42:16Z,41,55,96
NULL,43007,2017-07-01T16:04:42Z,0,0,0
"A-lang;B-RFC-approved;B-unstable,A-lang;B-RFC-approved;B-unstable,A-lang;B-RFC-approved;B-unstable,A-lang;B-RFC-approved;B-unstable",43008,2017-07-01T19:41:18Z,374,374,748
NULL,43009,2017-07-01T23:38:38Z,112,37,149
"B-RFC-approved;T-libs,B-RFC-approved;T-libs",43010,2017-07-02T00:15:05Z,20,63,83
NULL,43011,2017-07-02T00:29:45Z,52,7,59
"T-libs,B-unstable;I-nominated;T-libs,T-libs,B-unstable;I-nominated;T-libs",43012,2017-07-02T02:21:09Z,20,251,271
NULL,43015,2017-07-02T13:15:58Z,412,379,791
NULL,43017,2017-07-02T20:20:03Z,312,102,414
NULL,43022,2017-07-03T09:15:26Z,2,2,4
NULL,43026,2017-07-03T14:44:53Z,38,6,44
"A-incr-comp,S-waiting-on-author,A-incr-comp,S-waiting-on-author",43028,2017-07-03T15:35:11Z,640,691,1331
NULL,43043,2017-07-03T23:53:24Z,1,1,2
"beta-nominated;T-libs,S-waiting-on-review,S-waiting-on-review",43047,2017-07-04T11:57:37Z,0,0,0
"S-waiting-on-review,S-waiting-on-review,beta-nominated;T-libs",43051,2017-07-04T13:41:46Z,561,433,994
NULL,43053,2017-07-04T14:33:48Z,0,0,0
"T-libs,T-libs",43055,2017-07-04T18:27:05Z,4,9,13
NULL,43060,2017-07-04T23:43:58Z,194,78,272
NULL,43067,2017-07-05T14:33:18Z,52,7,59
NULL,43068,2017-07-05T14:53:10Z,6,2,8
NULL,43072,2017-07-05T19:25:37Z,29,15,44
"S-waiting-on-review;T-doc,S-waiting-on-review;T-doc",43075,2017-07-05T21:15:29Z,16,12,28
"B-unstable;I-nominated;T-libs,T-libs,B-unstable;I-nominated;T-libs,T-libs",43077,2017-07-05T23:26:01Z,196,174,370
NULL,43078,2017-07-06T00:26:43Z,18,0,18
"S-waiting-on-review,S-waiting-on-review",43083,2017-07-06T07:05:56Z,219,148,367
"B-RFC-approved,B-RFC-approved,B-RFC-approved,B-RFC-approved",43086,2017-07-06T13:12:57Z,0,0,0
NULL,43091,2017-07-06T17:48:28Z,0,1,1
NULL,43092,2017-07-06T17:56:48Z,2,1,3
NULL,43096,2017-07-06T21:35:53Z,174,18,192
NULL,43097,2017-07-06T22:07:53Z,41,21,62
"A-incr-comp;I-slow,A-incr-comp;I-slow",43107,2017-07-07T12:27:44Z,101,47,148
"B-unstable;T-lang,B-unstable;T-lang",43109,2017-07-07T14:11:57Z,20,11,31
NULL,43113,2017-07-07T21:48:01Z,1,1,2
"beta-nominated;T-libs,beta-nominated;T-libs,beta-nominated;T-dev-tools,beta-nominated;T-libs,beta-nominated;T-dev-tools,beta-nominated;T-libs",43114,2017-07-08T00:44:33Z,21,323,344
NULL,43115,2017-07-08T00:57:16Z,137,136,273
NULL,43116,2017-07-08T04:12:19Z,1,1,2
"B-RFC-approved;T-lang,B-RFC-approved;T-lang",43125,2017-07-08T19:36:09Z,231,0,231
NULL,43127,2017-07-08T20:10:23Z,0,0,0
"A-rustbuild;E-easy;E-help-wanted,A-rustbuild;E-easy;E-help-wanted",43129,2017-07-08T22:15:06Z,366,711,1077
"A-rustdoc,A-rustdoc",43130,2017-07-08T22:40:59Z,14,2,16
NULL,43136,2017-07-09T22:21:00Z,5,1,6
NULL,43140,2017-07-10T09:58:27Z,0,0,0
NULL,43145,2017-07-10T14:30:29Z,10,1,11
NULL,43147,2017-07-10T16:05:36Z,9,9,18
NULL,43152,2017-07-10T17:47:30Z,15,10,25
"T-compiler,T-compiler",43156,2017-07-10T21:16:46Z,0,0,0
"B-unstable;E-easy;T-libs,B-unstable;E-easy;T-libs",43158,2017-07-11T00:19:51Z,95,18,113
NULL,43159,2017-07-11T01:00:16Z,4,1,5
NULL,43167,2017-07-11T12:05:53Z,2,2,4
NULL,43168,2017-07-11T12:40:51Z,1291,0,1291
"A-linkage,A-linkage",43170,2017-07-11T20:04:25Z,143,14,157
NULL,43173,2017-07-11T21:31:58Z,0,0,0
NULL,43175,2017-07-12T00:30:31Z,71,29,100
NULL,43178,2017-07-12T03:57:29Z,68,0,68
S-waiting-on-review,43181,2017-07-12T12:58:50Z,338,29,367
"A-codegen;A-compiler;A-concurrency;A-incr-comp;I-compiletime;T-compiler,A-codegen;A-compiler;A-concurrency;A-incr-comp;I-compiletime;T-compiler",43183,2017-07-12T15:44:16Z,559,365,924
NULL,43185,2017-07-12T16:14:58Z,92,16,108
NULL,43194,2017-07-12T20:54:03Z,0,0,0
NULL,43199,2017-07-13T00:40:06Z,0,0,0
regression-from-stable-to-beta,43207,2017-07-13T05:23:55Z,6,6,12
NULL,43216,2017-07-13T14:45:23Z,321,25,346
NULL,43217,2017-07-13T15:18:42Z,15,7,22
NULL,43220,2017-07-13T18:06:23Z,0,0,0
NULL,43221,2017-07-13T18:16:48Z,77,6,83
NULL,43223,2017-07-13T18:51:01Z,0,0,0
NULL,43224,2017-07-13T21:10:30Z,28,1,29
NULL,43230,2017-07-14T05:33:04Z,489,24,513
NULL,43237,2017-07-14T16:41:42Z,9,1,10
NULL,43238,2017-07-14T17:30:45Z,1,1,2
NULL,43245,2017-07-15T02:02:50Z,281,0,281
NULL,43246,2017-07-15T03:57:20Z,89,21,110
NULL,43247,2017-07-15T03:58:50Z,41,16,57
NULL,43251,2017-07-15T12:49:29Z,33,22,55
NULL,43258,2017-07-15T23:06:10Z,8,2,10
NULL,43260,2017-07-15T23:28:22Z,9,2,11
NULL,43266,2017-07-16T16:36:30Z,78,7,85
NULL,43270,2017-07-16T20:02:08Z,24,7,31
"T-compiler,T-compiler",43271,2017-07-16T20:28:45Z,51,0,51
"B-RFC-approved;B-unstable;T-lang,B-RFC-approved;B-unstable;T-lang",43274,2017-07-16T22:30:03Z,116,8,124
NULL,43281,2017-07-17T09:48:53Z,2,1,3
NULL,43292,2017-07-17T17:53:00Z,1,1,2
NULL,43297,2017-07-17T20:34:10Z,4,4,8
NULL,43298,2017-07-17T20:34:22Z,462,125,587
NULL,43303,2017-07-17T22:40:43Z,56,1,57
NULL,43307,2017-07-18T02:58:34Z,36,443,479
S-waiting-on-review,43316,2017-07-18T15:41:39Z,189,156,345
NULL,43322,2017-07-19T01:03:24Z,1,1,2
"A-diagnostics;E-easy,A-diagnostics;E-easy",43323,2017-07-19T02:13:16Z,91,18,109
"T-compiler,T-compiler",43324,2017-07-19T02:36:44Z,37,23,60
"I-nominated;T-lang,I-nominated;T-lang,I-nominated;T-lang,I-nominated;T-lang",43339,2017-07-19T17:44:52Z,0,0,0
NULL,43342,2017-07-19T20:06:18Z,55,0,55
NULL,43343,2017-07-19T20:21:52Z,140,24,164
NULL,43345,2017-07-19T21:17:21Z,782,0,782
"A-rustdoc;I-completion;P-low,A-rustdoc;I-completion;P-low,A-rustdoc;I-completion;P-low,A-rustdoc;I-completion;P-low",43348,2017-07-20T00:46:55Z,1261,75,1336
"A-codegen,A-codegen",43351,2017-07-20T03:42:57Z,0,0,0
"A-diagnostics;A-syntaxext;I-cleanup;P-low,A-diagnostics;A-syntaxext;I-cleanup;P-low,A-diagnostics;A-syntaxext;I-cleanup;P-low,A-diagnostics;A-syntaxext;I-cleanup;P-low",43352,2017-07-20T04:57:42Z,97,13,110
"I-compiletime,I-compiletime",43361,2017-07-20T13:37:12Z,27,113,140
NULL,43368,2017-07-20T18:43:30Z,184,0,184
NULL,43382,2017-07-21T08:32:26Z,3,0,3
NULL,43384,2017-07-21T11:22:16Z,2,1,3
NULL,43386,2017-07-21T12:02:27Z,40,64,104
NULL,43387,2017-07-21T13:39:23Z,194,105,299
S-waiting-on-review,43388,2017-07-21T14:33:40Z,0,0,0
NULL,43397,2017-07-21T23:18:19Z,102,3,105
"B-RFC-approved;T-lang,B-RFC-approved;T-lang,B-RFC-approved;T-lang,B-RFC-approved;T-lang",43399,2017-07-21T23:41:24Z,311,106,417
NULL,43406,2017-07-22T09:24:46Z,1,0,1
"A-docs,A-docs",43413,2017-07-22T20:38:06Z,36,0,36
NULL,43422,2017-07-23T08:21:22Z,0,0,0
NULL,43425,2017-07-23T13:21:06Z,52,1,53
"A-diagnostics;P-high,A-diagnostics;P-high,A-diagnostics;P-high",43426,2017-07-23T13:52:37Z,290,31,321
NULL,43430,2017-07-23T16:07:15Z,85,88,173
NULL,43436,2017-07-23T18:43:09Z,1,1,2
NULL,43442,2017-07-23T21:47:46Z,131,13,144
"B-RFC-approved;B-unstable;T-lang,B-RFC-approved;B-unstable;T-lang",43443,2017-07-23T22:03:15Z,81,24,105
"A-android,A-android",43444,2017-07-23T22:19:41Z,0,0,0
NULL,43445,2017-07-23T23:13:53Z,36,13,49
NULL,43446,2017-07-24T00:22:56Z,1,0,1
NULL,43447,2017-07-24T02:41:46Z,194,129,323
NULL,43451,2017-07-24T13:02:55Z,0,0,0
NULL,43454,2017-07-24T15:16:40Z,275,196,471
NULL,43456,2017-07-24T18:23:49Z,1,1,2
NULL,43464,2017-07-25T02:09:14Z,0,0,0
A-compiler;A-macros,43465,2017-07-25T03:25:14Z,175,0,175
NULL,43471,2017-07-25T05:29:24Z,30,15,45
NULL,43477,2017-07-25T20:23:42Z,14,13,27
NULL,43479,2017-07-25T20:51:36Z,145,13,158
NULL,43480,2017-07-25T21:40:01Z,1,0,1
"A-rustbuild,A-rustbuild,A-rustbuild,A-rustbuild,A-rustbuild,A-rustbuild,A-rustbuild",43482,2017-07-25T22:21:48Z,181,144,325
"A-diagnostics,A-diagnostics",43484,2017-07-26T05:08:34Z,71,26,97
A-spurious,43485,2017-07-26T07:02:11Z,5,4,9
NULL,43487,2017-07-26T12:15:10Z,631,236,867
NULL,43489,2017-07-26T16:57:05Z,36,2,38
NULL,43505,2017-07-27T13:48:10Z,199,136,335
"A-rustdoc,A-rustdoc",43509,2017-07-27T18:30:01Z,13,1,14
NULL,43512,2017-07-27T20:15:59Z,28,19,47
"I-slow;regression-from-stable-to-nightly,I-slow;regression-from-stable-to-nightly",43513,2017-07-27T21:54:45Z,22,0,22
"A-rustdoc,A-rustdoc",43515,2017-07-28T00:33:09Z,7,0,7
NULL,43518,2017-07-28T04:39:47Z,55,5,60
A-incr-comp;E-mentor;T-compiler,43522,2017-07-28T14:15:55Z,1342,1064,2406
NULL,43529,2017-07-28T20:34:10Z,109,5,114
NULL,43532,2017-07-28T23:55:11Z,264,438,702
NULL,43533,2017-07-29T00:43:08Z,24,8,32
S-waiting-on-review,43538,2017-07-29T10:00:16Z,0,0,0
NULL,43540,2017-07-29T12:12:26Z,49,44,93
NULL,43546,2017-07-29T19:33:58Z,86,6,92
"regression-from-stable-to-beta;T-compiler,regression-from-stable-to-beta;T-compiler",43547,2017-07-29T20:09:37Z,46,16,62
NULL,43550,2017-07-29T23:29:43Z,0,0,0
"S-waiting-on-review,S-waiting-on-review",43551,2017-07-30T00:03:59Z,160,58,218
NULL,43552,2017-07-30T00:48:52Z,55,74,129
"A-rustdoc;T-dev-tools,A-rustdoc;T-dev-tools",43558,2017-07-30T13:12:18Z,31,23,54
"T-compiler,T-compiler",43559,2017-07-30T20:01:28Z,114,14,128
"A-rustdoc;I-papercut,A-rustdoc;I-papercut",43560,2017-07-30T20:08:46Z,142,19,161
I-needs-decision;T-libs,43563,2017-07-30T21:21:41Z,4,0,4
NULL,43568,2017-07-31T14:44:51Z,109,37,146
"B-RFC-approved;T-libs,B-RFC-approved;T-libs",43574,2017-07-31T21:22:50Z,71,0,71
I-nominated;regression-from-stable-to-beta;T-compiler,43576,2017-07-31T23:28:24Z,210,178,388
NULL,43579,2017-08-01T01:15:38Z,1,1,2
I-compiletime;T-compiler,43581,2017-08-01T01:42:22Z,2,0,2
NULL,43582,2017-08-01T02:12:09Z,110,70,180
I-compiletime;T-compiler,43584,2017-08-01T11:51:45Z,21,17,38
NULL,43589,2017-08-01T14:43:44Z,26,0,26
A-incr-comp,43590,2017-08-01T15:30:29Z,38,32,70
NULL,43595,2017-08-01T17:48:05Z,10,3,13
NULL,43600,2017-08-01T21:32:52Z,229,49,278
A-rustdoc,43602,2017-08-01T22:11:16Z,7,3,10
NULL,43603,2017-08-02T01:22:31Z,89,31,120
NULL,43607,2017-08-02T03:07:57Z,0,1,1
NULL,43609,2017-08-02T04:28:14Z,96,0,96
NULL,43615,2017-08-02T17:04:31Z,3,2,5
NULL,43618,2017-08-02T22:38:02Z,1,1,2
NULL,43621,2017-08-03T04:10:58Z,0,0,0
C-tracking-issue;T-dev-tools,43628,2017-08-03T14:34:26Z,334,45,379
NULL,43632,2017-08-03T20:10:32Z,1,1,2
"I-nominated;T-lang,I-nominated;T-lang",43641,2017-08-04T10:50:07Z,0,0,0
NULL,43642,2017-08-04T12:04:44Z,0,6,6
NULL,43646,2017-08-04T18:12:18Z,0,0,0
NULL,43651,2017-08-05T00:21:09Z,18,14,32
NULL,43688,2017-08-05T15:05:53Z,0,0,0
"I-nominated;T-compiler,I-nominated;T-compiler",43690,2017-08-05T17:48:06Z,618,24,642
NULL,43691,2017-08-05T21:55:25Z,25,9,34
NULL,43693,2017-08-06T03:26:36Z,0,0,0
NULL,43698,2017-08-06T15:39:48Z,125,19,144
NULL,43700,2017-08-06T17:15:32Z,624,204,828
NULL,43708,2017-08-07T03:20:35Z,3,11,14
NULL,43709,2017-08-07T04:43:25Z,46,16,62
NULL,43710,2017-08-07T05:56:43Z,1376,1376,2752
NULL,43713,2017-08-07T13:03:37Z,92,4,96
NULL,43714,2017-08-07T15:07:47Z,1,20,21
NULL,43716,2017-08-07T15:45:16Z,101,56,157
NULL,43717,2017-08-07T17:16:58Z,0,0,0
S-waiting-on-review,43723,2017-08-07T22:10:13Z,77,138,215
"A-docs,A-docs",43724,2017-08-07T22:18:14Z,615,529,1144
NULL,43726,2017-08-07T22:55:14Z,92,5,97
B-RFC-approved;T-lang,43728,2017-08-08T04:57:00Z,79,9,88
NULL,43732,2017-08-08T08:19:13Z,4,2,6
NULL,43735,2017-08-08T09:52:41Z,74,4,78
NULL,43736,2017-08-08T11:27:05Z,27,0,27
NULL,43737,2017-08-08T12:12:29Z,69,14,83
"A-incr-comp;T-compiler,A-incr-comp;T-compiler",43740,2017-08-08T14:02:47Z,1222,544,1766
B-RFC-approved;T-compiler,43743,2017-08-08T16:23:18Z,50,34,84
NULL,43745,2017-08-08T16:35:53Z,54,0,54
NULL,43760,2017-08-09T12:46:36Z,1,1,2
"B-RFC-approved;T-lang,B-RFC-approved;T-lang",43776,2017-08-09T22:10:17Z,128,34,162
NULL,43782,2017-08-10T06:01:39Z,55,30,85
"I-unsound;T-compiler,I-unsound;T-compiler",43786,2017-08-10T14:02:42Z,90,5,95
"T-dev-tools,T-dev-tools",43790,2017-08-10T20:58:35Z,84,1,85
"C-cleanup,C-cleanup",43798,2017-08-11T02:37:17Z,0,0,0
NULL,43800,2017-08-11T08:20:34Z,249,76,325
NULL,43802,2017-08-11T11:41:34Z,0,0,0
NULL,43813,2017-08-11T21:12:42Z,42,1,43
NULL,43814,2017-08-11T21:43:31Z,83,82,165
NULL,43815,2017-08-11T23:06:56Z,133,76,209
NULL,43824,2017-08-12T12:09:18Z,5,0,5
NULL,43826,2017-08-12T17:28:46Z,33,123,156
NULL,43829,2017-08-12T22:18:54Z,0,0,0
NULL,43830,2017-08-12T22:35:51Z,29,6,35
"S-waiting-on-review,beta-accepted;beta-nominated;T-libs",43831,2017-08-12T22:49:37Z,235,135,370
"A-diagnostics,A-diagnostics",43832,2017-08-13T00:53:10Z,48,11,59
B-unstable;T-libs,43833,2017-08-13T02:24:36Z,1,1,2
"B-RFC-approved;B-unstable;T-lang,B-RFC-approved;B-unstable;T-lang",43838,2017-08-13T08:49:11Z,88,99,187
NULL,43839,2017-08-13T09:03:16Z,268,175,443
NULL,43841,2017-08-13T12:39:48Z,62,19,81
NULL,43842,2017-08-13T14:01:12Z,144,141,285
"S-waiting-on-author,S-waiting-on-author",43844,2017-08-13T14:03:58Z,44,6,50
NULL,43847,2017-08-13T16:16:43Z,0,0,0
"T-doc;T-libs,T-doc;T-libs",43848,2017-08-13T16:19:06Z,45,10,55
NULL,43849,2017-08-13T18:04:22Z,86,14,100
NULL,43850,2017-08-13T18:56:20Z,19,3,22
NULL,43851,2017-08-13T19:21:22Z,0,0,0
NULL,43854,2017-08-13T21:59:45Z,77,0,77
NULL,43856,2017-08-14T00:08:19Z,0,5,5
NULL,43857,2017-08-14T10:09:28Z,16,0,16
I-ICE;regression-from-stable-to-nightly,43858,2017-08-14T10:25:46Z,39,4,43
"S-waiting-on-review,S-waiting-on-review",43859,2017-08-14T11:11:41Z,97,3,100
"T-dev-tools,T-dev-tools",43863,2017-08-14T17:59:40Z,6,33,39
NULL,43864,2017-08-14T18:57:48Z,5,0,5
"A-diagnostics,A-diagnostics",43867,2017-08-14T19:58:00Z,1,2,3
NULL,43868,2017-08-14T20:22:19Z,2,0,2
NULL,43870,2017-08-14T22:22:23Z,126,0,126
NULL,43872,2017-08-15T00:28:49Z,134,15,149
A-rustbuild,43873,2017-08-15T03:23:13Z,0,0,0
B-unstable,43878,2017-08-15T06:38:51Z,67,6,73
NULL,43880,2017-08-15T10:48:18Z,463,693,1156
NULL,43883,2017-08-15T14:17:38Z,13,3,16
NULL,43884,2017-08-15T14:44:24Z,1,1,2
NULL,43887,2017-08-15T15:57:46Z,0,0,0
NULL,43891,2017-08-15T20:33:18Z,59,59,118
"A-rustbuild,A-rustbuild",43895,2017-08-16T01:42:59Z,18,5,23
"A-diagnostics,A-diagnostics",43901,2017-08-16T11:33:18Z,91,10,101
NULL,43905,2017-08-16T15:11:26Z,8,1,9
"C-cleanup,C-cleanup",43907,2017-08-16T16:53:45Z,240,451,691
NULL,43911,2017-08-16T20:12:33Z,2,24,26
"A-docs,A-docs",43919,2017-08-17T04:48:53Z,18,13,31
S-waiting-on-review,43920,2017-08-17T06:09:08Z,4,6,10
NULL,43922,2017-08-17T06:35:35Z,55,30,85
"A-diagnostics,A-diagnostics",43929,2017-08-17T09:15:56Z,198,41,239
NULL,43931,2017-08-17T09:57:46Z,14,4,18
"A-destructors;A-mir,A-destructors;A-mir",43932,2017-08-17T10:11:48Z,177,54,231
"A-diagnostics,A-diagnostics",43933,2017-08-17T13:09:17Z,11,16,27
relnotes;S-waiting-on-review,43939,2017-08-17T14:44:16Z,129,75,204
"A-incr-comp;E-medium;E-mentor;T-compiler,A-incr-comp;E-medium;E-mentor;T-compiler",43945,2017-08-17T16:46:10Z,0,0,0
NULL,43948,2017-08-17T19:56:10Z,67,45,112
"beta-nominated,beta-nominated",43952,2017-08-17T21:08:54Z,287,400,687
NULL,43965,2017-08-17T22:02:52Z,1,1,2
NULL,43966,2017-08-17T22:09:34Z,59,0,59
"A-incr-comp;I-slow,A-incr-comp;I-slow",43968,2017-08-18T00:11:18Z,325,346,671
NULL,43971,2017-08-18T06:57:42Z,53,31,84
NULL,43975,2017-08-18T10:09:43Z,34,31,65
NULL,43976,2017-08-18T11:10:33Z,1,1,2
"A-rustdoc,A-rustdoc",43979,2017-08-18T17:43:33Z,17,1,18
NULL,43980,2017-08-18T18:26:20Z,0,0,0
NULL,43983,2017-08-18T23:13:32Z,13,3,16
"A-diagnostics,A-diagnostics",43984,2017-08-19T10:31:32Z,0,0,0
NULL,43986,2017-08-19T11:27:51Z,64,1309,1373
"I-wrong;T-libs,I-wrong;T-libs",43989,2017-08-19T20:08:56Z,10,15,25
NULL,43992,2017-08-19T23:19:05Z,0,0,0
NULL,43993,2017-08-19T23:34:17Z,18,19,37
NULL,43994,2017-08-19T23:54:43Z,9,142,151
NULL,43999,2017-08-20T16:21:01Z,112,19,131
NULL,44001,2017-08-20T19:50:33Z,4,0,4
NULL,44004,2017-08-21T01:24:45Z,1,1,2
NULL,44008,2017-08-21T09:14:39Z,43,1,44
NULL,44009,2017-08-21T09:39:42Z,30,32,62
NULL,44013,2017-08-21T11:28:23Z,27,11,38
"A-build,A-build",44014,2017-08-21T12:24:10Z,20,16,36
NULL,44026,2017-08-22T01:43:16Z,121,18,139
NULL,44031,2017-08-22T05:21:39Z,39,1,40
NULL,44032,2017-08-22T10:07:04Z,1,1,2
NULL,44033,2017-08-22T11:36:22Z,108,78,186
"T-libs,T-libs",44042,2017-08-22T18:01:59Z,1791,625,2416
B-RFC-approved;T-libs,44044,2017-08-22T20:24:44Z,25,109,134
NULL,44045,2017-08-22T20:47:20Z,0,0,0
"A-incr-comp;E-hard;E-mentor;T-compiler,A-incr-comp;E-hard;E-mentor;T-compiler",44046,2017-08-22T21:14:30Z,90,28,118
NULL,44049,2017-08-22T22:12:23Z,68,0,68
"C-tracking-issue;regression-from-stable-to-nightly;T-compiler,C-tracking-issue;regression-from-stable-to-nightly;T-compiler",44051,2017-08-22T23:49:14Z,96,30,126
NULL,44053,2017-08-23T02:43:09Z,2,1,3
NULL,44055,2017-08-23T03:58:57Z,64,30,94
NULL,44058,2017-08-23T12:44:31Z,30,18,48
"beta-nominated,beta-nominated,beta-nominated,beta-nominated;T-libs,beta-nominated",44062,2017-08-23T14:57:45Z,275,165,440
NULL,44066,2017-08-23T23:12:13Z,151,44,195
NULL,44067,2017-08-24T03:45:39Z,0,0,0
NULL,44070,2017-08-24T13:43:31Z,2,2,4
"A-incr-comp;T-compiler,A-incr-comp;T-compiler",44071,2017-08-24T14:39:05Z,59,33,92
NULL,44079,2017-08-25T06:33:49Z,344,178,522
NULL,44081,2017-08-25T10:29:10Z,55,1,56
NULL,44082,2017-08-25T14:46:44Z,57,8,65
"A-rustbuild;O-windows-msvc,A-rustbuild;O-windows-msvc",44084,2017-08-25T17:12:17Z,21,4,25
NULL,44085,2017-08-25T17:34:10Z,523,267,790
NULL,44088,2017-08-25T18:48:03Z,126,3,129
NULL,44089,2017-08-25T20:35:15Z,55,1,56
"S-waiting-on-author,S-waiting-on-author",44093,2017-08-26T01:18:30Z,0,0,0
NULL,44094,2017-08-26T03:29:06Z,316,6,322
NULL,44096,2017-08-26T05:32:35Z,38,0,38
NULL,44097,2017-08-26T06:09:34Z,113,0,113
S-waiting-on-author,44098,2017-08-26T13:46:38Z,264,88,352
NULL,44102,2017-08-26T18:31:13Z,1,7,8
"B-RFC-approved;T-lang,B-RFC-approved;T-lang",44103,2017-08-26T19:11:46Z,52,12,64
S-waiting-on-author,44106,2017-08-26T21:56:36Z,0,0,0
"A-build,A-build,A-rustbuild,A-rustbuild;T-infra",44107,2017-08-26T22:08:09Z,653,1217,1870
"B-RFC-approved;T-lang,B-RFC-approved;T-lang",44108,2017-08-26T22:14:37Z,84,2,86
NULL,44112,2017-08-27T02:37:37Z,13,2,15
NULL,44117,2017-08-27T19:41:20Z,66,22,88
NULL,44122,2017-08-28T05:06:35Z,0,0,0
NULL,44124,2017-08-28T07:40:31Z,0,0,0
NULL,44129,2017-08-28T13:25:39Z,319,23,342
NULL,44133,2017-08-28T19:24:06Z,69,36,105
NULL,44135,2017-08-28T20:41:14Z,9,6,15
"A-rustdoc;C-tracking-issue;T-dev-tools,A-rustdoc;C-tracking-issue;T-dev-tools",44138,2017-08-28T23:33:35Z,44,3,47
NULL,44139,2017-08-29T00:23:57Z,0,0,0
"A-incr-comp,A-incr-comp,A-incr-comp;T-compiler,A-incr-comp",44142,2017-08-29T01:34:40Z,1854,1460,3314
"A-rustbuild,A-rustbuild,A-rustbuild",44143,2017-08-29T01:35:29Z,1,6,7
"A-rustbuild,A-rustbuild",44144,2017-08-29T01:42:37Z,1,1,2
NULL,44148,2017-08-29T09:47:39Z,113,59,172
NULL,44149,2017-08-29T12:45:16Z,0,0,0
NULL,44155,2017-08-29T15:14:17Z,0,0,0
NULL,44156,2017-08-29T15:15:25Z,0,0,0
A-incr-comp;T-compiler,44157,2017-08-29T16:26:47Z,26,21,47
"A-docs,A-docs",44160,2017-08-29T17:35:11Z,165,42,207
"A-incr-comp;T-compiler,A-incr-comp;T-compiler",44162,2017-08-29T18:17:59Z,76,18,94
NULL,44164,2017-08-29T19:22:41Z,0,0,0
"A-build;beta-accepted;beta-nominated;T-dev-tools;T-infra,A-build;beta-accepted;beta-nominated;T-dev-tools;T-infra",44166,2017-08-29T21:10:25Z,0,0,0
NULL,44167,2017-08-29T21:24:03Z,99,131,230
"A-build;beta-accepted;beta-nominated;T-dev-tools;T-infra,A-build;beta-accepted;beta-nominated;T-dev-tools;T-infra",44169,2017-08-29T21:41:05Z,207,92,299
NULL,44171,2017-08-30T01:02:43Z,670,757,1427
"B-RFC-approved;T-libs,B-RFC-approved;T-libs",44174,2017-08-30T05:22:31Z,71,48,119
NULL,44186,2017-08-30T16:11:17Z,691,206,897
NULL,44194,2017-08-30T22:08:04Z,28,1,29
A-incr-comp;T-compiler,44195,2017-08-30T22:30:54Z,66,74,140
"I-nominated;T-compiler,I-nominated;T-compiler",44196,2017-08-30T22:50:32Z,0,0,0
NULL,44202,2017-08-31T00:33:13Z,46,0,46
"A-build;beta-accepted;beta-nominated;T-dev-tools;T-infra,A-build;beta-accepted;beta-nominated;T-dev-tools;T-infra,A-build;beta-accepted;beta-nominated;T-dev-tools;T-infra,A-build;beta-accepted;beta-nominated;T-dev-tools;T-infra",44204,2017-08-31T01:46:09Z,457,4,461
"T-doc,T-doc",44206,2017-08-31T02:35:37Z,1,3,4
NULL,44207,2017-08-31T02:53:07Z,0,0,0
NULL,44209,2017-08-31T04:15:12Z,92,6,98
"B-unstable;T-lang,B-unstable;T-lang",44212,2017-08-31T09:22:50Z,44,15,59
"A-diagnostics,A-diagnostics",44215,2017-08-31T13:49:28Z,70,30,100
NULL,44220,2017-08-31T17:33:04Z,115,21,136
NULL,44222,2017-08-31T19:16:23Z,0,0,0
NULL,44227,2017-08-31T21:55:34Z,0,0,0
NULL,44228,2017-08-31T21:57:57Z,0,0,0
NULL,44233,2017-09-01T00:07:50Z,239,95,334
NULL,44235,2017-09-01T01:05:13Z,72,5,77
A-rustdoc;T-dev-tools;T-doc,44238,2017-09-01T03:37:24Z,214,39,253
NULL,44248,2017-09-01T15:46:49Z,15,5,20
NULL,44251,2017-09-01T19:47:28Z,1477,24,1501
"S-waiting-on-crater,S-waiting-on-crater",44252,2017-09-01T20:06:21Z,0,0,0
NULL,44254,2017-09-01T21:09:55Z,31,17,48
A-build;A-rustdoc;I-nominated;T-dev-tools;T-doc,44259,2017-09-02T03:17:41Z,1,1,2
"regression-from-stable-to-beta,regression-from-stable-to-beta",44260,2017-09-02T03:50:24Z,47,33,80
NULL,44261,2017-09-02T04:36:05Z,15,1,16
"B-RFC-approved;B-unstable;T-lang,B-RFC-approved;B-unstable;T-lang",44262,2017-09-02T05:30:51Z,25,2,27
NULL,44269,2017-09-02T12:38:58Z,156,8,164
NULL,44272,2017-09-02T16:09:50Z,23,0,23
NULL,44276,2017-09-02T17:46:33Z,51,0,51
NULL,44277,2017-09-02T18:05:29Z,26,0,26
NULL,44287,2017-09-03T13:16:32Z,0,0,0
"B-RFC-approved;T-lang,B-RFC-approved;T-lang",44295,2017-09-03T18:57:18Z,732,114,846
"A-diagnostics;E-mentor,A-diagnostics;E-mentor",44297,2017-09-03T19:36:45Z,158,10,168
"A-mir;C-enhancement;T-compiler,A-mir;C-enhancement;T-compiler",44308,2017-09-04T05:03:03Z,319,362,681
NULL,44312,2017-09-04T10:32:00Z,16,79,95
"A-resolve;I-wrong,A-resolve;I-wrong",44317,2017-09-04T19:07:45Z,13,0,13
NULL,44319,2017-09-04T20:46:34Z,20,11,31
NULL,44321,2017-09-04T20:55:17Z,4,1,5
"E-easy;P-low;T-doc,E-easy;P-low;T-doc",44325,2017-09-04T22:46:52Z,25,20,45
"I-nominated;I-unsound,I-nominated;I-unsound",44326,2017-09-05T00:01:58Z,2,3,5
"P-backcompat-lang,P-backcompat-lang",44327,2017-09-05T00:09:13Z,1,2,3
NULL,44328,2017-09-05T02:24:00Z,0,1,1
NULL,44330,2017-09-05T04:28:47Z,1,1,2
NULL,44332,2017-09-05T10:08:50Z,17,1,18
"I-compiletime;T-compiler,I-compiletime;T-compiler",44335,2017-09-05T12:20:38Z,20,1,21
NULL,44338,2017-09-05T13:49:55Z,0,0,0
NULL,44344,2017-09-05T16:36:28Z,67,0,67
regression-from-stable-to-beta,44352,2017-09-05T20:34:08Z,0,0,0
"regression-from-stable-to-beta,regression-from-stable-to-beta",44356,2017-09-05T22:12:37Z,13,4,17
"regression-from-stable-to-beta,regression-from-stable-to-beta",44357,2017-09-05T22:19:56Z,59,37,96
"A-diagnostics;I-papercut;I-wrong,A-diagnostics;I-papercut;I-wrong",44360,2017-09-06T06:39:55Z,0,0,0
NULL,44364,2017-09-06T10:28:50Z,1827,731,2558
NULL,44368,2017-09-06T15:30:10Z,6,2,8
NULL,44369,2017-09-06T16:49:29Z,0,0,0
NULL,44380,2017-09-07T00:28:09Z,559,83,642
"I-wrong;regression-from-stable-to-nightly,I-wrong;regression-from-stable-to-nightly",44383,2017-09-07T03:21:37Z,33,6,39
NULL,44384,2017-09-07T05:15:54Z,2,1,3
NULL,44386,2017-09-07T07:05:50Z,82,13,95
NULL,44388,2017-09-07T09:28:54Z,9,16,25
NULL,44407,2017-09-08T01:07:44Z,7,0,7
beta-accepted;beta-nominated,44417,2017-09-08T13:41:12Z,0,0,0
NULL,44418,2017-09-08T14:44:08Z,102,245,347
NULL,44420,2017-09-08T14:46:43Z,194,135,329
"A-incr-comp,A-incr-comp",44435,2017-09-08T21:03:12Z,142,121,263
NULL,44436,2017-09-08T21:04:33Z,23,0,23
NULL,44438,2017-09-08T22:06:23Z,0,113,113
NULL,44440,2017-09-08T22:58:56Z,89,2,91
NULL,44442,2017-09-09T01:06:26Z,76,4,80
"E-easy;P-low;T-doc,E-easy;P-low;T-doc",44449,2017-09-09T08:10:37Z,10,0,10
"E-easy;P-low;T-doc,E-easy;P-low;T-doc",44453,2017-09-09T12:10:41Z,16,1,17
beta-accepted;beta-nominated,44455,2017-09-09T13:00:57Z,0,0,0
"B-unstable;T-lang,B-unstable;T-lang",44456,2017-09-09T15:03:34Z,39,211,250
"E-easy;P-low;T-doc,E-easy;P-low;T-doc",44457,2017-09-09T16:29:12Z,28,0,28
NULL,44460,2017-09-09T19:07:04Z,0,0,0
NULL,44464,2017-09-09T20:14:15Z,16,0,16
NULL,44467,2017-09-09T21:18:55Z,16,7,23
NULL,44469,2017-09-09T21:41:22Z,0,0,0
"C-enhancement;P-low;T-doc,C-enhancement;P-low;T-doc",44472,2017-09-10T03:27:29Z,31,0,31
NULL,44474,2017-09-10T12:03:33Z,158,105,263
"C-enhancement;P-low;T-doc,C-enhancement;P-low;T-doc",44477,2017-09-10T18:28:53Z,13,0,13
NULL,44480,2017-09-10T20:39:23Z,354,174,528
NULL,44482,2017-09-11T00:55:12Z,0,0,0
NULL,44483,2017-09-11T01:16:19Z,0,0,0
NULL,44484,2017-09-11T02:15:17Z,52,6,58
"E-easy;P-low;T-doc,E-easy;P-low;T-doc",44485,2017-09-11T06:18:30Z,11,0,11
"C-enhancement;P-low;T-doc,C-enhancement;P-low;T-doc",44497,2017-09-11T16:30:31Z,11,0,11
NULL,44498,2017-09-11T18:02:58Z,1,0,1
"A-incr-comp;T-compiler,A-incr-comp;T-compiler",44501,2017-09-11T19:00:21Z,438,241,679
NULL,44502,2017-09-11T19:12:14Z,142,113,255
S-waiting-on-author,44516,2017-09-12T04:45:30Z,151,2,153
NULL,44518,2017-09-12T08:16:24Z,0,0,0
NULL,44520,2017-09-12T10:44:27Z,0,0,0
"E-easy;P-low;T-doc,E-easy;P-low;T-doc",44521,2017-09-12T11:01:34Z,13,0,13
NULL,44525,2017-09-12T19:31:02Z,23,15,38
"A-macros;E-easy;E-mentor,A-macros;E-easy;E-mentor",44528,2017-09-12T20:34:38Z,146,14,160
"A-incr-comp,A-incr-comp",44529,2017-09-12T21:28:59Z,1452,1247,2699
NULL,44534,2017-09-13T06:03:38Z,6,3,9
NULL,44536,2017-09-13T09:42:33Z,4,3,7
"B-RFC-approved;T-libs,B-RFC-approved;T-libs",44537,2017-09-13T10:23:08Z,80,41,121
NULL,44541,2017-09-13T12:48:29Z,23,5,28
NULL,44542,2017-09-13T14:53:56Z,20,2,22
"A-diagnostics;T-compiler,A-diagnostics;T-compiler",44549,2017-09-13T19:39:18Z,97,20,117
"S-waiting-on-review,S-waiting-on-review",44550,2017-09-13T19:46:18Z,0,0,0
"A-typesystem;B-RFC;I-enhancement,B-RFC-approved;T-lang,A-typesystem;B-RFC;I-enhancement,B-RFC-approved;T-lang",44551,2017-09-13T20:48:54Z,264,18,282
NULL,44552,2017-09-13T21:30:58Z,8,8,16
"A-rustdoc,A-rustdoc",44554,2017-09-13T22:20:46Z,35,2,37
NULL,44556,2017-09-14T00:12:47Z,0,0,0
NULL,44560,2017-09-14T03:03:59Z,94,94,188
"beta-accepted;beta-nominated,S-waiting-on-review,S-waiting-on-review",44561,2017-09-14T03:15:55Z,0,0,0
NULL,44562,2017-09-14T06:47:12Z,13,1,14
"A-libs,A-libs",44572,2017-09-14T19:35:33Z,7,0,7
"I-nominated;regression-from-stable-to-nightly;T-compiler,I-nominated;regression-from-stable-to-nightly;T-compiler",44584,2017-09-15T01:46:16Z,0,0,0
"S-waiting-on-review,beta-accepted;beta-nominated,S-waiting-on-review",44585,2017-09-15T02:32:54Z,320,120,440
"regression-from-stable-to-nightly,regression-from-stable-to-nightly",44586,2017-09-15T04:33:03Z,16,3,19
NULL,44590,2017-09-15T08:37:58Z,12,12,24
NULL,44598,2017-09-15T14:36:18Z,1,1,2
NULL,44599,2017-09-15T14:48:32Z,0,0,0
NULL,44601,2017-09-15T15:37:47Z,143,91,234
"B-RFC-approved;T-lang,B-RFC-approved;T-lang",44614,2017-09-15T21:09:00Z,1406,75,1481
"B-RFC-approved;T-lang,B-RFC-approved;T-lang",44620,2017-09-16T00:20:00Z,130,53,183
"S-waiting-on-review,S-waiting-on-review",44621,2017-09-16T01:02:44Z,0,0,0
"P-low;T-doc,P-low;T-doc",44622,2017-09-16T01:54:05Z,1,1,2
S-waiting-on-review,44623,2017-09-16T02:10:58Z,0,0,0
NULL,44624,2017-09-16T02:46:17Z,24,3,27
NULL,44625,2017-09-16T02:59:09Z,24,8,32
NULL,44626,2017-09-16T05:36:17Z,12,0,12
NULL,44627,2017-09-16T07:28:03Z,29,3,32
A-rustbuild,44630,2017-09-16T11:04:43Z,1,3,4
"needs-crater;S-waiting-on-review,needs-crater;S-waiting-on-review",44633,2017-09-16T13:49:27Z,119,144,263
"S-waiting-on-review,S-waiting-on-review",44634,2017-09-16T14:17:05Z,480,198,678
NULL,44636,2017-09-16T17:24:55Z,224,150,374
NULL,44639,2017-09-16T23:11:53Z,1,4,5
B-RFC-approved;T-libs,44640,2017-09-17T00:11:38Z,12,14,26
NULL,44641,2017-09-17T00:26:31Z,10,1,11
"A-diagnostics;A-typesystem;I-enhancement;I-wishlist,A-diagnostics;A-typesystem;I-enhancement;I-wishlist",44642,2017-09-17T00:41:31Z,0,0,0
NULL,44646,2017-09-17T04:18:03Z,188,32,220
NULL,44647,2017-09-17T04:22:50Z,5,2,7
NULL,44649,2017-09-17T07:54:07Z,0,0,0
NULL,44652,2017-09-17T09:36:53Z,0,0,0
NULL,44654,2017-09-17T11:19:16Z,880,287,1167
NULL,44664,2017-09-17T23:27:56Z,12,2,14
A-codegen;A-mir;T-compiler,44667,2017-09-18T03:04:56Z,0,0,0
E-easy;E-mentor;P-medium;T-doc,44668,2017-09-18T06:46:29Z,17,0,17
B-unstable;T-dev-tools,44673,2017-09-18T11:26:46Z,0,0,0
NULL,44676,2017-09-18T15:36:41Z,0,0,0
NULL,44678,2017-09-18T16:04:30Z,1985,798,2783
NULL,44689,2017-09-19T03:39:41Z,23,1,24
"B-RFC-approved;T-lang,B-RFC-approved;T-lang",44691,2017-09-19T05:58:32Z,259,62,321
NULL,44693,2017-09-19T07:15:29Z,1,1,2
NULL,44694,2017-09-19T08:37:19Z,0,0,0
NULL,44707,2017-09-19T19:50:27Z,228,32,260
"B-RFC-approved;T-lang,B-RFC-approved;T-lang",44708,2017-09-19T22:30:52Z,0,0,0
"B-RFC-approved,B-RFC-approved",44709,2017-09-20T01:19:03Z,295,199,494
NULL,44713,2017-09-20T07:07:53Z,15,1,16
NULL,44720,2017-09-20T15:29:21Z,1,0,1
NULL,44734,2017-09-21T08:02:13Z,146,0,146
NULL,44735,2017-09-21T09:18:29Z,245,119,364
"regression-from-stable-to-beta;T-compiler,regression-from-stable-to-beta;T-compiler",44743,2017-09-21T14:58:02Z,16,3,19
"C-bug;regression-from-stable-to-nightly,C-bug;regression-from-stable-to-nightly",44745,2017-09-21T15:15:48Z,33,11,44
NULL,44749,2017-09-21T17:51:23Z,19,6,25
NULL,44757,2017-09-21T19:59:50Z,29,7,36
"regression-from-stable-to-beta;T-compiler,regression-from-stable-to-beta;T-compiler",44758,2017-09-21T20:26:33Z,187,112,299
NULL,44761,2017-09-21T20:42:35Z,0,0,0
B-RFC-approved;T-libs,44764,2017-09-21T20:50:02Z,86,0,86
NULL,44765,2017-09-22T02:25:47Z,24,28,52
A-associated-items;A-traits;A-typesystem;B-RFC-approved;B-unstable;C-tracking-issue;T-lang,44766,2017-09-22T02:28:11Z,107,125,232
"S-waiting-on-review,S-waiting-on-review",44772,2017-09-22T12:20:21Z,662,535,1197
NULL,44775,2017-09-22T18:30:47Z,42,61,103
"A-docs,A-docs",44778,2017-09-22T22:47:38Z,120,13,133
NULL,44779,2017-09-22T23:45:04Z,72,1,73
"A-libs,A-libs,A-libs",44780,2017-09-23T01:40:43Z,0,0,0
"A-attributes;A-rustdoc;C-tracking-issue;T-dev-tools;T-doc;WG-docs-rustdoc,A-attributes;A-rustdoc;C-tracking-issue;T-dev-tools;T-doc;WG-docs-rustdoc,A-attributes;A-rustdoc;C-tracking-issue;T-dev-tools;T-doc;WG-docs-rustdoc",44781,2017-09-23T01:59:57Z,486,29,515
NULL,44782,2017-09-23T02:21:23Z,102,20,122
"S-waiting-on-bors,S-waiting-on-author,S-waiting-on-bors,S-waiting-on-bors,S-waiting-on-author,S-waiting-on-bors,S-waiting-on-bors,S-waiting-on-author,S-waiting-on-bors,S-waiting-on-bors,S-waiting-on-bors,S-waiting-on-bors,S-waiting-on-bors,S-waiting-on-bors,S-waiting-on-author,S-waiting-on-bors",44784,2017-09-23T04:29:24Z,309,58,367
NULL,44786,2017-09-23T10:55:56Z,43,5,48
NULL,44790,2017-09-23T16:09:49Z,26,2,28
"S-waiting-on-review,S-waiting-on-bors,S-waiting-on-review,S-waiting-on-bors",44791,2017-09-23T16:56:10Z,0,0,0
"A-rustbuild;WG-infra-rustbuild,A-rustbuild;WG-infra-rustbuild,A-rustbuild;WG-infra-rustbuild,A-rustbuild;WG-infra-rustbuild,A-rustbuild;WG-infra-rustbuild",44792,2017-09-23T17:13:07Z,132,79,211
NULL,44795,2017-09-23T18:54:42Z,19,11,30
"A-docs,A-docs,A-docs,A-docs",44797,2017-09-23T19:33:12Z,0,0,0
"C-bug;I-nominated;T-libs,C-bug;I-nominated;T-libs",44802,2017-09-24T04:21:23Z,26,1,27
NULL,44806,2017-09-24T11:02:46Z,42,11,53
NULL,44807,2017-09-24T12:01:53Z,96,32,128
"regression-from-stable-to-beta;T-compiler,regression-from-stable-to-beta;T-compiler",44809,2017-09-24T14:33:58Z,157,50,207
NULL,44811,2017-09-24T14:49:57Z,162,40,202
"A-rustbuild,A-rustbuild",44812,2017-09-24T14:51:36Z,5,0,5
NULL,44813,2017-09-24T16:38:35Z,0,0,0
NULL,44818,2017-09-24T22:46:53Z,182,37,219
"S-waiting-on-author,S-waiting-on-author,beta-nominated",44823,2017-09-25T06:08:43Z,118,201,319
"S-waiting-on-author,S-waiting-on-author",44824,2017-09-25T06:09:58Z,0,0,0
NULL,44825,2017-09-25T07:06:38Z,1,1,2
"T-compiler,T-compiler",44845,2017-09-25T18:10:43Z,0,0,0
NULL,44847,2017-09-25T19:05:38Z,102,16,118
"A-associated-items;A-traits;A-typesystem;B-RFC-approved;B-unstable;C-tracking-issue;T-lang,S-waiting-on-author,A-associated-items;A-traits;A-typesystem;B-RFC-approved;B-unstable;C-tracking-issue;T-lang,S-waiting-on-author",44852,2017-09-25T22:27:04Z,0,0,0
NULL,44853,2017-09-25T22:57:31Z,97,48,145
"A-docs,A-docs",44854,2017-09-25T23:43:39Z,0,0,0
"A-docs,A-docs",44855,2017-09-26T02:20:04Z,442,67,509
"B-RFC-approved;T-lang,B-RFC-approved;T-lang,B-RFC-approved;T-lang",44857,2017-09-26T04:50:55Z,113,1,114
NULL,44860,2017-09-26T08:51:11Z,68,1,69
"E-needs-mentor;T-compiler;WG-compiler-traits,E-needs-mentor;T-compiler;WG-compiler-traits",44866,2017-09-26T16:50:16Z,102,2,104
"WG-compiler-nll,WG-compiler-nll",44878,2017-09-27T02:29:08Z,62,59,121
NULL,44881,2017-09-27T06:22:09Z,0,0,0
NULL,44882,2017-09-27T07:24:49Z,150,136,286
"I-crash;P-high;T-compiler;T-lang,I-crash;P-high;T-compiler;T-lang,I-crash;P-high;T-compiler;T-lang,I-crash;P-high;T-compiler;T-lang,I-crash;P-high;T-compiler;T-lang,I-crash;P-high;T-compiler;T-lang,I-crash;P-high;T-compiler;T-lang,I-crash;P-high;T-compiler;T-lang,I-crash;P-high;T-compiler;T-lang,I-crash;P-high;T-compiler;T-lang,I-crash;P-high;T-compiler;T-lang,I-crash;P-high;T-compiler;T-lang",44884,2017-09-27T11:35:20Z,1026,232,1258
NULL,44888,2017-09-27T16:13:18Z,1180,807,1987
NULL,44890,2017-09-27T19:00:38Z,32,31,63
NULL,44892,2017-09-27T20:57:16Z,25,5,30
NULL,44893,2017-09-27T22:05:57Z,0,0,0
"T-libs,T-libs",44895,2017-09-28T03:01:11Z,22,7,29
"A-codegen;A-mir;T-compiler,A-codegen;A-mir;T-compiler",44896,2017-09-28T03:28:45Z,273,136,409
"A-incr-comp;metabug;T-compiler,A-incr-comp;metabug;T-compiler",44901,2017-09-28T14:48:02Z,1088,2371,3459
"A-docs,A-docs",44905,2017-09-28T17:39:27Z,13,2,15
"B-unstable;T-lang,B-unstable;T-lang",44906,2017-09-28T20:16:16Z,153,6,159
beta-nominated;T-compiler,44907,2017-09-28T20:34:51Z,0,0,0
"beta-nominated;T-compiler,beta-nominated,beta-nominated;T-compiler",44908,2017-09-28T20:35:44Z,653,175,828
B-RFC-approved;T-libs,44916,2017-09-29T05:42:25Z,0,0,0
"S-waiting-on-author,S-waiting-on-author",44918,2017-09-29T08:45:43Z,74,32,106
NULL,44920,2017-09-29T11:33:31Z,61,15,76
NULL,44922,2017-09-29T14:15:45Z,84,48,132
"S-waiting-on-author,beta-nominated,S-waiting-on-author,beta-nominated",44936,2017-09-29T23:59:06Z,0,0,0
"A-debuginfo;A-metadata;B-unstable;T-compiler;T-tools,A-debuginfo;A-metadata;B-unstable;T-compiler;T-tools",44940,2017-09-30T06:50:38Z,59,12,71
A-associated-items;I-wrong,44943,2017-09-30T09:50:10Z,84,53,137
NULL,44945,2017-09-30T13:03:11Z,23,14,37
NULL,44949,2017-09-30T20:38:51Z,21,0,21
NULL,44959,2017-10-01T15:16:25Z,133,14,147
NULL,44963,2017-10-01T19:17:22Z,192,107,299
NULL,44965,2017-10-01T22:33:30Z,92,4,96
"A-lint,A-lint",44966,2017-10-02T00:21:19Z,24,1,25
"E-mentor;T-compiler;WG-compiler-incr;WG-compiler-traits,E-mentor;T-compiler;WG-compiler-incr;WG-compiler-traits",44967,2017-10-02T00:53:30Z,226,82,308
NULL,44969,2017-10-02T02:27:47Z,34,8,42
"A-diagnostics;A-parser,A-diagnostics;A-parser",44970,2017-10-02T05:30:04Z,0,0,0
regression-from-stable-to-nightly;T-doc;T-infra,44977,2017-10-02T14:17:19Z,18,18,36
"E-easy,E-easy;I-cleanup,E-easy,E-easy;I-cleanup",44978,2017-10-02T15:03:04Z,6,2,8
"E-mentor;T-compiler;WG-compiler-incr;WG-compiler-traits,E-mentor;T-compiler;WG-compiler-incr;WG-compiler-traits",44984,2017-10-02T18:29:08Z,37,39,76
NULL,44985,2017-10-02T18:40:36Z,439,35,474
NULL,44987,2017-10-02T20:43:54Z,5,5,10
NULL,44989,2017-10-02T23:40:12Z,57,1,58
"A-rustdoc;I-completion;P-low,A-rustdoc;I-completion;P-low,A-rustdoc;I-completion;P-low,A-rustdoc;I-completion;P-low",44994,2017-10-03T09:34:16Z,0,0,0
NULL,44999,2017-10-03T12:06:38Z,38,10,48
"C-bug;E-easy;E-mentor;I-slow;T-libs,C-bug;E-easy;E-mentor;I-slow;T-libs",45007,2017-10-03T17:08:58Z,114,72,186
NULL,45013,2017-10-04T05:37:36Z,168,102,270
NULL,45016,2017-10-04T11:37:53Z,557,379,936
NULL,45018,2017-10-04T13:00:32Z,37,37,74
NULL,45019,2017-10-04T13:08:58Z,6,13,19
"A-diagnostics,I-ICE;T-compiler,I-ICE;T-compiler,A-diagnostics",45020,2017-10-04T13:14:28Z,119,0,119
NULL,45025,2017-10-04T16:01:51Z,276,17,293
NULL,45031,2017-10-04T21:55:57Z,50,3,53
NULL,45032,2017-10-04T21:57:30Z,56,50,106
NULL,45039,2017-10-05T03:14:29Z,345,14,359
NULL,45041,2017-10-05T03:43:58Z,8,295,303
"A-docs,A-docs",45042,2017-10-05T04:16:29Z,8,8,16
S-waiting-on-review,45046,2017-10-05T12:22:39Z,74,24,98
NULL,45047,2017-10-05T15:02:46Z,323,35,358
"A-testsuite;C-enhancement;E-easy;E-mentor;WG-infra-rustbuild,A-testsuite;C-enhancement;E-easy;E-mentor;WG-infra-rustbuild",45051,2017-10-05T20:55:45Z,47,29,76
NULL,45052,2017-10-05T20:56:29Z,5,3,8
NULL,45054,2017-10-05T21:24:35Z,1,1,2
NULL,45059,2017-10-06T05:50:34Z,31,0,31
NULL,45064,2017-10-06T14:07:14Z,16,2,18
NULL,45065,2017-10-06T14:28:17Z,1,1,2
NULL,45069,2017-10-06T16:14:59Z,209,52,261
NULL,45072,2017-10-06T19:37:51Z,838,169,1007
NULL,45074,2017-10-06T22:40:47Z,0,0,0
NULL,45075,2017-10-06T23:05:07Z,202,83,285
NULL,45079,2017-10-07T08:53:07Z,0,0,0
NULL,45080,2017-10-07T09:04:13Z,9,4,13
"A-diagnostics,A-diagnostics",45082,2017-10-07T12:42:41Z,57,9,66
NULL,45083,2017-10-07T13:19:22Z,8,0,8
relnotes,45090,2017-10-07T16:42:44Z,0,0,0
NULL,45091,2017-10-07T17:42:31Z,1,1,2
NULL,45094,2017-10-07T18:58:00Z,5,5,10
NULL,45097,2017-10-07T21:35:55Z,15,72,87
"S-waiting-on-author,S-waiting-on-author",45098,2017-10-08T01:58:05Z,110,0,110
"E-needs-mentor,E-needs-mentor",45099,2017-10-08T04:00:18Z,2,2,4
NULL,45100,2017-10-08T05:39:08Z,90,68,158
NULL,45101,2017-10-08T08:45:58Z,1,1,2
NULL,45102,2017-10-08T09:11:29Z,9,65,74
NULL,45104,2017-10-08T15:32:49Z,786,475,1261
"A-docs,A-docs",45106,2017-10-08T16:14:59Z,108,1,109
NULL,45108,2017-10-08T16:21:41Z,2,2,4
NULL,45111,2017-10-08T21:03:00Z,10,6,16
A-docs,45112,2017-10-08T21:13:02Z,0,0,0
"A-docs,A-docs",45113,2017-10-08T21:17:40Z,9,0,9
NULL,45122,2017-10-09T00:17:23Z,7,1,8
NULL,45123,2017-10-09T01:18:02Z,117,24,141
NULL,45125,2017-10-09T02:11:08Z,271,186,457
NULL,45135,2017-10-09T13:43:11Z,1,2,3
S-waiting-on-review,45141,2017-10-09T16:16:29Z,438,226,664
NULL,45146,2017-10-09T17:21:57Z,74,5,79
NULL,45147,2017-10-09T17:39:09Z,0,0,0
"A-incr-comp;A-testsuite;E-mentor;WG-compiler-incr,A-incr-comp;A-testsuite;E-mentor;WG-compiler-incr",45148,2017-10-09T18:07:42Z,160,0,160
"A-docs,A-docs",45151,2017-10-09T18:55:19Z,18,0,18
"E-easy;E-mentor;T-compiler;WG-compiler-nll,E-easy;E-mentor;T-compiler;WG-compiler-nll",45162,2017-10-10T03:24:18Z,398,105,503
"S-waiting-on-review,S-waiting-on-review,S-waiting-on-review,S-waiting-on-review",45169,2017-10-10T12:08:30Z,142,77,219
NULL,45170,2017-10-10T12:26:17Z,1,1,2
"A-diagnostics;E-mentor,A-diagnostics;E-mentor",45173,2017-10-10T14:51:51Z,72,10,82
"B-RFC-approved;C-tracking-issue;E-needs-mentor;T-lang;WG-compiler-front,B-RFC-approved;C-tracking-issue;E-needs-mentor;T-lang;WG-compiler-front",45175,2017-10-10T15:11:02Z,150,42,192
NULL,45176,2017-10-10T15:14:34Z,23,3,26
NULL,45178,2017-10-10T16:46:36Z,56,0,56
NULL,45189,2017-10-10T22:56:21Z,25,41,66
NULL,45190,2017-10-10T23:39:33Z,9,9,18
NULL,45191,2017-10-10T23:50:41Z,213,125,338
NULL,45192,2017-10-11T00:22:31Z,229,20,249
NULL,45198,2017-10-11T09:01:07Z,62,0,62
"C-cleanup;E-mentor;T-compiler;WG-compiler-nll,C-cleanup;E-mentor;T-compiler;WG-compiler-nll",45200,2017-10-11T14:49:10Z,49,5,54
"A-codegen;regression-from-stable-to-beta,A-codegen;regression-from-stable-to-beta",45202,2017-10-11T15:54:43Z,58,9,67
NULL,45203,2017-10-11T16:15:46Z,1,1,2
NULL,45204,2017-10-11T16:22:50Z,0,0,0
"I-wrong;P-high,I-wrong;P-high,I-wrong;P-high,I-wrong;P-high,I-wrong;P-high,I-wrong;P-high,I-wrong;P-high,I-wrong;P-high",45205,2017-10-11T16:30:19Z,535,16,551
NULL,45207,2017-10-11T17:17:07Z,0,0,0
NULL,45209,2017-10-11T17:32:49Z,37,20,57
"A-codegen;A-LLVM,A-codegen;A-LLVM",45215,2017-10-11T18:34:54Z,67,10,77
"A-diagnostics,A-diagnostics",45221,2017-10-11T21:40:58Z,45,1,46
"B-unstable;T-compiler,B-unstable;T-compiler",45223,2017-10-12T00:15:59Z,0,0,0
"A-codegen;A-unicode;I-enhancement;I-slow,I-slow,A-codegen;A-unicode;I-enhancement;I-slow",45225,2017-10-12T02:34:06Z,4986,5624,10610
NULL,45227,2017-10-12T02:37:24Z,66,7,73
"E-mentor;T-compiler;WG-compiler-incr,E-mentor;T-compiler;WG-compiler-incr",45228,2017-10-12T03:29:11Z,47,1,48
NULL,45232,2017-10-12T07:50:28Z,141,36,177
NULL,45233,2017-10-12T08:14:32Z,240,73,313
"A-incr-comp,A-incr-comp",45237,2017-10-12T15:14:24Z,0,0,0
NULL,45245,2017-10-12T21:01:55Z,1,1,2
"A-traits;A-typesystem;B-RFC-approved;P-backcompat-lang,A-traits;A-typesystem;B-RFC-approved;P-backcompat-lang",45247,2017-10-12T22:34:02Z,494,216,710
S-waiting-on-review,45261,2017-10-13T15:38:06Z,819,180,999
NULL,45269,2017-10-14T02:26:46Z,24,4,28
NULL,45272,2017-10-14T05:42:47Z,0,0,0
NULL,45281,2017-10-14T14:32:17Z,23,5,28
NULL,45282,2017-10-14T14:40:24Z,0,0,0
"A-incr-comp;E-medium;E-mentor;T-compiler,A-incr-comp;E-medium;E-mentor;T-compiler",45283,2017-10-14T15:05:08Z,220,124,344
"S-waiting-on-review,S-waiting-on-review",45288,2017-10-14T16:04:38Z,57,22,79
NULL,45290,2017-10-14T16:43:32Z,18,7,25
"beta-nominated;S-waiting-on-review;T-libs,S-waiting-on-review,S-waiting-on-review,S-waiting-on-review,S-waiting-on-review,beta-nominated;S-waiting-on-review;T-libs,S-waiting-on-review,S-waiting-on-review",45291,2017-10-14T19:21:46Z,0,0,0
"B-unstable,B-RFC-approved;C-tracking-issue;E-needs-mentor;T-lang;WG-compiler-front,B-unstable,B-RFC-approved;C-tracking-issue;E-needs-mentor;T-lang;WG-compiler-front,B-unstable,B-RFC-approved;C-tracking-issue;E-needs-mentor;T-lang;WG-compiler-front,B-unstable,B-RFC-approved;C-tracking-issue;E-needs-mentor;T-lang;WG-compiler-front",45294,2017-10-15T00:45:29Z,154,12,166
"A-docs,A-docs",45295,2017-10-15T02:28:13Z,72,11,83
NULL,45297,2017-10-15T05:05:39Z,127,25,152
"B-RFC-approved;T-lang,B-RFC-approved;T-lang",45298,2017-10-15T05:19:32Z,1415,21,1436
"S-waiting-on-review,beta-nominated;S-waiting-on-review;T-libs,S-waiting-on-review,S-waiting-on-review",45299,2017-10-15T06:22:00Z,108,41,149
NULL,45305,2017-10-15T12:53:02Z,19,15,34
"B-unstable;E-easy;T-libs,B-unstable;E-easy;T-libs",45306,2017-10-15T13:31:55Z,19,0,19
"T-compiler,T-compiler",45311,2017-10-15T19:02:17Z,186,0,186
NULL,45312,2017-10-15T19:38:35Z,44,49,93
NULL,45315,2017-10-16T02:43:17Z,28,2,30
NULL,45316,2017-10-16T04:20:59Z,32,1,33
A-incr-comp,45319,2017-10-16T12:51:02Z,591,83,674
NULL,45326,2017-10-16T20:15:03Z,20,19,39
NULL,45337,2017-10-17T05:22:04Z,1116,228,1344
NULL,45338,2017-10-17T06:02:47Z,2,1,3
"B-unstable;E-easy;T-libs,B-unstable;E-easy;T-libs",45340,2017-10-17T09:05:00Z,4,1,5
NULL,45343,2017-10-17T14:02:44Z,14,14,28
NULL,45344,2017-10-17T14:21:06Z,83,91,174
"A-codegen;O-windows-msvc,A-windows,A-codegen;O-windows-msvc,A-windows",45348,2017-10-18T00:33:23Z,115,50,165
"E-easy;E-mentor;P-medium;T-doc,E-easy;E-mentor;P-medium;T-doc",45349,2017-10-18T01:24:22Z,3,1,4
"E-mentor;T-compiler;WG-compiler-incr,E-mentor;T-compiler;WG-compiler-incr",45350,2017-10-18T01:26:28Z,28,10,38
"A-asmjs;A-LLVM,A-asmjs;A-LLVM",45352,2017-10-18T01:50:58Z,60,61,121
"A-incr-comp;E-mentor;WG-compiler-incr,A-incr-comp;E-mentor;WG-compiler-incr",45353,2017-10-18T03:24:44Z,94,17,111
NULL,45359,2017-10-18T11:13:46Z,127,55,182
NULL,45366,2017-10-18T17:34:10Z,3,5,8
"S-waiting-on-review,S-waiting-on-review",45368,2017-10-18T17:59:55Z,401,124,525
NULL,45369,2017-10-18T18:47:18Z,25,0,25
NULL,45370,2017-10-18T18:47:29Z,10,46,56
"A-associated-items;I-wrong,A-associated-items;I-wrong",45378,2017-10-19T05:29:10Z,0,0,0
"C-cleanup;E-mentor;T-compiler;WG-compiler-nll,C-cleanup;E-mentor;T-compiler;WG-compiler-nll",45384,2017-10-19T14:51:36Z,447,48,495
"S-waiting-on-review,beta-nominated;S-waiting-on-review,S-waiting-on-review,S-waiting-on-review",45386,2017-10-19T15:13:35Z,88,87,175
"A-spurious,A-spurious",45393,2017-10-19T20:27:51Z,3,3,6
NULL,45394,2017-10-19T20:53:29Z,769,9,778
"A-codegen;C-tracking-issue,A-codegen;C-tracking-issue",45400,2017-10-20T03:05:20Z,21,6,27
"E-mentor;T-compiler;WG-compiler-front,E-mentor;T-compiler;WG-compiler-front",45401,2017-10-20T05:09:04Z,99,12,111
NULL,45404,2017-10-20T07:30:58Z,117,703,820
"B-RFC-approved;T-lang,E-mentor;T-compiler;WG-compiler-errors,B-RFC-approved;T-lang,E-mentor;T-compiler;WG-compiler-errors",45409,2017-10-20T13:04:34Z,74,21,95
NULL,45413,2017-10-20T14:55:47Z,24,4,28
"P-high;T-doc,P-high;T-doc",45421,2017-10-20T20:13:52Z,5,20,25
NULL,45422,2017-10-20T21:38:39Z,0,0,0
NULL,45429,2017-10-21T13:21:34Z,81,13,94
S-waiting-on-review,45430,2017-10-21T13:47:26Z,260,37,297
NULL,45432,2017-10-21T15:59:42Z,5,5,10
NULL,45435,2017-10-21T17:19:40Z,156,74,230
NULL,45436,2017-10-21T19:17:17Z,260,25,285
NULL,45442,2017-10-22T10:07:18Z,22,1,23
beta-nominated;S-waiting-on-review,45443,2017-10-22T10:53:29Z,14,14,28
NULL,45446,2017-10-22T12:40:41Z,1,97,98
NULL,45449,2017-10-22T13:28:22Z,33,4,37
NULL,45450,2017-10-22T14:09:42Z,11,1,12
NULL,45452,2017-10-22T17:24:28Z,121,76,197
"A-diagnostics;A-typesystem,A-diagnostics,A-diagnostics;P-high,A-diagnostics;P-high,A-diagnostics;A-typesystem,A-diagnostics",45455,2017-10-22T20:36:32Z,428,2,430
NULL,45464,2017-10-23T08:44:18Z,82,2,84
NULL,45465,2017-10-23T09:47:11Z,1,0,1
NULL,45472,2017-10-23T15:04:33Z,707,150,857
"E-mentor;T-compiler;WG-compiler-incr,E-mentor;T-compiler;WG-compiler-incr",45473,2017-10-23T15:48:55Z,11,50,61
NULL,45476,2017-10-23T18:29:52Z,94,65,159
NULL,45482,2017-10-23T21:01:27Z,0,0,0
NULL,45496,2017-10-24T16:34:51Z,12,4,16
NULL,45502,2017-10-24T20:36:32Z,6,2,8
NULL,45503,2017-10-24T20:46:18Z,55,4,59
"A-ARM,A-ARM",45508,2017-10-24T22:57:53Z,1,0,1
S-waiting-on-review,45513,2017-10-25T07:48:13Z,257,3,260
"regression-from-stable-to-nightly;T-compiler,regression-from-stable-to-nightly;T-compiler",45522,2017-10-25T14:52:05Z,16,24,40
NULL,45523,2017-10-25T14:55:30Z,1,1,2
NULL,45525,2017-10-25T16:08:01Z,372,438,810
NULL,45526,2017-10-25T16:59:37Z,1,1,2
"A-codegen;C-tracking-issue,A-codegen;C-tracking-issue",45529,2017-10-25T18:11:56Z,0,0,0
"S-waiting-on-review,S-waiting-on-review",45532,2017-10-25T19:02:55Z,101,32,133
NULL,45540,2017-10-26T00:02:56Z,36,7,43
NULL,45545,2017-10-26T04:59:07Z,211,58,269
NULL,45548,2017-10-26T12:34:36Z,2,1,3
NULL,45550,2017-10-26T13:52:43Z,1,1,2
"A-incr-comp;I-unsound,A-incr-comp;I-unsound",45551,2017-10-26T14:36:04Z,111,50,161
"C-bug;T-doc,C-bug;T-doc",45554,2017-10-26T18:50:50Z,1,1,2
"C-bug;T-doc,C-bug;T-doc",45555,2017-10-26T18:59:16Z,1,1,2
"A-ARM,A-ARM",45559,2017-10-26T20:45:05Z,1,0,1
"E-needs-mentor;T-compiler;WG-compiler-front,E-mentor;T-compiler;WG-compiler-front,E-needs-mentor;T-compiler;WG-compiler-front,E-mentor;T-compiler;WG-compiler-front",45569,2017-10-27T05:57:18Z,469,0,469
NULL,45571,2017-10-27T06:13:18Z,85,76,161
NULL,45575,2017-10-27T12:37:00Z,520,407,927
"S-waiting-on-review,S-waiting-on-review",45577,2017-10-27T15:36:57Z,0,0,0
NULL,45585,2017-10-28T02:50:50Z,0,10,10
S-waiting-on-review,45586,2017-10-28T03:34:23Z,0,0,0
S-waiting-on-review,45589,2017-10-28T07:56:26Z,54,42,96
NULL,45595,2017-10-28T15:25:12Z,929,182,1111
NULL,45602,2017-10-28T23:54:49Z,58,30,88
NULL,45603,2017-10-29T01:21:52Z,47,9,56
S-waiting-on-author,45611,2017-10-29T09:28:40Z,36,3,39
NULL,45616,2017-10-29T14:43:33Z,9,9,18
NULL,45617,2017-10-29T17:23:05Z,112,42,154
NULL,45618,2017-10-29T17:35:35Z,1,1,2
"A-rustdoc;T-dev-tools-rustdoc;T-doc,A-rustdoc;T-dev-tools-rustdoc;T-doc",45620,2017-10-29T18:30:01Z,29,4,33
NULL,45630,2017-10-30T08:29:02Z,70,13,83
NULL,45635,2017-10-30T17:54:49Z,39,0,39
NULL,45639,2017-10-30T22:51:12Z,30,1,31
NULL,45645,2017-10-31T01:03:58Z,14,13,27
NULL,45646,2017-10-31T03:01:12Z,24,6,30
NULL,45650,2017-10-31T13:04:02Z,13,3,16
NULL,45652,2017-10-31T13:44:25Z,4,2,6
NULL,45655,2017-10-31T14:01:49Z,8,6,14
S-waiting-on-author,45656,2017-10-31T14:19:07Z,97,52,149
NULL,45660,2017-10-31T17:53:41Z,61,3,64
"A-codegen;C-tracking-issue,A-codegen;C-tracking-issue",45661,2017-10-31T17:56:17Z,0,0,0
NULL,45668,2017-10-31T19:57:15Z,660,222,882
"S-waiting-on-review,S-waiting-on-review",45673,2017-10-31T22:28:50Z,307,131,438
"S-waiting-on-review,S-waiting-on-review,S-waiting-on-review,S-waiting-on-review",45674,2017-11-01T05:32:22Z,221,61,282
NULL,45677,2017-11-01T11:23:20Z,0,0,0
NULL,45679,2017-11-01T12:08:26Z,0,0,0
"A-docs;B-RFC-approved;T-doc,A-docs;B-RFC-approved;T-doc",45692,2017-11-01T19:25:49Z,48,45,93
"B-RFC-approved;T-lang,A-traits;E-mentor;T-compiler;WG-compiler-traits,B-RFC-approved;T-lang,A-traits;E-mentor;T-compiler;WG-compiler-traits,B-unstable",45701,2017-11-01T21:43:23Z,885,134,1019
"A-diagnostics;A-unicode;I-wrong,A-diagnostics;A-unicode;I-wrong,A-diagnostics;A-unicode;I-wrong,A-diagnostics;A-unicode;I-wrong",45711,2017-11-02T03:59:11Z,231,16,247
NULL,45715,2017-11-02T10:27:31Z,16,8,24
NULL,45723,2017-11-02T13:50:11Z,81,1,82
NULL,45735,2017-11-03T08:14:06Z,111,23,134
NULL,45736,2017-11-03T08:32:09Z,19,15,34
NULL,45739,2017-11-03T14:45:45Z,2,2,4
S-waiting-on-review,45741,2017-11-03T15:40:09Z,112,122,234
"S-waiting-on-review,S-waiting-on-review",45744,2017-11-03T17:24:16Z,1,1,2
NULL,45747,2017-11-03T19:38:59Z,0,0,0
NULL,45748,2017-11-03T20:39:11Z,18,4,22
"S-waiting-on-author,S-waiting-on-author",45751,2017-11-04T00:36:18Z,95,42,137
NULL,45752,2017-11-04T02:03:43Z,59,17,76
NULL,45754,2017-11-04T04:51:36Z,63,1,64
"S-waiting-on-review;T-libs,S-waiting-on-review",45755,2017-11-04T05:49:34Z,98,10,108
NULL,45758,2017-11-04T13:56:35Z,5,3,8
NULL,45760,2017-11-04T15:13:20Z,0,0,0
NULL,45764,2017-11-04T19:18:15Z,16,8,24
"A-rustdoc;T-doc,A-rustdoc;T-doc",45766,2017-11-04T19:54:48Z,198,31,229
NULL,45767,2017-11-04T20:01:11Z,28,6,34
NULL,45770,2017-11-04T22:27:13Z,35,60,95
"E-needs-mentor;T-compiler;WG-compiler-front,E-needs-mentor;T-compiler;WG-compiler-front",45771,2017-11-04T22:58:45Z,187,49,236
"B-RFC-approved,B-RFC-approved",45773,2017-11-05T00:04:23Z,69,29,98
B-RFC-approved;T-lang,45775,2017-11-05T01:27:52Z,64,49,113
NULL,45776,2017-11-05T01:34:01Z,0,0,0
"S-waiting-on-review,S-waiting-on-review",45783,2017-11-05T15:24:59Z,394,28,422
NULL,45806,2017-11-06T15:50:46Z,2,3,5
"A-diagnostics;T-compiler,A-diagnostics;T-compiler",45807,2017-11-06T16:34:49Z,105,44,149
NULL,45812,2017-11-06T20:15:51Z,31,3,34
"A-rustdoc,A-rustdoc",45815,2017-11-06T21:17:17Z,7,7,14
"S-waiting-on-review,S-waiting-on-review",45818,2017-11-07T02:21:58Z,0,0,0
NULL,45820,2017-11-07T03:05:59Z,0,0,0
"S-waiting-on-review,S-waiting-on-review",45822,2017-11-07T07:52:17Z,479,74,553
NULL,45824,2017-11-07T08:57:22Z,36,2,38
NULL,45828,2017-11-07T11:34:09Z,0,21,21
"B-RFC-approved;T-lang,B-RFC-approved;T-lang",45846,2017-11-07T20:52:06Z,949,578,1527
NULL,45849,2017-11-07T21:46:11Z,4,2,6
"C-tracking-issue;T-compiler,C-tracking-issue;T-compiler",45853,2017-11-07T22:43:10Z,232,226,458
NULL,45856,2017-11-08T02:04:57Z,74,8,82
S-waiting-on-review,45862,2017-11-08T09:09:19Z,276,37,313
"S-waiting-on-author,B-unstable;C-tracking-issue;T-libs,S-waiting-on-author",45863,2017-11-08T09:31:28Z,39,0,39
"A-const-fn;A-typesystem;I-wrong;P-medium;T-compiler,A-const-fn;A-typesystem;I-wrong;P-medium;T-compiler",45864,2017-11-08T10:30:06Z,87,61,148
NULL,45866,2017-11-08T10:31:45Z,46,0,46
"E-needs-mentor,A-docs,E-needs-mentor,A-docs",45870,2017-11-08T14:26:13Z,349,113,462
NULL,45877,2017-11-08T19:05:54Z,301,28,329
NULL,45879,2017-11-08T22:36:46Z,1004,782,1786
NULL,45880,2017-11-08T22:47:48Z,63,12,75
NULL,45882,2017-11-08T23:24:50Z,1,0,1
"S-waiting-on-crater,S-waiting-on-crater",45890,2017-11-09T18:24:35Z,56,9,65
"S-waiting-on-review,S-waiting-on-review",45892,2017-11-09T20:06:44Z,4,4,8
"S-waiting-on-review,S-waiting-on-review,S-waiting-on-review,S-waiting-on-review",45893,2017-11-09T20:09:35Z,38,22,60
NULL,45898,2017-11-09T22:22:04Z,6,6,12
NULL,45899,2017-11-09T23:33:13Z,35,18,53
NULL,45900,2017-11-09T23:33:49Z,64,45,109
"A-associated-items;A-traits;A-typesystem;B-RFC-approved;B-unstable;C-tracking-issue;T-lang,A-associated-items;A-traits;A-typesystem;B-RFC-approved;B-unstable;C-tracking-issue;T-lang",45904,2017-11-10T04:08:52Z,486,80,566
NULL,45906,2017-11-10T09:03:41Z,0,0,0
"S-waiting-on-review;T-libs,S-waiting-on-review;T-libs,S-waiting-on-author",45907,2017-11-10T09:07:13Z,563,64,627
NULL,45908,2017-11-10T09:40:38Z,1,0,1
NULL,45909,2017-11-10T11:53:28Z,71,5,76
"A-mir;C-bug;T-compiler,A-mir;C-bug;T-compiler",45913,2017-11-10T14:26:40Z,113,29,142
"S-waiting-on-review,S-waiting-on-review",45915,2017-11-10T16:53:03Z,60,5,65
"T-compiler,T-compiler",45916,2017-11-10T18:05:33Z,343,516,859
"B-unstable,E-needs-mentor;T-compiler;WG-compiler-traits,B-unstable,E-needs-mentor;T-compiler;WG-compiler-traits",45918,2017-11-10T18:58:42Z,1146,325,1471
"A-llvm;I-nominated;I-wrong;T-compiler,A-llvm;I-nominated;I-wrong;T-compiler",45920,2017-11-10T20:00:30Z,33,5,38
"A-borrow-checker;I-ICE;WG-compiler-nll,A-borrow-checker;I-ICE;WG-compiler-nll",45922,2017-11-10T21:24:14Z,44,14,58
NULL,45927,2017-11-11T09:32:58Z,303,9,312
NULL,45928,2017-11-11T09:51:26Z,0,0,0
S-waiting-on-review,45931,2017-11-11T12:24:11Z,0,0,0
"S-waiting-on-review,S-waiting-on-review",45932,2017-11-11T12:38:10Z,373,34,407
"A-borrow-checker;WG-compiler-nll,A-borrow-checker;WG-compiler-nll",45936,2017-11-11T18:38:18Z,57,28,85
"A-incr-comp;A-testsuite;E-mentor;WG-compiler-incr,A-incr-comp;A-testsuite;E-mentor;WG-compiler-incr",45941,2017-11-12T10:29:10Z,47,60,107
NULL,45942,2017-11-12T12:21:48Z,141,0,141
B-RFC-approved;T-lang,45947,2017-11-12T22:19:39Z,53,4,57
NULL,45948,2017-11-12T23:24:50Z,48,2,50
"A-incr-comp;A-testsuite;E-mentor;WG-compiler-incr,A-incr-comp;A-testsuite;E-mentor;WG-compiler-incr",45950,2017-11-13T00:14:31Z,56,112,168
"A-incr-comp;A-testsuite;E-mentor;WG-compiler-incr,A-incr-comp;A-testsuite;E-mentor;WG-compiler-incr",45951,2017-11-13T00:52:16Z,75,145,220
NULL,45952,2017-11-13T03:36:53Z,54,9,63
NULL,45953,2017-11-13T06:09:50Z,37,17,54
"S-waiting-on-review,S-waiting-on-review,S-waiting-on-review,S-waiting-on-review,S-waiting-on-review,S-waiting-on-review,S-waiting-on-review,S-waiting-on-review,S-waiting-on-review,S-waiting-on-bors",45956,2017-11-13T09:09:49Z,420,84,504
"WG-compiler-nll,WG-compiler-nll",45967,2017-11-13T19:49:40Z,14,12,26
"S-waiting-on-review,S-waiting-on-review,S-waiting-on-review,S-waiting-on-review,S-waiting-on-review,S-waiting-on-review,S-waiting-on-review",45981,2017-11-14T11:37:46Z,175,239,414
NULL,45984,2017-11-14T14:03:04Z,32,36,68
"beta-nominated;S-waiting-on-review,beta-nominated",45986,2017-11-14T14:40:08Z,338,93,431
"A-incr-comp;A-testsuite;E-mentor;WG-compiler-incr,A-incr-comp;A-testsuite;E-mentor;WG-compiler-incr",45987,2017-11-14T15:32:52Z,36,210,246
"A-borrow-checker;A-diagnostics;C-bug;E-needs-mentor;T-compiler;WG-compiler-nll,A-borrow-checker;A-diagnostics;C-bug;E-needs-mentor;T-compiler;WG-compiler-nll",45989,2017-11-14T19:47:41Z,119,25,144
NULL,45990,2017-11-14T20:22:21Z,283,0,283
NULL,45996,2017-11-15T01:47:58Z,36,23,59
NULL,45997,2017-11-15T01:50:26Z,267,21,288
NULL,45998,2017-11-15T04:31:42Z,11,16,27
"A-macros-2.0,A-macros-2.0",45999,2017-11-15T05:47:53Z,8,7,15
B-RFC-approved;T-lang,46000,2017-11-15T10:21:57Z,67,3,70
"A-diagnostics;I-nominated;T-compiler,A-diagnostics;I-nominated;T-compiler",46005,2017-11-15T15:14:16Z,10,3,13
NULL,46008,2017-11-15T17:07:57Z,57,7,64
NULL,46009,2017-11-15T17:15:06Z,8,8,16
NULL,46011,2017-11-15T18:32:20Z,100,47,147
NULL,46012,2017-11-15T20:10:30Z,86,76,162
"E-needs-mentor;T-compiler;WG-compiler-nll,E-needs-mentor;T-compiler;WG-compiler-nll",46014,2017-11-15T21:12:36Z,0,0,0
"I-ICE;T-compiler;WG-compiler-nll,I-ICE;T-compiler;WG-compiler-nll",46022,2017-11-15T22:55:30Z,575,140,715
NULL,46024,2017-11-16T02:58:40Z,170,39,209
"S-waiting-on-review,S-waiting-on-review,S-waiting-on-review,S-waiting-on-review,S-waiting-on-review,S-waiting-on-review",46029,2017-11-16T09:05:08Z,144,190,334
"A-borrow-checker;WG-compiler-nll,A-borrow-checker;WG-compiler-nll",46032,2017-11-16T10:57:39Z,108,44,152
NULL,46033,2017-11-16T12:57:32Z,109,29,138
"S-waiting-on-review,S-waiting-on-review",46039,2017-11-16T15:40:28Z,28,102,130
"A-diagnostics;T-compiler;WG-compiler-nll,A-diagnostics;T-compiler;WG-compiler-nll",46040,2017-11-16T16:27:59Z,40,44,84
NULL,46041,2017-11-16T16:45:58Z,232,79,311
NULL,46049,2017-11-16T22:17:18Z,0,0,0
"B-RFC-approved;T-lang,T-compiler;WG-compiler-middle",46051,2017-11-17T07:02:40Z,1088,140,1228
"T-compiler;WG-compiler-nll,E-needs-mentor;T-compiler;WG-compiler-nll,T-compiler;WG-compiler-nll,E-needs-mentor;T-compiler;WG-compiler-nll",46054,2017-11-17T09:58:56Z,169,37,206
NULL,46063,2017-11-17T19:19:46Z,0,0,0
beta-nominated;S-waiting-on-review,46065,2017-11-17T19:31:01Z,11,11,22
NULL,46066,2017-11-17T21:00:13Z,43,45,88
"A-incr-comp;C-enhancement;E-mentor;WG-compiler-incr,A-incr-comp;C-enhancement;E-mentor;WG-compiler-incr",46068,2017-11-17T23:04:35Z,18,0,18
C-cleanup;E-easy;E-mentor;T-compiler,46071,2017-11-18T04:28:02Z,19,32,51
S-waiting-on-review,46073,2017-11-18T11:15:25Z,115,107,222
"S-waiting-on-author;T-libs,S-waiting-on-author;T-libs",46074,2017-11-18T11:53:46Z,6,26,32
NULL,46077,2017-11-18T13:04:02Z,186,324,510
NULL,46078,2017-11-18T13:45:53Z,0,0,0
NULL,46081,2017-11-18T16:30:54Z,141,82,223
needs-crater;S-waiting-on-review,46083,2017-11-18T19:51:20Z,656,136,792
"A-diagnostics;WG-compiler-nll,A-diagnostics;WG-compiler-nll",46087,2017-11-18T22:34:57Z,59,13,72
NULL,46093,2017-11-19T05:58:23Z,536,0,536
NULL,46094,2017-11-19T08:43:43Z,55,15,70
"A-borrow-checker;I-unsound;WG-compiler-nll,A-borrow-checker;I-unsound;WG-compiler-nll",46100,2017-11-19T12:26:53Z,126,2,128
"A-build;T-dev-tools;T-infra;WG-infra-rustbuild,A-build;T-dev-tools;T-infra;WG-infra-rustbuild",46102,2017-11-19T18:17:51Z,14,5,19
NULL,46103,2017-11-19T18:27:13Z,23,18,41
"E-needs-mentor;T-compiler;WG-compiler-nll,E-needs-mentor;T-compiler;WG-compiler-nll",46106,2017-11-19T22:59:56Z,354,373,727
NULL,46108,2017-11-20T05:46:22Z,0,0,0
A-diagnostics;E-mentor;WG-compiler-errors,46116,2017-11-20T15:26:50Z,2220,2121,4341
"A-borrow-checker;A-diagnostics;E-easy;WG-compiler-nll,A-borrow-checker;A-diagnostics;E-easy;WG-compiler-nll",46119,2017-11-20T16:02:39Z,1,1,2
"A-libs,A-libs",46121,2017-11-20T16:43:55Z,2,2,4
NULL,46124,2017-11-20T17:33:46Z,37,30,67
"S-waiting-on-review;T-libs,S-waiting-on-review;T-libs",46127,2017-11-20T18:22:22Z,0,0,0
NULL,46129,2017-11-20T18:51:41Z,79,0,79
"S-waiting-on-review;T-libs,S-waiting-on-review;T-libs,S-waiting-on-review;T-libs,S-waiting-on-review;T-libs",46130,2017-11-20T19:14:50Z,114,49,163
NULL,46134,2017-11-20T20:50:37Z,38,9,47
A-associated-items;A-traits;A-typesystem;B-RFC-approved;B-unstable;C-tracking-issue;T-lang,46146,2017-11-21T06:55:11Z,0,0,0
"S-waiting-on-review,S-waiting-on-review,S-waiting-on-review,S-waiting-on-bors",46153,2017-11-21T12:57:33Z,0,0,0
NULL,46155,2017-11-21T13:24:53Z,2,2,4
"A-incr-comp;E-needs-mentor;T-compiler;WG-compiler-incr,A-incr-comp;E-needs-mentor;T-compiler;WG-compiler-incr",46165,2017-11-21T16:22:59Z,0,0,0
"S-waiting-on-review,S-waiting-on-bors,S-waiting-on-review,S-waiting-on-review",46166,2017-11-21T17:13:07Z,392,462,854
"A-diagnostics;C-enhancement;T-doc,A-diagnostics;C-enhancement;T-doc",46168,2017-11-21T19:51:35Z,32,31,63
NULL,46174,2017-11-21T23:11:09Z,2,44,46
NULL,46175,2017-11-21T23:19:09Z,227,227,454
NULL,46176,2017-11-21T23:31:31Z,0,0,0
NULL,46177,2017-11-22T01:08:20Z,7,1,8
NULL,46192,2017-11-22T21:03:59Z,453,141,594
NULL,46193,2017-11-22T21:09:50Z,0,0,0
NULL,46196,2017-11-22T21:31:46Z,7,2,9
"B-RFC-approved,B-RFC-approved,B-RFC-approved,B-RFC-approved",46206,2017-11-23T15:23:47Z,0,0,0
"A-build;A-testsuite,A-build;A-testsuite",46207,2017-11-23T15:32:59Z,244,120,364
NULL,46211,2017-11-23T16:36:54Z,4,0,4
NULL,46219,2017-11-23T19:53:11Z,106,13,119
NULL,46220,2017-11-23T19:54:18Z,4,2,6
"A-rustdoc;T-dev-tools-rustdoc,A-rustdoc;T-dev-tools-rustdoc",46221,2017-11-23T20:21:16Z,9,2,11
S-waiting-on-review,46225,2017-11-23T20:51:14Z,67,13,80
NULL,46226,2017-11-23T21:07:03Z,148,53,201
NULL,46229,2017-11-23T22:48:24Z,0,0,0
NULL,46231,2017-11-24T00:02:12Z,46,11,57
"A-borrow-checker;E-needs-mentor;WG-compiler-nll,A-borrow-checker;E-needs-mentor;WG-compiler-nll",46236,2017-11-24T13:04:01Z,89,50,139
NULL,46247,2017-11-24T22:13:40Z,64,23,87
NULL,46249,2017-11-24T22:49:27Z,99,0,99
NULL,46250,2017-11-25T06:30:05Z,8,8,16
NULL,46252,2017-11-25T10:39:18Z,3,0,3
NULL,46253,2017-11-25T12:25:20Z,25,1,26
"E-needs-mentor;T-compiler;WG-compiler-middle,E-needs-mentor;T-compiler;WG-compiler-middle",46254,2017-11-25T12:46:24Z,55,4,59
A-build,46255,2017-11-25T12:50:26Z,0,0,0
"A-diagnostics;C-enhancement;E-easy;WG-compiler-errors,A-diagnostics;C-enhancement;E-easy;WG-compiler-errors",46258,2017-11-25T15:43:07Z,29,1,30
"relnotes;S-waiting-on-review;T-libs,relnotes;S-waiting-on-review;T-libs",46266,2017-11-25T20:39:05Z,0,0,0
"E-needs-mentor;T-compiler;WG-compiler-nll,A-borrow-checker;WG-compiler-nll,E-needs-mentor;T-compiler;WG-compiler-nll,A-borrow-checker;WG-compiler-nll",46268,2017-11-25T23:04:15Z,608,176,784
NULL,46272,2017-11-26T07:01:41Z,81,12,93
"A-docs;A-rustdoc,A-docs;A-rustdoc",46278,2017-11-26T16:50:42Z,255,234,489
NULL,46284,2017-11-26T21:45:40Z,3,0,3
NULL,46287,2017-11-26T22:22:03Z,8,164,172
NULL,46290,2017-11-27T00:37:54Z,43,94,137
"S-waiting-on-review;T-libs,S-waiting-on-review;T-libs",46293,2017-11-27T01:30:14Z,7,0,7
S-waiting-on-review,46304,2017-11-27T15:18:45Z,0,0,0
NULL,46312,2017-11-27T19:16:52Z,628,61,689
NULL,46321,2017-11-28T06:30:41Z,0,0,0
NULL,46323,2017-11-28T09:52:59Z,3,3,6
S-waiting-on-review,46324,2017-11-28T10:15:25Z,0,0,0
"A-rustdoc;T-doc,A-rustdoc;T-doc",46326,2017-11-28T11:06:26Z,31,6,37
NULL,46329,2017-11-28T12:57:13Z,48,81,129
NULL,46330,2017-11-28T13:27:10Z,3,4,7
"S-waiting-on-review,S-waiting-on-review",46338,2017-11-28T17:05:04Z,476,226,702
"S-waiting-on-review;T-libs,S-waiting-on-review;T-libs",46340,2017-11-28T18:23:53Z,0,0,0
NULL,46341,2017-11-28T18:37:39Z,0,0,0
NULL,46343,2017-11-28T19:25:37Z,89,8,97
"A-diagnostics;C-enhancement;E-needs-mentor;WG-compiler-errors,A-diagnostics;C-enhancement;E-needs-mentor;WG-compiler-errors",46347,2017-11-28T21:10:27Z,56,5,61
NULL,46350,2017-11-28T22:47:25Z,0,0,0
"A-llvm,A-llvm",46353,2017-11-29T01:19:35Z,0,0,0
"A-rustdoc,A-rustdoc",46359,2017-11-29T09:06:23Z,32,0,32
"S-waiting-on-review;T-libs,S-waiting-on-review;T-libs",46362,2017-11-29T10:37:55Z,404,518,922
"S-waiting-on-bors,S-waiting-on-bors",46366,2017-11-29T13:09:12Z,3,5,8
A-codegen;C-tracking-issue,46382,2017-11-29T21:52:32Z,154,126,280
NULL,46385,2017-11-29T23:02:42Z,1,1,2
NULL,46386,2017-11-29T23:12:53Z,0,2,2
A-rustdoc;E-easy;E-mentor;T-doc,46387,2017-11-29T23:32:58Z,16,1,17
NULL,46392,2017-11-30T09:07:00Z,6,0,6
"A-build;T-dev-tools;T-infra;WG-infra-rustbuild,A-build;T-dev-tools;T-infra;WG-infra-rustbuild",46393,2017-11-30T10:41:02Z,124,28,152
"S-waiting-on-review,S-waiting-on-review,S-waiting-on-review,S-waiting-on-crater",46395,2017-11-30T12:08:35Z,0,0,0
"S-waiting-on-crater,S-waiting-on-review,S-waiting-on-review",46398,2017-11-30T13:19:50Z,0,0,0
"S-waiting-on-review,S-waiting-on-review,S-waiting-on-review,S-waiting-on-review,S-waiting-on-crater",46399,2017-11-30T13:20:31Z,0,0,0
NULL,46401,2017-11-30T13:41:52Z,1,2,3
"S-waiting-on-review,S-waiting-on-crater,S-waiting-on-review,S-waiting-on-review",46404,2017-11-30T16:03:41Z,0,0,0
NULL,46405,2017-11-30T16:24:25Z,34,0,34
"S-waiting-on-review;T-doc,S-waiting-on-review,S-waiting-on-review,S-waiting-on-review,S-waiting-on-review,S-waiting-on-crater,S-waiting-on-review,S-waiting-on-review;T-doc,S-waiting-on-review,S-waiting-on-review,S-waiting-on-review,S-waiting-on-crater",46410,2017-11-30T19:29:19Z,0,0,0
NULL,46412,2017-11-30T20:24:45Z,43,1,44
NULL,46417,2017-12-01T06:55:57Z,0,0,0
NULL,46419,2017-12-01T08:38:05Z,142,28,170
"S-waiting-on-crater,S-waiting-on-review;T-doc,S-waiting-on-review",46430,2017-12-01T17:39:06Z,219,49,268
"A-diagnostics,A-diagnostics",46431,2017-12-01T18:02:03Z,4,4,8
NULL,46432,2017-12-01T18:34:56Z,1,1,2
NULL,46433,2017-12-01T19:55:48Z,10,3,13
NULL,46435,2017-12-01T22:43:31Z,13,180,193
beta-nominated,46436,2017-12-01T22:58:25Z,518,781,1299
"E-mentor;T-compiler;WG-compiler-front,E-mentor;T-compiler;WG-compiler-front",46441,2017-12-02T07:51:32Z,258,15,273
NULL,46450,2017-12-02T15:51:53Z,1711,754,2465
A-rustdoc,46452,2017-12-02T20:00:31Z,0,0,0
"A-rustdoc,A-rustdoc",46454,2017-12-02T21:15:03Z,1,0,1
NULL,46455,2017-12-02T22:16:36Z,382,290,672
"A-diagnostics,A-diagnostics",46461,2017-12-03T08:30:14Z,147,65,212
NULL,46462,2017-12-03T08:55:26Z,57,30,87
NULL,46473,2017-12-03T16:27:49Z,69,69,138
NULL,46480,2017-12-03T22:36:12Z,0,0,0
S-waiting-on-review;T-infra,46482,2017-12-03T22:43:51Z,160,120,280
NULL,46483,2017-12-03T23:03:09Z,40,2,42
NULL,46486,2017-12-04T05:56:05Z,13,5,18
NULL,46492,2017-12-04T15:54:10Z,14,4,18
NULL,46497,2017-12-04T18:01:58Z,46,23,69
NULL,46501,2017-12-04T20:26:36Z,0,0,0
A-rustdoc;C-enhancement,46502,2017-12-04T21:12:22Z,10,1,11
NULL,46503,2017-12-04T22:23:08Z,0,2,2
NULL,46508,2017-12-05T01:03:17Z,62,1,63
NULL,46512,2017-12-05T05:56:52Z,29,4,33
NULL,46514,2017-12-05T08:03:32Z,35,6,41
"B-RFC-approved;T-libs,B-RFC-approved;T-libs",46517,2017-12-05T16:07:36Z,2,4,6
NULL,46518,2017-12-05T17:17:28Z,149,15,164
NULL,46521,2017-12-05T21:40:23Z,42,7,49
"A-incr-comp;A-testsuite;E-mentor;WG-compiler-incr,A-incr-comp;A-testsuite;E-mentor;WG-compiler-incr",46523,2017-12-05T23:04:31Z,320,404,724
T-compiler;WG-compiler-nll,46524,2017-12-05T23:29:27Z,18,7,25
NULL,46526,2017-12-05T23:43:35Z,76,5,81
T-compiler;WG-compiler-front,46531,2017-12-06T02:50:24Z,609,63,672
S-waiting-on-review,46538,2017-12-06T14:35:42Z,87,15,102
NULL,46549,2017-12-07T02:02:24Z,38,1,39
"S-waiting-on-review,S-blocked,S-waiting-on-review,S-blocked",46551,2017-12-07T05:06:02Z,217,9,226
"A-build;T-dev-tools;T-infra;WG-infra-rustbuild,A-build;T-dev-tools;T-infra;WG-infra-rustbuild",46554,2017-12-07T08:50:52Z,429,334,763
NULL,46556,2017-12-07T13:03:25Z,260,995,1255
S-blocked,46562,2017-12-07T15:49:37Z,99,44,143
"S-waiting-on-author,S-waiting-on-author,S-waiting-on-author,S-waiting-on-author",46564,2017-12-07T16:27:32Z,0,0,0
"A-attributes;A-rustdoc;C-tracking-issue;T-dev-tools;T-doc;WG-docs-rustdoc,A-attributes;A-rustdoc;C-tracking-issue;T-dev-tools;T-doc;WG-docs-rustdoc",46567,2017-12-07T16:58:13Z,0,0,0
NULL,46570,2017-12-07T19:31:10Z,33,2,35
NULL,46573,2017-12-07T22:22:01Z,25,0,25
"S-waiting-on-review,S-waiting-on-review,S-waiting-on-review,S-waiting-on-review",46574,2017-12-07T22:59:05Z,206,40,246
NULL,46580,2017-12-08T04:22:21Z,1,1,2
NULL,46581,2017-12-08T06:06:54Z,9,0,9
NULL,46583,2017-12-08T11:02:54Z,311,4,315
"A-rustdoc;T-doc,A-rustdoc;T-doc",46586,2017-12-08T15:37:05Z,9,1,10
NULL,46592,2017-12-08T20:24:45Z,24,16,40
"A-diagnostics;WG-compiler-nll,A-diagnostics;WG-compiler-nll,WG-compiler-nll",46598,2017-12-09T11:47:28Z,297,51,348
NULL,46603,2017-12-09T17:39:26Z,1,0,1
NULL,46608,2017-12-09T21:05:32Z,51,7,58
NULL,46611,2017-12-10T00:21:24Z,26,1,27
"B-RFC-approved;T-lang,B-RFC-approved;T-lang",46613,2017-12-10T00:57:38Z,264,57,321
"E-needs-mentor;T-compiler;WG-compiler-middle,E-needs-mentor;T-compiler;WG-compiler-middle",46616,2017-12-10T05:58:31Z,135,56,191
NULL,46620,2017-12-10T10:59:37Z,13,62,75
NULL,46623,2017-12-10T15:56:27Z,58,13,71
NULL,46624,2017-12-10T16:31:30Z,4,4,8
NULL,46633,2017-12-10T19:16:38Z,94,84,178
NULL,46636,2017-12-10T19:33:37Z,22,32,54
NULL,46638,2017-12-10T19:47:57Z,0,0,0
"A-testsuite;E-easy;E-mentor;T-compiler,A-testsuite;E-easy;E-mentor;T-compiler",46640,2017-12-10T21:18:23Z,253,203,456
"A-diagnostics;E-mentor;WG-compiler-errors,A-diagnostics;E-mentor;WG-compiler-errors",46641,2017-12-10T21:33:47Z,6814,2083,8897
NULL,46647,2017-12-10T23:21:43Z,8,0,8
"A-diagnostics,A-diagnostics",46653,2017-12-11T07:55:44Z,63,4,67
E-needs-mentor,46664,2017-12-11T18:03:40Z,273,33,306
NULL,46666,2017-12-11T18:43:06Z,16,4,20
"A-rustdoc;T-doc,A-rustdoc;T-doc",46668,2017-12-11T21:30:46Z,27,4,31
NULL,46671,2017-12-11T23:02:30Z,6,1,7
NULL,46672,2017-12-11T23:21:26Z,4,4,8
NULL,46674,2017-12-12T00:10:13Z,1,6,7
S-waiting-on-review,46692,2017-12-12T17:28:16Z,0,0,0
S-waiting-on-review,46696,2017-12-12T20:28:10Z,34,10,44
NULL,46700,2017-12-12T23:22:06Z,11,12,23
"A-associated-items;A-traits;A-typesystem;B-RFC-approved;B-unstable;C-tracking-issue;T-lang,A-associated-items;A-traits;A-typesystem;B-RFC-approved;B-unstable;C-tracking-issue;T-lang",46706,2017-12-13T02:29:31Z,155,53,208
NULL,46708,2017-12-13T05:22:26Z,66,5,71
NULL,46709,2017-12-13T13:45:52Z,2391,19,2410
A-spurious,46715,2017-12-13T17:25:29Z,5,4,9
NULL,46719,2017-12-14T01:29:59Z,585,538,1123
"A-diagnostics;C-bug;E-needs-mentor;WG-compiler-errors,A-diagnostics;C-bug;E-needs-mentor;WG-compiler-errors,A-diagnostics;C-bug;E-needs-mentor;WG-compiler-errors,A-diagnostics;C-bug;E-needs-mentor;WG-compiler-errors",46720,2017-12-14T01:35:33Z,41,16,57
NULL,46721,2017-12-14T04:49:44Z,0,0,0
NULL,46722,2017-12-14T05:09:23Z,71,28,99
NULL,46728,2017-12-14T14:20:22Z,7,3,10
"A-diagnostics,A-diagnostics",46732,2017-12-14T19:49:51Z,112,41,153
NULL,46735,2017-12-14T21:57:38Z,776,317,1093
"T-doc,T-doc",46737,2017-12-15T00:07:42Z,7,10,17
NULL,46739,2017-12-15T04:36:40Z,27,2,29
NULL,46745,2017-12-15T14:27:04Z,32,25,57
B-unstable;T-libs,46749,2017-12-15T18:26:08Z,34,36,70
A-impl-trait;I-ICE;T-compiler,46754,2017-12-15T20:57:30Z,93,186,279
NULL,46757,2017-12-15T22:54:16Z,24,43,67
NULL,46761,2017-12-16T07:37:18Z,56,2,58
NULL,46762,2017-12-16T08:09:15Z,1,2,3
S-waiting-on-review,46763,2017-12-16T09:00:16Z,48,1,49
NULL,46772,2017-12-16T16:22:50Z,130,0,130
NULL,46777,2017-12-16T21:37:26Z,142,50,192
NULL,46779,2017-12-17T01:38:19Z,89,70,159
NULL,46780,2017-12-17T01:53:57Z,36,17,53
NULL,46785,2017-12-17T13:24:33Z,231,23,254
NULL,46786,2017-12-17T14:58:59Z,41,5,46
"A-rustdoc,A-rustdoc,A-rustdoc,A-rustdoc",46787,2017-12-17T15:23:09Z,43,5,48
A-diagnostics;A-parser,46788,2017-12-17T16:06:53Z,357,20,377
"A-libs,A-libs,A-libs,A-libs",46789,2017-12-17T17:18:37Z,321,167,488
NULL,46792,2017-12-17T22:28:50Z,0,0,0
NULL,46795,2017-12-17T23:07:18Z,0,0,0
NULL,46798,2017-12-18T01:17:30Z,63,3,66
NULL,46799,2017-12-18T01:58:52Z,0,0,0
NULL,46808,2017-12-18T13:13:19Z,12,4,16
"beta-nominated,beta-nominated",46809,2017-12-18T13:22:56Z,16,9,25
B-RFC-approved;T-libs,46812,2017-12-18T14:55:40Z,18,2,20
NULL,46814,2017-12-18T15:36:00Z,67,5,72
NULL,46828,2017-12-18T21:40:06Z,34,11,45
NULL,46830,2017-12-18T22:11:56Z,58,32,90
NULL,46831,2017-12-18T23:19:16Z,15,10,25
NULL,46832,2017-12-19T00:15:41Z,46,0,46
NULL,46838,2017-12-19T14:08:44Z,46,15,61
NULL,46847,2017-12-19T20:08:17Z,49,3,52
A-attributes;A-rustdoc;C-tracking-issue;T-dev-tools;T-doc;WG-docs-rustdoc,46858,2017-12-19T22:56:41Z,56,9,65
NULL,46862,2017-12-20T01:36:18Z,4132,1844,5976
"S-waiting-on-review,S-waiting-on-review;T-compiler",46874,2017-12-20T13:22:06Z,255,143,398
NULL,46877,2017-12-20T13:45:27Z,29,0,29
"I-ICE,I-ICE,I-ICE,I-ICE,I-ICE",46882,2017-12-20T16:22:23Z,6638,7166,13804
"S-waiting-on-review,S-waiting-on-review",46886,2017-12-20T17:18:33Z,329,263,592
NULL,46887,2017-12-20T17:19:24Z,17,1,18
"B-unstable,B-unstable",46888,2017-12-20T18:25:28Z,112,5,117
"T-doc,T-doc",46894,2017-12-20T22:18:52Z,40,2,42
NULL,46895,2017-12-20T22:26:29Z,231,21,252
"E-easy;I-cleanup,E-easy;I-cleanup,E-easy;I-cleanup",46899,2017-12-21T05:12:20Z,24,30,54
S-waiting-on-bors,46904,2017-12-21T12:18:22Z,248,99,347
NULL,46905,2017-12-21T12:36:51Z,88,11,99
NULL,46907,2017-12-21T13:18:16Z,34,4,38
"A-codegen;C-tracking-issue,A-codegen;C-tracking-issue,A-codegen;C-tracking-issue",46910,2017-12-21T15:05:43Z,32,4,36
NULL,46911,2017-12-21T15:54:48Z,0,0,0
NULL,46912,2017-12-21T15:55:30Z,4,0,4
"S-waiting-on-review,S-waiting-on-review",46914,2017-12-21T16:31:55Z,38,21,59
NULL,46916,2017-12-21T16:59:55Z,38,3,41
S-waiting-on-review,46922,2017-12-21T18:51:00Z,453,329,782
NULL,46924,2017-12-21T19:17:16Z,7,1,8
NULL,46925,2017-12-21T20:30:54Z,5614,4977,10591
A-codegen;A-llvm;I-slow,46926,2017-12-21T21:03:15Z,0,0,0
NULL,46928,2017-12-21T22:58:18Z,2,2,4
NULL,46934,2017-12-22T01:34:51Z,0,0,0
NULL,46941,2017-12-22T09:16:40Z,116,234,350
"A-borrow-checker;A-diagnostics;WG-compiler-nll,A-borrow-checker;A-diagnostics;WG-compiler-nll",46949,2017-12-22T15:49:05Z,75,2,77
"B-unstable;T-libs,B-unstable;T-libs",46952,2017-12-22T18:56:41Z,182,197,379
NULL,46958,2017-12-23T00:06:28Z,0,0,0
NULL,46965,2017-12-23T09:23:53Z,0,0,0
NULL,46967,2017-12-23T14:12:10Z,0,0,0
A-diagnostics;T-compiler,46973,2017-12-23T21:56:52Z,167,12,179
"I-unsound;WG-compiler-nll,I-unsound;WG-compiler-nll",46975,2017-12-23T22:54:37Z,171,4,175
NULL,46980,2017-12-24T03:39:44Z,25,11,36
NULL,46984,2017-12-24T13:00:24Z,262,29,291
"T-libs,T-libs",46985,2017-12-24T17:41:05Z,7,0,7
NULL,46987,2017-12-24T19:39:32Z,11,8,19
"A-testsuite;E-mentor;I-papercut;P-low,A-testsuite;E-mentor;I-papercut;P-low,A-testsuite;E-mentor;I-papercut;P-low,A-testsuite;E-mentor;I-papercut;P-low",46990,2017-12-24T22:57:49Z,0,0,0
NULL,46992,2017-12-25T03:10:39Z,0,0,0
A-spurious;C-tracking-issue;T-infra,47000,2017-12-25T18:37:43Z,1,1,2
"beta-nominated,beta-nominated",47001,2017-12-25T19:19:14Z,62,9,71
"B-RFC-approved;B-unstable;T-lang,B-RFC-approved;B-unstable;T-lang",47006,2017-12-25T23:44:00Z,20,65,85
NULL,47007,2017-12-25T23:47:29Z,7,6,13
NULL,47012,2017-12-26T07:19:01Z,212,14,226
NULL,47013,2017-12-26T08:10:17Z,151,108,259
"I-ICE,I-ICE,I-ICE,I-ICE,I-ICE,I-ICE",47014,2017-12-26T10:26:37Z,192,0,192
NULL,47016,2017-12-26T11:30:49Z,6,1,7
NULL,47017,2017-12-26T13:12:46Z,24,1,25
NULL,47018,2017-12-26T15:16:04Z,39,6,45
A-borrow-checker;A-diagnostics;WG-compiler-nll,47020,2017-12-26T19:10:25Z,0,0,0
NULL,47021,2017-12-26T19:22:53Z,48,3,51
"relnotes;S-waiting-on-review;T-libs,S-waiting-on-review;T-libs,beta-accepted;beta-nominated;T-libs,S-waiting-on-review;T-libs,relnotes;S-waiting-on-review;T-libs,S-waiting-on-review;T-libs,beta-accepted;beta-nominated;T-libs,S-waiting-on-review;T-libs",47030,2017-12-27T15:26:25Z,39,24,63
NULL,47031,2017-12-27T15:59:48Z,27,1,28
NULL,47044,2017-12-28T06:48:37Z,153,0,153
"A-rustdoc;B-RFC-approved;T-dev-tools,A-rustdoc;T-dev-tools;T-doc,A-rustdoc;B-RFC-approved;T-dev-tools",47046,2017-12-28T11:34:21Z,995,264,1259
NULL,47050,2017-12-28T18:32:05Z,36,24,60
NULL,47052,2017-12-28T19:15:05Z,33,8,41
"S-blocked,S-blocked",47063,2017-12-29T16:21:19Z,25,3,28
NULL,47079,2017-12-30T21:28:14Z,1,1,2
"A-specialization;A-traits,B-unstable;T-libs",47082,2017-12-30T22:28:55Z,0,0,0
NULL,47084,2017-12-31T05:22:41Z,48,3,51
A-borrow-checker;A-diagnostics;WG-compiler-nll,47093,2017-12-31T14:32:55Z,0,0,0
NULL,47098,2017-12-31T23:39:08Z,85,64,149
NULL,47104,2018-01-01T17:58:45Z,30,4,34
NULL,47105,2018-01-01T17:58:48Z,34,8,42
NULL,47111,2018-01-01T21:13:18Z,130,44,174
NULL,47116,2018-01-02T00:40:15Z,466,116,582
NULL,47121,2018-01-02T03:08:09Z,1,1,2
"A-diagnostics;I-papercut;I-wrong,A-diagnostics;I-papercut;I-wrong",47124,2018-01-02T06:12:55Z,104,21,125
NULL,47126,2018-01-02T09:28:52Z,472,10,482
NULL,47130,2018-01-02T16:00:28Z,0,0,0
NULL,47132,2018-01-02T17:10:09Z,23,1,24
NULL,47142,2018-01-02T23:07:27Z,73,0,73
"A-closures;A-diagnostics;WG-compiler-errors,A-closures;A-diagnostics;WG-compiler-errors",47144,2018-01-02T23:29:00Z,352,21,373
NULL,47145,2018-01-02T23:44:36Z,11,0,11
NULL,47146,2018-01-02T23:58:49Z,14,20,34
"I-nominated;T-lang,I-nominated;T-lang",47147,2018-01-03T01:54:43Z,26,3,29
"A-macros;A-plugin;B-RFC-approved,A-macros;A-plugin;B-RFC-approved",47149,2018-01-03T07:36:52Z,14,0,14
NULL,47150,2018-01-03T07:38:49Z,1,1,2
NULL,47151,2018-01-03T08:58:05Z,87,39,126
"A-debuginfo;I-slow,A-debuginfo;I-slow",47152,2018-01-03T11:10:21Z,0,0,0
"B-RFC-approved;T-lang,S-waiting-on-review,B-RFC-approved;T-lang,S-waiting-on-review",47156,2018-01-03T15:37:17Z,322,26,348
"B-RFC-approved;T-lang,B-RFC-approved;T-lang",47158,2018-01-03T16:52:35Z,881,12,893
"I-compiletime,I-compiletime",47161,2018-01-03T17:14:35Z,43,43,86
NULL,47162,2018-01-03T18:21:44Z,68,72,140
NULL,47165,2018-01-03T20:54:40Z,16,23,39
NULL,47167,2018-01-03T23:32:16Z,104,12,116
NULL,47171,2018-01-04T03:20:22Z,199,34,233
"A-LLVM,A-LLVM",47173,2018-01-04T08:51:24Z,13,34,47
NULL,47177,2018-01-04T10:34:51Z,55,18,73
NULL,47180,2018-01-04T12:41:59Z,75,0,75
NULL,47191,2018-01-04T19:09:36Z,0,0,0
NULL,47195,2018-01-04T19:48:53Z,0,0,0
"E-mentor;T-compiler;WG-compiler-incr;WG-compiler-traits,E-mentor;T-compiler;WG-compiler-incr;WG-compiler-traits",47200,2018-01-04T21:30:54Z,39,7,46
NULL,47202,2018-01-05T00:14:01Z,4,0,4
NULL,47204,2018-01-05T01:11:31Z,7,12,19
NULL,47208,2018-01-05T05:42:27Z,48,6,54
NULL,47210,2018-01-05T07:44:58Z,19,1,20
NULL,47214,2018-01-05T09:22:14Z,162,107,269
NULL,47220,2018-01-05T17:11:48Z,27,6,33
"S-waiting-on-review,S-waiting-on-review",47225,2018-01-06T01:13:37Z,45,66,111
NULL,47230,2018-01-06T11:11:52Z,8,9,17
NULL,47231,2018-01-06T12:36:32Z,6,2,8
"A-LLVM,A-LLVM",47233,2018-01-06T15:01:23Z,1,58,59
"S-waiting-on-review,S-waiting-on-review",47235,2018-01-06T18:36:08Z,278,192,470
NULL,47242,2018-01-06T22:46:59Z,102,15,117
"A-incr-comp;C-enhancement;E-needs-mentor;WG-compiler-incr,A-incr-comp;C-enhancement;E-needs-mentor;WG-compiler-incr",47243,2018-01-06T22:51:41Z,78,2,80
NULL,47245,2018-01-07T00:45:55Z,0,0,0
NULL,47247,2018-01-07T05:13:56Z,1717,114,1831
"S-waiting-on-review,S-waiting-on-review",47252,2018-01-07T17:50:13Z,62,50,112
NULL,47254,2018-01-07T19:27:27Z,3,12,15
NULL,47259,2018-01-07T22:18:19Z,49,1,50
"A-diagnostics;E-needs-mentor;T-compiler;WG-compiler-errors;WG-compiler-nll,A-diagnostics;E-needs-mentor;T-compiler;WG-compiler-errors;WG-compiler-nll",47261,2018-01-08T01:03:32Z,78,14,92
NULL,47262,2018-01-08T02:58:31Z,32,1,33
NULL,47263,2018-01-08T03:45:48Z,22,8,30
"A-incr-comp;regression-from-stable-to-beta;T-compiler,A-incr-comp;regression-from-stable-to-beta;T-compiler",47269,2018-01-08T11:39:10Z,70,28,98
NULL,47274,2018-01-08T14:55:16Z,84,11,95
"S-waiting-on-review,S-waiting-on-review",47276,2018-01-08T17:58:56Z,192,162,354
NULL,47277,2018-01-08T18:32:49Z,16,18,34
NULL,47291,2018-01-09T12:11:23Z,0,0,0
NULL,47298,2018-01-09T19:01:00Z,9,30,39
"A-rustdoc;T-doc,A-rustdoc;T-doc",47301,2018-01-09T21:27:47Z,325,224,549
NULL,47302,2018-01-09T21:28:37Z,4,9,13
NULL,47305,2018-01-10T00:26:10Z,14,47,61
T-libs,47308,2018-01-10T03:28:27Z,501,278,779
NULL,47322,2018-01-10T15:15:46Z,48,0,48
"S-waiting-on-review;T-libs,S-waiting-on-review;T-libs",47324,2018-01-10T16:14:28Z,10,2,12
"beta-nominated;S-waiting-on-review,S-waiting-on-review",47327,2018-01-10T16:56:26Z,200,81,281
NULL,47328,2018-01-10T17:13:26Z,42,64,106
"A-diagnostics;WG-compiler-nll,A-diagnostics;WG-compiler-nll",47329,2018-01-10T17:14:30Z,65,31,96
NULL,47330,2018-01-10T17:23:11Z,4,4,8
NULL,47333,2018-01-10T19:37:31Z,56,0,56
NULL,47334,2018-01-10T19:50:44Z,16,32,48
"S-waiting-on-bors,S-waiting-on-review;T-lang;beta-nominated,S-waiting-on-bors,S-waiting-on-review;T-lang;beta-nominated",47339,2018-01-10T21:51:12Z,0,0,0
"I-ICE,A-specialization;I-ICE,I-ICE,A-specialization;I-ICE",47344,2018-01-11T04:06:32Z,110,0,110
"S-waiting-on-review;T-lang;beta-nominated,S-waiting-on-bors,S-waiting-on-review;T-lang;beta-nominated,S-waiting-on-bors",47350,2018-01-11T09:13:02Z,0,0,0
NULL,47353,2018-01-11T11:06:53Z,99,8,107
NULL,47362,2018-01-11T19:35:41Z,0,0,0
NULL,47365,2018-01-11T21:28:40Z,0,1,1
"E-mentor;T-compiler;WG-compiler-nll,A-borrow-checker;I-nominated;I-unsound;T-compiler",47368,2018-01-11T23:14:48Z,75,0,75
NULL,47372,2018-01-12T02:49:06Z,43,3,46
NULL,47374,2018-01-12T04:27:25Z,42,3,45
NULL,47378,2018-01-12T10:53:42Z,0,0,0
NULL,47382,2018-01-12T11:51:07Z,23,1,24
NULL,47387,2018-01-12T16:06:29Z,11,1,12
"S-waiting-on-review,S-waiting-on-bors,S-waiting-on-review;T-lang;beta-nominated",47392,2018-01-12T18:26:47Z,490,225,715
S-waiting-on-review;T-lang;beta-nominated,47399,2018-01-12T22:19:19Z,10,31,41
NULL,47401,2018-01-12T22:40:03Z,22,3,25
NULL,47407,2018-01-13T06:38:31Z,55,2,57
"A-diagnostics,A-diagnostics",47413,2018-01-13T13:06:14Z,345,297,642
"A-rustdoc;C-bug,A-rustdoc;C-bug",47414,2018-01-13T13:47:58Z,11,8,19
"C-enhancement;E-easy;I-compiletime,C-enhancement;E-easy;I-compiletime",47415,2018-01-13T15:56:54Z,81,9,90
S-waiting-on-review,47416,2018-01-13T18:02:07Z,193,804,997
"A-rustdoc;C-bug,A-rustdoc;C-bug",47423,2018-01-14T07:32:41Z,11,9,20
NULL,47424,2018-01-14T09:46:39Z,0,0,0
NULL,47425,2018-01-14T11:26:47Z,21,0,21
NULL,47435,2018-01-14T23:05:47Z,0,0,0
NULL,47437,2018-01-14T23:41:30Z,0,0,0
NULL,47439,2018-01-15T00:12:54Z,10,10,20
NULL,47440,2018-01-15T03:22:48Z,38,27,65
NULL,47444,2018-01-15T08:24:10Z,6,7,13
NULL,47445,2018-01-15T08:55:38Z,660,212,872
NULL,47453,2018-01-15T13:52:37Z,78,52,130
"A-borrow-checker;I-unsound,E-mentor;T-compiler;WG-compiler-nll,A-borrow-checker;I-unsound,E-mentor;T-compiler;WG-compiler-nll",47456,2018-01-15T16:15:24Z,41,0,41
NULL,47458,2018-01-15T16:30:10Z,55,19,74
"B-RFC-approved;T-libs,B-RFC-approved;T-libs",47463,2018-01-15T19:04:49Z,109,116,225
NULL,47465,2018-01-15T21:02:53Z,72,32,104
NULL,47467,2018-01-15T22:07:25Z,47,7,54
NULL,47471,2018-01-15T22:57:25Z,260,48,308
NULL,47479,2018-01-16T02:53:06Z,42,16,58
NULL,47481,2018-01-16T05:41:08Z,69,77,146
NULL,47483,2018-01-16T05:45:27Z,9,0,9
E-easy,47484,2018-01-16T08:05:47Z,0,0,0
NULL,47485,2018-01-16T08:47:16Z,0,0,0
"E-easy,E-easy",47487,2018-01-16T09:17:53Z,11,0,11
NULL,47488,2018-01-16T09:58:22Z,0,0,0
A-NLL;WG-compiler-nll,47489,2018-01-16T10:40:26Z,564,77,641
NULL,47492,2018-01-16T14:39:32Z,0,0,0
NULL,47494,2018-01-16T16:36:44Z,82,26,108
NULL,47495,2018-01-16T17:46:19Z,31,9,40
A-attributes;A-rustdoc;C-tracking-issue;T-dev-tools;T-doc;WG-docs-rustdoc,47496,2018-01-16T19:34:29Z,16,0,16
"S-waiting-on-review,S-waiting-on-review",47505,2018-01-16T23:52:48Z,7,6,13
NULL,47507,2018-01-17T01:24:30Z,181,32,213
NULL,47508,2018-01-17T01:38:47Z,2,0,2
"beta-accepted;beta-nominated,S-waiting-on-review,S-waiting-on-review;T-doc,S-waiting-on-review;T-infra,S-waiting-on-author",47513,2018-01-17T10:43:21Z,0,0,0
NULL,47514,2018-01-17T11:23:27Z,2,1,3
NULL,47520,2018-01-17T16:40:26Z,9,7,16
NULL,47521,2018-01-17T17:52:36Z,221,115,336
"S-waiting-on-review,S-waiting-on-review;T-doc,S-waiting-on-review;T-infra,S-waiting-on-author,beta-accepted;beta-nominated",47522,2018-01-17T17:57:33Z,611,281,892
NULL,47528,2018-01-17T22:43:32Z,821,115,936
NULL,47533,2018-01-18T00:38:22Z,0,0,0
NULL,47534,2018-01-18T04:18:13Z,42,15,57
A-diagnostics,47540,2018-01-18T11:50:28Z,109,14,123
NULL,47541,2018-01-18T12:50:33Z,6,1,7
NULL,47543,2018-01-18T14:47:42Z,20,12,32
NULL,47546,2018-01-18T15:15:55Z,0,0,0
NULL,47548,2018-01-18T15:41:40Z,9,3,12
"A-borrow-checker;I-nominated;I-unsound;T-compiler,A-borrow-checker;I-nominated;I-unsound;T-compiler",47549,2018-01-18T15:55:18Z,39,0,39
beta-accepted;beta-nominated,47553,2018-01-18T20:07:37Z,41,15,56
NULL,47557,2018-01-18T21:31:03Z,0,0,0
B-RFC-approved;C-tracking-issue;T-libs,47562,2018-01-19T02:37:01Z,107,0,107
"S-waiting-on-review;T-libs,S-waiting-on-review;T-libs",47572,2018-01-19T10:06:28Z,0,0,0
NULL,47573,2018-01-19T11:12:14Z,214,177,391
"A-diagnostics,A-diagnostics",47574,2018-01-19T13:05:16Z,309,43,352
"I-unsound,I-unsound",47600,2018-01-19T19:59:04Z,32,4,36
"A-testsuite;C-enhancement;T-compiler,A-testsuite;C-enhancement;T-compiler",47605,2018-01-19T23:54:51Z,0,0,0
"A-borrow-checker;A-diagnostics;WG-compiler-nll,A-borrow-checker;A-diagnostics;WG-compiler-nll",47607,2018-01-20T02:19:38Z,150,48,198
NULL,47609,2018-01-20T05:48:05Z,6,6,12
NULL,47610,2018-01-20T06:00:19Z,10,3,13
"E-needs-mentor;WG-compiler-errors,A-diagnostics",47613,2018-01-20T11:10:29Z,234,83,317
A-codegen;A-LLVM;I-nominated;T-compiler,47614,2018-01-20T16:14:22Z,94,57,151
"S-waiting-on-review;T-libs,S-waiting-on-review;T-libs",47622,2018-01-20T21:32:51Z,388,201,589
NULL,47625,2018-01-20T22:56:34Z,12,12,24
B-unstable;T-libs,47631,2018-01-21T09:02:39Z,64,25,89
NULL,47632,2018-01-21T09:41:48Z,8,0,8
NULL,47633,2018-01-21T11:30:13Z,23,1,24
NULL,47636,2018-01-21T12:55:42Z,0,0,0
NULL,47644,2018-01-21T22:11:46Z,1935,188,2123
"B-RFC-approved;B-unstable;T-lang,B-RFC-approved;B-unstable;T-lang",47650,2018-01-22T04:11:15Z,0,0,0
"O-macos,O-macos",47655,2018-01-22T10:10:33Z,32,1,33
NULL,47662,2018-01-22T18:10:12Z,3,0,3
NULL,47663,2018-01-22T18:35:39Z,56,74,130
C-bug;I-ICE;T-compiler;regression-from-stable-to-stable,47668,2018-01-22T22:37:59Z,71,15,86
NULL,47671,2018-01-23T01:49:23Z,553,202,755
NULL,47675,2018-01-23T04:30:16Z,87,27,114
NULL,47677,2018-01-23T08:19:30Z,4,0,4
"I-nominated;S-waiting-on-bors;T-compiler,S-waiting-on-review,S-waiting-on-bors",47678,2018-01-23T09:03:48Z,302,103,405
"beta-nominated,beta-nominated",47682,2018-01-23T16:10:06Z,374,84,458
NULL,47686,2018-01-23T21:10:42Z,47,23,70
"B-RFC-approved;T-libs,B-RFC-approved;T-libs",47687,2018-01-23T21:50:43Z,280,200,480
NULL,47688,2018-01-23T22:03:41Z,9,7,16
NULL,47689,2018-01-23T22:53:10Z,63,0,63
"A-diagnostics;C-bug;E-easy;E-mentor,A-diagnostics;C-bug;E-easy;E-mentor",47702,2018-01-24T09:48:28Z,28,3,31
NULL,47704,2018-01-24T12:00:29Z,22,0,22
NULL,47705,2018-01-24T12:18:30Z,21,5,26
"A-LLVM,A-LLVM",47710,2018-01-24T15:19:30Z,56,41,97
NULL,47717,2018-01-24T16:26:29Z,1,1,2
"B-RFC-approved;T-lang,B-RFC-approved;T-lang",47726,2018-01-24T22:51:02Z,50,18,68
NULL,47730,2018-01-25T04:25:08Z,272,129,401
NULL,47731,2018-01-25T04:25:53Z,0,0,0
NULL,47732,2018-01-25T05:25:48Z,351,126,477
S-waiting-on-review,47734,2018-01-25T09:19:24Z,0,0,0
NULL,47738,2018-01-25T13:48:24Z,307,93,400
NULL,47740,2018-01-25T14:52:20Z,215,83,298
NULL,47743,2018-01-25T16:21:09Z,207,3,210
"S-waiting-on-review,S-waiting-on-review",47746,2018-01-25T18:14:24Z,58,2,60
NULL,47747,2018-01-25T18:42:21Z,86,41,127
"S-waiting-on-review,S-waiting-on-review,S-waiting-on-review,S-waiting-on-review,S-waiting-on-review,S-waiting-on-review,S-waiting-on-review,S-waiting-on-review,S-waiting-on-review,S-waiting-on-review,S-waiting-on-review,S-waiting-on-review",47748,2018-01-25T18:49:04Z,3681,2401,6082
NULL,47760,2018-01-25T23:15:47Z,17,5,22
NULL,47762,2018-01-26T00:31:31Z,5,1,6
"A-diagnostics,A-diagnostics",47763,2018-01-26T01:07:03Z,0,0,0
NULL,47767,2018-01-26T06:44:39Z,37,3,40
A-diagnostics;A-macros,47768,2018-01-26T06:56:01Z,0,0,0
NULL,47769,2018-01-26T08:54:00Z,68,2,70
NULL,47772,2018-01-26T11:09:40Z,4,2,6
"A-attributes;C-tracking-issue;T-dev-tools,A-attributes;C-tracking-issue;T-dev-tools",47773,2018-01-26T11:22:55Z,0,0,0
NULL,47784,2018-01-26T18:35:29Z,57,3,60
NULL,47791,2018-01-27T00:39:30Z,212,129,341
NULL,47794,2018-01-27T01:57:20Z,49,1,50
"E-easy,E-easy",47795,2018-01-27T02:13:28Z,1,0,1
NULL,47800,2018-01-27T08:02:53Z,2,4,6
T-compiler;WG-compiler-nll,47802,2018-01-27T10:20:23Z,261,74,335
"A-diagnostics;C-enhancement;E-mentor,A-diagnostics;C-enhancement;E-mentor",47804,2018-01-27T11:52:53Z,72,9,81
NULL,47806,2018-01-27T16:18:09Z,2,2,4
NULL,47810,2018-01-27T17:59:31Z,55,4,59
"B-RFC-approved,B-RFC-approved,B-unstable;C-tracking-issue;T-libs",47813,2018-01-27T20:15:03Z,187,256,443
NULL,47818,2018-01-28T06:41:54Z,0,0,0
NULL,47822,2018-01-28T12:47:24Z,1,1,2
"S-waiting-on-review,S-waiting-on-review",47824,2018-01-28T15:22:27Z,0,0,0
A-LLVM,47828,2018-01-28T19:15:22Z,41,14,55
NULL,47829,2018-01-28T19:17:06Z,9,0,9
NULL,47834,2018-01-28T22:53:20Z,27,6,33
"A-build;T-compiler;WG-compiler-nll,A-build;T-compiler;WG-compiler-nll",47836,2018-01-29T00:11:06Z,12,0,12
NULL,47837,2018-01-29T00:32:20Z,470,483,953
NULL,47839,2018-01-29T02:50:52Z,12,2,14
NULL,47840,2018-01-29T05:09:31Z,3,0,3
NULL,47843,2018-01-29T05:47:02Z,3255,55,3310
"S-waiting-on-review,S-waiting-on-review",47844,2018-01-29T07:47:06Z,33,0,33
NULL,47848,2018-01-29T11:23:38Z,0,0,0
NULL,47855,2018-01-29T16:52:45Z,20,1,21
"I-wrong;P-high,I-wrong;P-high,I-wrong;P-high,I-wrong;P-high",47857,2018-01-29T18:36:29Z,0,0,0
"S-waiting-on-review,S-waiting-on-review",47859,2018-01-29T20:19:05Z,0,0,0
NULL,47862,2018-01-29T22:05:27Z,31,2,33
NULL,47867,2018-01-30T07:55:49Z,0,0,0
NULL,47869,2018-01-30T08:29:47Z,0,0,0
S-waiting-on-review,47870,2018-01-30T09:11:01Z,706,188,894
A-NLL;T-compiler;WG-compiler-nll,47873,2018-01-30T11:43:59Z,65,4,69
NULL,47876,2018-01-30T13:21:13Z,24,5,29
A-amusing;A-traits,47877,2018-01-30T13:56:43Z,37,7,44
NULL,47891,2018-01-30T22:24:46Z,23,3,26
B-unstable;T-libs,47892,2018-01-30T22:47:55Z,105,1,106
"A-rustdoc,A-rustdoc",47894,2018-01-31T00:50:41Z,144,52,196
NULL,47895,2018-01-31T00:59:51Z,29,7,36
NULL,47896,2018-01-31T01:51:35Z,83,9,92
A-NLL;T-compiler;WG-compiler-nll,47898,2018-01-31T02:57:20Z,21,2,23
beta-nominated,47900,2018-01-31T08:36:20Z,320,48,368
A-runtime;C-bug;O-linux;T-libs,47912,2018-01-31T19:45:28Z,93,68,161
NULL,47914,2018-01-31T21:36:58Z,33,13,46
"T-compiler;WG-compiler-nll,T-compiler;WG-compiler-nll",47917,2018-02-01T00:41:34Z,134,7,141
NULL,47918,2018-02-01T00:54:09Z,307,93,400
T-libs,47919,2018-02-01T01:23:38Z,7,1,8
NULL,47926,2018-02-01T09:29:41Z,302,1,303
regression-from-stable-to-nightly,47933,2018-02-01T17:11:51Z,40,3,43
NULL,47956,2018-02-02T01:22:02Z,44,21,65
NULL,47957,2018-02-02T03:49:04Z,128,38,166
NULL,47958,2018-02-02T04:37:12Z,29,7,36
A-rustdoc;C-bug;I-ICE;regression-from-stable-to-beta,47959,2018-02-02T06:41:58Z,30,5,35
NULL,47964,2018-02-02T10:30:37Z,188,76,264
NULL,47970,2018-02-02T19:22:46Z,214,2,216
A-diagnostics;T-compiler,47982,2018-02-03T12:25:47Z,0,0,0
A-macros;B-RFC-approved;B-unstable;T-lang,47992,2018-02-04T03:33:12Z,0,0,0
A-diagnostics,48033,2018-02-06T13:57:50Z,57,0,57
NULL,48035,2018-02-06T14:27:53Z,38,26,64
NULL,48056,2018-02-07T19:17:59Z,653,14,667
NULL,48065,2018-02-08T03:16:08Z,1,16,17
B-unstable,48072,2018-02-08T16:15:24Z,79,11,90
NULL,48076,2018-02-08T19:40:05Z,62,12,74
NULL,48082,2018-02-09T00:08:49Z,62,24,86
NULL,48083,2018-02-09T00:50:49Z,33,5,38
B-unstable,48084,2018-02-09T00:51:39Z,295,89,384
A-rustdoc;T-doc,48095,2018-02-09T16:45:47Z,219,5,224
NULL,48105,2018-02-09T20:44:17Z,444,327,771
NULL,48110,2018-02-10T00:34:22Z,1,6,7
S-waiting-on-author,48114,2018-02-10T06:36:13Z,2,2,4
NULL,48123,2018-02-10T14:53:14Z,218,51,269
A-diagnostics,48138,2018-02-11T05:07:09Z,152,69,221
NULL,48139,2018-02-11T09:39:33Z,0,0,0
B-RFC-approved;T-lang,48143,2018-02-11T14:39:15Z,300,147,447
NULL,48146,2018-02-11T17:52:51Z,282,75,357
"S-waiting-on-review,A-const-fn;A-typesystem;B-RFC-approved;C-tracking-issue;T-compiler;T-lang",48149,2018-02-11T23:26:05Z,2565,2484,5049
NULL,48154,2018-02-12T06:12:56Z,43,5,48
NULL,48157,2018-02-12T09:48:19Z,42,6,48
NULL,48158,2018-02-12T10:46:10Z,0,0,0
NULL,48166,2018-02-12T19:28:49Z,2,81,83
NULL,48167,2018-02-12T19:37:16Z,5,3,8
NULL,48171,2018-02-12T22:10:19Z,221,42,263
"S-waiting-on-review,S-waiting-on-bors,S-waiting-on-bors,S-waiting-on-review,S-waiting-on-bors,S-waiting-on-bors",48177,2018-02-13T07:10:26Z,0,0,0
NULL,48181,2018-02-13T12:46:35Z,27,2,29
"A-diagnostics;T-compiler,A-diagnostics;T-compiler",48198,2018-02-14T04:28:36Z,20,46,66
"S-waiting-on-bors,S-waiting-on-review,S-waiting-on-bors,S-waiting-on-bors,S-waiting-on-review;T-libs,S-waiting-on-bors,S-waiting-on-bors;beta-nominated,S-waiting-on-review,S-waiting-on-bors,S-waiting-on-review;T-libs,S-waiting-on-bors,S-waiting-on-bors,S-waiting-on-bors;beta-nominated",48203,2018-02-14T08:14:52Z,805,211,1016
"A-incr-comp;C-enhancement;I-compiletime,A-incr-comp;C-enhancement;I-compiletime",48206,2018-02-14T11:52:24Z,112,47,159
NULL,48208,2018-02-14T15:30:34Z,231,141,372
A-spurious;C-tracking-issue;T-infra,48209,2018-02-14T15:43:14Z,34,34,68
"A-lint,A-lint",48221,2018-02-14T22:26:07Z,316,166,482
NULL,48235,2018-02-15T15:55:33Z,8,1,9
NULL,48239,2018-02-15T17:59:39Z,4,2,6
"I-compilemem;I-compiletime;T-compiler;WG-compiler-nll,I-compilemem;I-compiletime;T-compiler;WG-compiler-nll",48245,2018-02-15T20:10:33Z,276,54,330
NULL,48246,2018-02-15T22:44:29Z,48,3,51
"B-RFC-approved;T-libs,B-RFC-approved;T-libs",48259,2018-02-16T08:43:50Z,30,78,108
"S-waiting-on-bors,S-waiting-on-bors,S-waiting-on-review,S-waiting-on-bors",48261,2018-02-16T09:37:11Z,0,0,0
"B-unstable;T-libs,B-RFC-approved;C-tracking-issue;T-libs",48265,2018-02-16T11:10:19Z,210,89,299
NULL,48266,2018-02-16T11:26:34Z,80,5,85
NULL,48267,2018-02-16T11:27:59Z,0,0,0
NULL,48273,2018-02-16T13:53:06Z,15,0,15
"S-waiting-on-review;T-libs,C-tracking-issue;T-libs,S-waiting-on-review;T-libs,C-tracking-issue;T-libs",48282,2018-02-16T21:19:47Z,1,1,2
"A-associated-items;A-diagnostics;A-traits,A-associated-items;A-diagnostics;A-traits",48288,2018-02-17T02:24:56Z,0,0,0
NULL,48292,2018-02-17T07:36:46Z,27,0,27
"S-waiting-on-review,S-waiting-on-bors,S-waiting-on-bors,S-waiting-on-review,S-waiting-on-review,S-waiting-on-review",48294,2018-02-17T13:45:29Z,2185,1775,3960
"I-compiletime;T-compiler,I-compiletime;T-compiler,S-waiting-on-review,I-compiletime;T-compiler,I-compiletime;T-compiler",48296,2018-02-17T14:27:43Z,133,151,284
NULL,48305,2018-02-17T20:32:10Z,0,0,0
"C-bug;S-waiting-on-review;T-doc,S-waiting-on-review,S-waiting-on-review,C-bug;S-waiting-on-review;T-doc,S-waiting-on-review,S-waiting-on-review",48307,2018-02-17T22:40:20Z,0,0,0
"B-RFC-approved;T-lang,B-RFC-approved;T-lang",48309,2018-02-17T23:36:37Z,109,22,131
NULL,48315,2018-02-18T02:40:29Z,0,0,0
NULL,48321,2018-02-18T11:16:40Z,308,0,308
"C-bug;S-waiting-on-review;T-doc,S-waiting-on-review,S-waiting-on-review,S-waiting-on-review",48322,2018-02-18T12:21:04Z,243,1471,1714
NULL,48325,2018-02-18T14:30:50Z,7,7,14
NULL,48326,2018-02-18T18:56:05Z,324,108,432
"T-doc,T-doc",48328,2018-02-18T19:20:20Z,134,14,148
"T-doc,T-doc",48330,2018-02-18T21:10:03Z,95,3,98
"B-unstable;T-lang;T-libs,B-unstable;T-lang;T-libs,B-unstable;T-lang;T-libs,B-unstable;T-lang;T-libs",48333,2018-02-18T22:13:40Z,39,1392,1431
A-rustdoc;B-RFC-approved;T-dev-tools,48335,2018-02-18T22:57:51Z,61,16,77
NULL,48338,2018-02-18T23:14:28Z,189,37,226
"S-waiting-on-bors,S-waiting-on-bors",48340,2018-02-18T23:43:11Z,9,7,16
"S-waiting-on-review,S-waiting-on-bors,S-waiting-on-review,S-waiting-on-bors,S-waiting-on-review",48348,2018-02-19T05:55:21Z,0,0,0
"S-waiting-on-bors,S-waiting-on-review,S-waiting-on-review,S-waiting-on-bors,S-waiting-on-review,S-waiting-on-review,S-waiting-on-bors,S-waiting-on-review,S-waiting-on-review,S-waiting-on-bors",48350,2018-02-19T07:02:01Z,0,0,0
NULL,48356,2018-02-19T18:15:10Z,28,0,28
"A-debuginfo;A-metadata;B-unstable;T-compiler;T-tools,A-debuginfo;A-metadata;B-unstable;T-compiler;T-tools,A-debuginfo;A-metadata;B-unstable;T-compiler;T-tools",48359,2018-02-19T20:51:16Z,38,70,108
NULL,48362,2018-02-19T22:59:16Z,17,6,23
NULL,48363,2018-02-20T01:35:09Z,0,0,0
NULL,48365,2018-02-20T04:54:58Z,24,0,24
"T-compiler;T-tools,T-compiler;T-tools",48373,2018-02-20T15:48:47Z,0,0,0
NULL,48378,2018-02-20T18:26:52Z,0,0,0
"S-waiting-on-review,S-waiting-on-review",48379,2018-02-20T18:29:35Z,4,1,5
NULL,48380,2018-02-20T18:51:53Z,115,19,134
"A-rustdoc;T-dev-tools-rustdoc,A-rustdoc;T-dev-tools-rustdoc,A-rustdoc;T-dev-tools-rustdoc,A-rustdoc;T-dev-tools-rustdoc",48381,2018-02-20T19:14:04Z,35,11,46
NULL,48382,2018-02-20T19:30:55Z,38,12,50
A-lint,48386,2018-02-20T21:39:13Z,109,0,109
NULL,48388,2018-02-20T23:09:33Z,62,7,69
NULL,48397,2018-02-21T13:36:39Z,2,2,4
"S-waiting-on-review,S-waiting-on-review,S-waiting-on-review,S-waiting-on-review,S-waiting-on-review,S-waiting-on-review,S-waiting-on-review,S-waiting-on-review,S-waiting-on-review,S-waiting-on-review,S-waiting-on-review,S-waiting-on-review",48399,2018-02-21T15:29:59Z,2626,232,2858
"A-build;T-dev-tools;T-infra;WG-infra-rustbuild,A-build;T-dev-tools;T-infra;WG-infra-rustbuild",48405,2018-02-21T19:34:59Z,208,47,255
NULL,48407,2018-02-21T20:36:57Z,0,0,0
"S-waiting-on-review,S-waiting-on-review",48410,2018-02-21T22:18:05Z,3,10,13
"A-rustdoc;C-bug;I-ICE,A-rustdoc;C-bug;I-ICE",48415,2018-02-22T00:41:10Z,52,3,55
NULL,48419,2018-02-22T03:36:17Z,75,0,75
NULL,48420,2018-02-22T05:21:29Z,75,0,75
"B-RFC-approved;C-tracking-issue;T-lang,B-RFC-approved;C-tracking-issue;T-lang",48429,2018-02-22T14:14:30Z,1,1,2
NULL,48441,2018-02-22T22:00:04Z,8,2,10
S-waiting-on-review,48445,2018-02-22T23:49:46Z,86,22,108
NULL,48446,2018-02-22T23:52:21Z,45,17,62
"T-lang,T-lang",48448,2018-02-23T00:48:26Z,38,0,38
NULL,48449,2018-02-23T00:51:02Z,6878,6708,13586
NULL,48450,2018-02-23T00:54:39Z,5,23,28
"S-waiting-on-review,S-waiting-on-review",48454,2018-02-23T01:26:06Z,38,12,50
"A-lint;C-future-compatibility,A-lint;C-future-compatibility",48461,2018-02-23T08:25:41Z,234,46,280
NULL,48465,2018-02-23T10:52:16Z,0,0,0
NULL,48466,2018-02-23T12:53:03Z,8,8,16
"A-rustdoc;T-dev-tools-rustdoc,A-rustdoc;T-dev-tools-rustdoc",48473,2018-02-23T17:06:51Z,32,2,34
"T-doc,T-doc",48474,2018-02-23T18:01:22Z,18,0,18
"S-waiting-on-review,S-waiting-on-review,S-waiting-on-review,S-waiting-on-review,S-waiting-on-review,S-waiting-on-review,S-waiting-on-review,S-waiting-on-review",48476,2018-02-23T18:24:59Z,1035,313,1348
NULL,48477,2018-02-23T18:31:15Z,94,94,188
NULL,48479,2018-02-23T19:29:06Z,61,1312,1373
"A-NLL;T-compiler;WG-compiler-nll,A-NLL;T-compiler;WG-compiler-nll,A-NLL;T-compiler;WG-compiler-nll,A-NLL;T-compiler;WG-compiler-nll",48482,2018-02-23T21:04:01Z,358,33,391
"B-RFC-approved;C-tracking-issue;T-lang,B-RFC-approved;C-tracking-issue;T-lang",48490,2018-02-24T00:13:39Z,231,128,359
NULL,48494,2018-02-24T03:37:50Z,1,0,1
"T-lang,T-lang",48497,2018-02-24T08:39:59Z,23,8,31
NULL,48502,2018-02-24T13:36:25Z,0,0,0
NULL,48507,2018-02-24T15:51:43Z,2,0,2
"S-waiting-on-bors,S-waiting-on-review,S-waiting-on-bors,S-waiting-on-review,S-waiting-on-bors,S-waiting-on-review,S-waiting-on-review,S-waiting-on-bors,S-waiting-on-review,S-waiting-on-bors",48510,2018-02-24T16:55:54Z,1607,1224,2831
"S-waiting-on-review,S-waiting-on-review",48511,2018-02-24T18:15:21Z,64,27,91
"C-tracking-issue;T-lang;proposed-final-comment-period,C-tracking-issue;T-lang;proposed-final-comment-period",48516,2018-02-24T20:39:22Z,124,226,350
NULL,48517,2018-02-24T23:00:33Z,13,0,13
"S-waiting-on-review,S-waiting-on-review,S-waiting-on-review,S-waiting-on-review,S-waiting-on-review,S-waiting-on-bors,S-waiting-on-review,S-waiting-on-review,S-waiting-on-review,S-waiting-on-review,S-waiting-on-bors,S-waiting-on-review,S-waiting-on-review,S-waiting-on-review,S-waiting-on-review,S-waiting-on-review,S-waiting-on-bors,S-waiting-on-review,S-waiting-on-review,S-waiting-on-review,S-waiting-on-review,S-waiting-on-review,S-waiting-on-review,S-waiting-on-bors",48520,2018-02-24T23:52:21Z,941,546,1487
NULL,48522,2018-02-25T00:48:42Z,55,8,63
"S-waiting-on-review,S-waiting-on-review",48523,2018-02-25T01:08:05Z,966,806,1772
A-macros;A-plugin;B-RFC-approved,48524,2018-02-25T03:16:06Z,141,19,160
"S-waiting-on-review,S-waiting-on-review,S-waiting-on-review,S-waiting-on-review,S-waiting-on-review",48526,2018-02-25T05:08:46Z,0,0,0
NULL,48527,2018-02-25T05:13:35Z,174,5,179
"B-RFC-approved;B-unstable;T-lang,B-RFC-approved;B-unstable;T-lang",48528,2018-02-25T05:22:42Z,844,162,1006
"S-waiting-on-review,S-waiting-on-bors,S-waiting-on-bors,S-waiting-on-review,S-waiting-on-review,S-waiting-on-review,S-waiting-on-review,S-waiting-on-review,S-waiting-on-review,S-waiting-on-review,S-waiting-on-bors,S-waiting-on-review,S-waiting-on-bors,S-waiting-on-bors",48531,2018-02-25T07:54:56Z,1143,236,1379
NULL,48541,2018-02-25T23:05:28Z,16,1,17
NULL,48546,2018-02-26T14:05:48Z,47,8,55
"S-waiting-on-review,S-waiting-on-review",48548,2018-02-26T16:52:22Z,50,10,60
NULL,48552,2018-02-26T19:07:12Z,381,92,473
"B-RFC-approved;C-tracking-issue;T-lang,B-RFC-approved;C-tracking-issue;T-lang",48557,2018-02-26T21:32:24Z,1084,65,1149
NULL,48562,2018-02-26T23:21:42Z,0,0,0
"A-windows-msvc,A-windows-msvc,A-windows-msvc,A-windows-msvc",48567,2018-02-27T00:28:20Z,0,0,0
"A-rustbuild,A-rustbuild",48569,2018-02-27T01:54:41Z,15,25,40
NULL,48572,2018-02-27T03:53:58Z,127,6,133
NULL,48573,2018-02-27T04:38:41Z,120,4,124
NULL,48576,2018-02-27T08:30:55Z,5,2,7
"S-waiting-on-review,S-waiting-on-review,S-waiting-on-review,S-waiting-on-bors,S-waiting-on-bors,S-waiting-on-author,S-waiting-on-review,S-waiting-on-review,S-waiting-on-review,S-waiting-on-review,S-waiting-on-review,S-waiting-on-review,S-waiting-on-review,S-waiting-on-review",48577,2018-02-27T10:25:58Z,0,0,0
"B-unstable;E-easy;T-libs,B-unstable;E-easy;T-libs",48585,2018-02-27T16:14:38Z,43,141,184
NULL,48588,2018-02-27T18:37:06Z,136,166,302
"T-compiler;WG-compiler-nll,T-compiler;WG-compiler-nll",48592,2018-02-27T19:10:21Z,787,563,1350
"S-waiting-on-review,S-waiting-on-review",48596,2018-02-28T00:11:18Z,11,4,15
"A-NLL;A-diagnostics;C-bug;T-compiler;WG-compiler-nll,A-NLL;A-diagnostics;C-bug;T-compiler;WG-compiler-nll",48605,2018-02-28T09:10:45Z,414,119,533
"S-waiting-on-review,S-waiting-on-review,S-waiting-on-review,S-waiting-on-review,C-enhancement;S-waiting-on-review;T-doc,S-waiting-on-review,S-waiting-on-review,S-waiting-on-review,S-waiting-on-review,S-waiting-on-review,S-waiting-on-bors,S-waiting-on-bors,S-waiting-on-author,S-waiting-on-review,S-waiting-on-review,S-waiting-on-review",48608,2018-02-28T11:15:45Z,698,1394,2092
NULL,48610,2018-02-28T12:57:16Z,43,0,43
"S-waiting-on-review,S-waiting-on-review",48611,2018-02-28T15:16:56Z,413,271,684
"S-waiting-on-review,S-waiting-on-review,S-waiting-on-author,S-waiting-on-review,S-waiting-on-review,T-libs,S-waiting-on-author,S-waiting-on-review,C-enhancement;S-waiting-on-review;T-doc,S-waiting-on-review",48615,2018-02-28T17:32:30Z,677,148,825
"S-waiting-on-author,T-lang,S-waiting-on-author,T-lang",48618,2018-02-28T19:32:41Z,108,32,140
NULL,48621,2018-02-28T22:09:19Z,0,0,0
"regression-from-stable-to-beta,regression-from-stable-to-beta",48622,2018-02-28T22:58:09Z,0,0,0
"S-waiting-on-review,S-waiting-on-review",48626,2018-03-01T02:10:06Z,1,1,2
"A-spurious;C-tracking-issue;T-infra,A-spurious;C-tracking-issue;T-infra,A-spurious;C-tracking-issue;T-infra,A-spurious;C-tracking-issue;T-infra",48630,2018-03-01T05:35:47Z,28,5,33
"S-waiting-on-review,S-waiting-on-review,S-waiting-on-author;S-waiting-on-review,S-waiting-on-bors,S-waiting-on-review,S-waiting-on-review,S-waiting-on-review,S-waiting-on-review;relnotes,S-waiting-on-bors,S-waiting-on-review,S-waiting-on-review,S-waiting-on-bors,S-waiting-on-review,S-waiting-on-review,S-waiting-on-review,S-waiting-on-author;S-waiting-on-review,S-waiting-on-review,S-waiting-on-review;relnotes,S-waiting-on-bors",48632,2018-03-01T07:33:36Z,0,0,0
NULL,48637,2018-03-01T12:52:58Z,8,0,8
NULL,48639,2018-03-01T13:55:00Z,111,13,124
NULL,48651,2018-03-02T02:54:19Z,11,11,22
"S-waiting-on-review,S-waiting-on-review,S-waiting-on-author;S-waiting-on-review,S-waiting-on-review;relnotes,S-waiting-on-bors,S-waiting-on-review,S-waiting-on-bors,S-waiting-on-review,S-waiting-on-review,S-waiting-on-review",48652,2018-03-02T03:03:28Z,705,336,1041
NULL,48658,2018-03-02T06:36:19Z,185,0,185
NULL,48664,2018-03-02T12:51:26Z,16,4,20
"C-bug;I-compiletime;T-compiler;regression-from-stable-to-nightly,C-bug;I-compiletime;T-compiler;regression-from-stable-to-nightly",48666,2018-03-02T14:00:36Z,107,60,167
"T-compiler;WG-compiler-nll,T-compiler;WG-compiler-nll",48682,2018-03-02T20:09:04Z,1255,860,2115
"S-waiting-on-review,S-waiting-on-review,S-waiting-on-review,S-waiting-on-review,S-waiting-on-review,S-waiting-on-review,S-waiting-on-review,S-waiting-on-review",48687,2018-03-03T03:26:50Z,0,0,0
"S-waiting-on-review,S-waiting-on-review,S-waiting-on-review,S-waiting-on-review,S-waiting-on-review,S-waiting-on-review,S-waiting-on-review",48694,2018-03-03T10:45:53Z,287,44,331
"A-traits;C-cleanup;WG-compiler-traits,A-traits;C-cleanup;WG-compiler-traits",48698,2018-03-03T13:56:02Z,1,148,149
"S-waiting-on-review,S-waiting-on-review",48702,2018-03-03T17:01:00Z,0,0,0
NULL,48705,2018-03-03T19:16:33Z,4,4,8
NULL,48706,2018-03-03T20:31:07Z,117,109,226
NULL,48708,2018-03-03T22:48:04Z,0,0,0
"A-diagnostics;T-compiler,A-diagnostics;T-compiler",48709,2018-03-03T22:50:36Z,42,8,50
"A-traits;WG-compiler-traits,A-traits;WG-compiler-traits",48710,2018-03-04T00:53:31Z,40,85,125
"A-incr-comp;C-enhancement;I-compiletime,A-incr-comp;C-enhancement;I-compiletime",48712,2018-03-04T02:37:17Z,456,394,850
"S-waiting-on-bors,S-waiting-on-bors,S-waiting-on-bors,S-waiting-on-bors",48730,2018-03-04T12:18:00Z,5,3,8
NULL,48732,2018-03-04T14:04:28Z,0,11,11
NULL,48735,2018-03-04T19:44:08Z,512,477,989
NULL,48736,2018-03-04T20:13:54Z,1,0,1
"S-waiting-on-review,S-waiting-on-review,S-waiting-on-review,S-waiting-on-review,S-waiting-on-review,S-waiting-on-review,S-waiting-on-review",48744,2018-03-05T03:50:39Z,0,0,0
NULL,48755,2018-03-05T19:18:03Z,97,64,161
NULL,48756,2018-03-05T20:09:46Z,0,0,0
NULL,48757,2018-03-05T20:10:47Z,20,24,44
NULL,48765,2018-03-06T05:14:33Z,16,0,16
"S-waiting-on-review,S-waiting-on-review,S-waiting-on-review,S-waiting-on-review,S-waiting-on-review,S-waiting-on-review,S-waiting-on-review;T-doc,S-waiting-on-review,S-waiting-on-review,S-waiting-on-review,S-waiting-on-review,S-waiting-on-review,S-waiting-on-review",48768,2018-03-06T08:25:43Z,684,384,1068
NULL,48769,2018-03-06T08:29:08Z,0,0,0
"S-waiting-on-review,S-waiting-on-review;T-doc,S-waiting-on-review,S-waiting-on-review,S-waiting-on-review,S-waiting-on-review,S-waiting-on-review,S-waiting-on-review,S-waiting-on-review,S-waiting-on-review,S-waiting-on-review",48774,2018-03-06T09:48:20Z,0,0,0
"S-waiting-on-review,S-waiting-on-review,S-waiting-on-review,S-waiting-on-review,S-waiting-on-review,S-waiting-on-review,S-waiting-on-review,S-waiting-on-review;T-doc,S-waiting-on-review,S-waiting-on-review,S-waiting-on-review,S-waiting-on-review,S-waiting-on-review",48776,2018-03-06T12:40:35Z,0,0,0
"S-waiting-on-review,S-waiting-on-review",48779,2018-03-06T13:49:46Z,675,181,856
NULL,48782,2018-03-06T16:45:24Z,2,2,4
"T-compiler,A-debuginfo;I-slow,A-debuginfo;I-slow,T-compiler",48786,2018-03-06T18:35:23Z,31,5,36
NULL,48787,2018-03-06T18:36:51Z,1,2,3
NULL,48801,2018-03-07T00:18:15Z,328,263,591
"S-waiting-on-review,S-waiting-on-review,S-waiting-on-review,S-waiting-on-review,S-waiting-on-review,S-waiting-on-review,S-waiting-on-review,S-waiting-on-bors,S-waiting-on-review,S-waiting-on-review,S-waiting-on-review,S-waiting-on-review,S-waiting-on-review,S-waiting-on-review,S-waiting-on-review,S-waiting-on-review,S-waiting-on-review,S-waiting-on-bors",48806,2018-03-07T02:01:15Z,831,924,1755
NULL,48810,2018-03-07T04:24:02Z,309,0,309
"B-RFC-approved;T-libs,B-RFC-approved;T-libs",48813,2018-03-07T09:02:46Z,210,3,213
NULL,48814,2018-03-07T09:11:26Z,0,0,0
NULL,48818,2018-03-07T14:26:47Z,48,11,59
NULL,48830,2018-03-07T22:15:06Z,0,0,0
NULL,48834,2018-03-08T01:14:02Z,205,46,251
A-build;T-infra,48841,2018-03-08T11:46:23Z,0,0,0
B-RFC-approved;C-tracking-issue;T-lang,48842,2018-03-08T13:44:36Z,153,136,289
"S-waiting-on-review,S-waiting-on-review,S-waiting-on-review,S-waiting-on-bors,S-waiting-on-review,S-waiting-on-review,S-waiting-on-review",48849,2018-03-08T19:26:03Z,1464,1021,2485
NULL,48851,2018-03-08T19:56:10Z,45,244,289
"T-doc,T-doc",48856,2018-03-08T23:48:15Z,1,1,2
"T-doc,T-doc",48857,2018-03-08T23:49:13Z,1,1,2
NULL,48859,2018-03-09T01:24:24Z,1,1,2
"S-waiting-on-review,S-waiting-on-review;WG-epoch,S-waiting-on-review,S-waiting-on-review,S-waiting-on-review,S-waiting-on-review,S-waiting-on-review;WG-epoch,S-waiting-on-review,S-waiting-on-review,S-waiting-on-review",48860,2018-03-09T01:26:01Z,640,436,1076
"I-slow;WG-compiler-performance,I-slow;WG-compiler-performance",48864,2018-03-09T06:10:27Z,38,3,41
NULL,48874,2018-03-09T11:34:15Z,8,8,16
NULL,48886,2018-03-09T18:46:29Z,0,0,0
"A-macros-2.0,A-macros-2.0",48894,2018-03-09T21:47:31Z,0,0,0
"A-build;A-iOS;A-llvm;E-hard;I-enhancement;T-compiler;T-tools,A-build;A-iOS;A-llvm;E-hard;I-enhancement;T-compiler;T-tools",48896,2018-03-09T22:12:39Z,89,4,93
"S-waiting-on-review,S-waiting-on-review,S-waiting-on-review,S-waiting-on-review,S-waiting-on-review,S-waiting-on-review,S-waiting-on-review,S-waiting-on-review,S-waiting-on-review,S-waiting-on-review",48897,2018-03-09T23:36:13Z,0,0,0
"A-rustdoc,A-rustdoc",48898,2018-03-09T23:36:43Z,30,8,38
"A-NLL;C-cleanup;WG-compiler-nll,A-NLL;C-cleanup;WG-compiler-nll",48902,2018-03-10T04:33:23Z,94,94,188
NULL,48908,2018-03-10T12:39:20Z,2,2,4
"S-waiting-on-review,S-waiting-on-review",48909,2018-03-10T12:48:18Z,270,84,354
"S-waiting-on-review,S-waiting-on-bors,S-waiting-on-review,S-waiting-on-review",48912,2018-03-10T13:40:38Z,0,0,0
"A-diagnostics;E-needs-mentor;T-compiler;WG-compiler-nll,A-diagnostics;E-needs-mentor;T-compiler;WG-compiler-nll,A-diagnostics;E-needs-mentor;T-compiler;WG-compiler-nll,A-diagnostics;E-needs-mentor;T-compiler;WG-compiler-nll",48914,2018-03-10T15:27:28Z,182,24,206
NULL,48917,2018-03-10T17:05:56Z,228,260,488
"S-waiting-on-review,S-waiting-on-review,S-waiting-on-review,S-waiting-on-review,S-waiting-on-review,S-waiting-on-review,S-waiting-on-review,S-waiting-on-review",48921,2018-03-10T20:15:24Z,0,0,0
"B-RFC-approved;C-tracking-issue;T-lang,B-RFC-approved;C-tracking-issue;T-lang",48922,2018-03-10T21:25:27Z,153,1,154
NULL,48930,2018-03-11T09:55:37Z,82,20,102
"T-doc,T-doc",48932,2018-03-11T11:55:51Z,24,0,24
NULL,48938,2018-03-11T20:18:16Z,8,1,9
"B-RFC-approved;C-tracking-issue;T-lang,B-RFC-approved;C-tracking-issue;T-lang",48942,2018-03-11T22:57:55Z,519,145,664
NULL,48946,2018-03-12T01:40:37Z,46,1,47
"S-waiting-on-bors,S-waiting-on-review,S-waiting-on-review,S-waiting-on-review,S-waiting-on-review,S-waiting-on-bors,S-waiting-on-review,S-waiting-on-review,S-waiting-on-review,S-waiting-on-review",48947,2018-03-12T01:51:32Z,0,0,0
NULL,48949,2018-03-12T04:43:09Z,0,0,0
"S-waiting-on-review,S-waiting-on-review,S-waiting-on-bors,S-waiting-on-review,S-waiting-on-review,S-waiting-on-review,S-waiting-on-review,S-waiting-on-bors,S-waiting-on-review,S-waiting-on-review,S-waiting-on-bors,S-waiting-on-review,S-waiting-on-review,S-waiting-on-review",48955,2018-03-12T16:54:34Z,222,267,489
"A-typesystem;T-compiler,A-typesystem;T-compiler",48960,2018-03-12T20:32:31Z,80,4,84
NULL,48966,2018-03-12T21:34:14Z,12,8,20
S-waiting-on-review,48971,2018-03-13T01:07:15Z,15,438,453
S-waiting-on-review,48972,2018-03-13T01:11:04Z,2,171,173
"B-RFC-approved;T-libs,B-RFC-approved;T-libs",48973,2018-03-13T03:23:21Z,0,0,0
NULL,48981,2018-03-13T14:54:55Z,12,1,13
"S-waiting-on-review,S-waiting-on-review",48988,2018-03-13T18:25:42Z,35,0,35
NULL,48989,2018-03-13T19:02:17Z,11,9,20
NULL,48990,2018-03-13T19:35:21Z,43,2,45
NULL,48993,2018-03-13T21:06:44Z,6,0,6
"A-traits;T-compiler;WG-compiler-traits,S-waiting-on-review,A-traits;T-compiler;WG-compiler-traits,S-waiting-on-review",48995,2018-03-13T21:44:45Z,341,109,450
"A-diagnostics;C-enhancement,A-diagnostics;C-enhancement",48997,2018-03-13T22:28:07Z,0,0,0
NULL,48999,2018-03-13T23:16:46Z,91,53,144
"T-libs,A-const-fn;A-typesystem;B-RFC-approved;C-tracking-issue;T-compiler;T-lang,A-const-fn;A-typesystem;B-RFC-approved;C-tracking-issue;T-compiler;T-lang,T-libs",49000,2018-03-13T23:27:57Z,0,0,0
"A-incr-comp;E-mentor;I-compiletime;WG-compiler-performance,A-incr-comp;E-mentor;I-compiletime;WG-compiler-performance",49004,2018-03-14T03:25:42Z,6,1,7
NULL,49007,2018-03-14T05:59:53Z,42,27,69
"S-waiting-on-review,S-waiting-on-review,S-waiting-on-review,S-waiting-on-bors,S-waiting-on-review,S-waiting-on-review,S-waiting-on-review,S-waiting-on-review,S-waiting-on-review,S-waiting-on-bors,S-waiting-on-review,S-waiting-on-review",49008,2018-03-14T08:29:55Z,266,546,812
"T-doc,T-doc",49029,2018-03-14T23:09:57Z,401,364,765
"E-easy;E-mentor;WG-epoch,E-easy;E-mentor;WG-epoch",49035,2018-03-15T03:35:22Z,95,95,190
S-waiting-on-review,49039,2018-03-15T06:34:54Z,0,0,0
"A-impl-trait;T-compiler;WG-compiler-nll;WG-compiler-traits,A-impl-trait;T-compiler;WG-compiler-nll;WG-compiler-traits",49041,2018-03-15T09:57:23Z,427,84,511
A-spurious,49047,2018-03-15T15:18:44Z,0,0,0
NULL,49049,2018-03-15T17:08:48Z,1,1,2
NULL,49050,2018-03-15T17:49:09Z,5,23,28
"S-waiting-on-review,S-waiting-on-review,S-waiting-on-review,S-waiting-on-review,S-waiting-on-review,S-waiting-on-review,S-waiting-on-review,S-waiting-on-review,S-waiting-on-review,S-waiting-on-review;T-libs,S-waiting-on-review,S-waiting-on-review,S-waiting-on-review,S-waiting-on-review,S-waiting-on-review,S-waiting-on-review,S-waiting-on-review,S-waiting-on-review,S-waiting-on-review,S-waiting-on-review,S-waiting-on-review,S-waiting-on-review,S-waiting-on-review,S-blocked,S-waiting-on-review,S-waiting-on-review,S-waiting-on-review,S-waiting-on-review,S-waiting-on-review",49051,2018-03-15T17:49:53Z,637,462,1099
NULL,49055,2018-03-15T18:35:46Z,4,2,6
NULL,49064,2018-03-15T22:14:34Z,26,2,28
NULL,49066,2018-03-15T22:41:10Z,0,0,0
"A-incr-comp;C-enhancement;I-compiletime,A-incr-comp;C-enhancement;I-compiletime",49069,2018-03-16T02:27:53Z,20,10,30
NULL,49076,2018-03-16T07:54:38Z,32,3,35
NULL,49077,2018-03-16T08:02:52Z,49,4,53
"I-ICE;regression-from-stable-to-nightly,A-const-fn;I-ICE;I-nominated;T-compiler,I-ICE;regression-from-stable-to-nightly",49079,2018-03-16T09:03:37Z,212,126,338
NULL,49083,2018-03-16T10:50:37Z,1,1,2
NULL,49088,2018-03-16T15:23:57Z,9,2,11
"A-build;A-rustdoc;I-nominated;T-dev-tools;T-doc,A-build;A-rustdoc;I-nominated;T-dev-tools;T-doc",49090,2018-03-16T16:43:12Z,3,3,6
NULL,49091,2018-03-16T16:46:40Z,72,3,75
NULL,49092,2018-03-16T17:45:54Z,56,327,383
"A-build;A-rustbuild;T-infra,A-build;A-rustbuild;T-infra",49094,2018-03-16T19:30:57Z,81,22,103
"A-spurious;O-asmjs;T-infra,A-spurious;O-asmjs;T-infra",49095,2018-03-16T19:56:09Z,31,5,36
"B-RFC-approved;B-unstable;T-lang,B-RFC-approved;B-unstable;T-lang",49101,2018-03-17T01:17:30Z,106,301,407
NULL,49104,2018-03-17T05:51:39Z,21,10,31
NULL,49105,2018-03-17T09:06:42Z,31,0,31
"S-waiting-on-bors,S-waiting-on-review,S-waiting-on-bors,S-waiting-on-review,S-waiting-on-review,S-waiting-on-review,S-waiting-on-review",49106,2018-03-17T09:20:50Z,923,48,971
NULL,49109,2018-03-17T11:17:09Z,24,16,40
NULL,49117,2018-03-17T18:27:29Z,40,77,117
NULL,49121,2018-03-17T21:46:59Z,1,2,3
"S-waiting-on-review,A-macros;A-plugin;B-RFC-approved",49124,2018-03-18T00:21:08Z,334,33,367
NULL,49125,2018-03-18T01:11:54Z,1,0,1
"B-RFC-approved;T-libs,B-RFC-approved;T-libs",49130,2018-03-18T08:44:46Z,129,40,169
NULL,49152,2018-03-18T23:04:40Z,40,33,73
"S-waiting-on-review,S-waiting-on-review",49154,2018-03-19T00:59:47Z,791,858,1649
NULL,49157,2018-03-19T01:20:32Z,50,1,51
NULL,49158,2018-03-19T01:38:17Z,36,7,43
"A-diagnostics;C-enhancement,A-diagnostics;C-enhancement",49160,2018-03-19T06:03:36Z,104,42,146
"T-lang,T-lang",49162,2018-03-19T06:50:19Z,85,61,146
"S-waiting-on-author,S-waiting-on-author",49169,2018-03-19T13:12:44Z,2,0,2
NULL,49170,2018-03-19T13:35:36Z,5,2,7
"B-RFC-implemented;C-tracking-issue;T-lang,B-RFC-implemented;C-tracking-issue;T-lang",49172,2018-03-19T13:46:27Z,354,113,467
"S-waiting-on-bors,S-waiting-on-bors",49182,2018-03-19T19:00:10Z,8,8,16
NULL,49184,2018-03-19T19:43:02Z,1,1,2
"A-spurious;O-asmjs;T-infra,A-spurious;C-tracking-issue;T-infra,A-spurious;O-asmjs;T-infra,A-spurious;C-tracking-issue;T-infra",49187,2018-03-19T22:14:58Z,33,26,59
"A-rustdoc;C-enhancement,A-rustdoc;C-enhancement",49188,2018-03-19T23:04:54Z,19,0,19
NULL,49189,2018-03-19T23:13:04Z,28,10,38
"S-waiting-on-review,S-waiting-on-review;T-libs,S-waiting-on-review,S-waiting-on-review,S-waiting-on-review,S-waiting-on-review,S-waiting-on-review,S-waiting-on-review,S-waiting-on-review,S-waiting-on-review,S-waiting-on-review,S-waiting-on-bors;T-doc;T-libs,S-waiting-on-review,S-waiting-on-review,S-waiting-on-review,S-waiting-on-review,S-waiting-on-review,S-waiting-on-review;T-libs,S-waiting-on-review,S-waiting-on-review,S-waiting-on-review,S-waiting-on-review,S-waiting-on-review,S-waiting-on-review,S-waiting-on-review,S-waiting-on-review,S-waiting-on-review,S-waiting-on-review,S-waiting-on-review,S-waiting-on-bors;T-doc;T-libs,S-waiting-on-review",49190,2018-03-19T23:15:36Z,1029,649,1678
"A-docs;A-infrastructure;T-tools,A-docs;A-infrastructure;T-tools",49193,2018-03-20T02:09:17Z,202,45,247
NULL,49194,2018-03-20T02:38:54Z,96,124,220
NULL,49196,2018-03-20T03:43:27Z,67,37,104
NULL,49197,2018-03-20T06:29:16Z,0,0,0
NULL,49200,2018-03-20T09:41:49Z,38,3,41
NULL,49201,2018-03-20T09:43:23Z,117,0,117
NULL,49202,2018-03-20T10:02:33Z,196,118,314
NULL,49210,2018-03-20T14:39:38Z,66,38,104
"T-compiler;WG-compiler-traits,T-compiler;WG-compiler-traits",49211,2018-03-20T15:14:46Z,75,4,79
NULL,49212,2018-03-20T15:30:07Z,14,1,15
"S-waiting-on-review,S-waiting-on-review",49219,2018-03-20T21:56:23Z,3327,1168,4495
S-waiting-on-review,49221,2018-03-20T22:18:34Z,83,45,128
NULL,49222,2018-03-20T22:52:14Z,49,1,50
NULL,49223,2018-03-20T23:03:21Z,19,2,21
NULL,49224,2018-03-20T23:18:23Z,0,0,0
"C-enhancement;S-waiting-on-review;T-libs,C-enhancement;S-waiting-on-review;T-libs",49229,2018-03-21T07:06:27Z,78,6,84
"S-waiting-on-review,S-waiting-on-review,S-waiting-on-review,S-waiting-on-review,S-waiting-on-review,S-waiting-on-review;T-libs;relnotes,S-waiting-on-bors,S-waiting-on-bors,S-waiting-on-review,S-waiting-on-review,S-waiting-on-review,S-waiting-on-review,S-waiting-on-review,S-waiting-on-review,S-waiting-on-review,S-waiting-on-bors,S-waiting-on-review,S-waiting-on-review,S-waiting-on-review,S-waiting-on-review;T-libs;relnotes,S-waiting-on-review,S-waiting-on-bors,S-waiting-on-bors,S-waiting-on-review,S-waiting-on-review,S-waiting-on-review,S-waiting-on-review,S-waiting-on-review,S-waiting-on-bors",49236,2018-03-21T14:23:10Z,0,0,0
NULL,49243,2018-03-21T17:51:19Z,1,26,27
NULL,49244,2018-03-21T18:02:36Z,41,4,45
"S-waiting-on-review,S-waiting-on-review,S-waiting-on-review,S-waiting-on-review",49248,2018-03-21T20:23:17Z,0,0,0
"A-lifetimes,A-lifetimes,A-lifetimes",49251,2018-03-21T22:45:18Z,2081,1107,3188
"E-easy;E-mentor;WG-epoch,E-easy;E-mentor;WG-epoch",49252,2018-03-21T22:51:49Z,31,14,45
"S-waiting-on-review,B-unstable,S-waiting-on-review,B-unstable",49255,2018-03-22T01:42:09Z,72,343,415
"S-waiting-on-review,S-waiting-on-review",49258,2018-03-22T05:46:11Z,151,2,153
NULL,49262,2018-03-22T09:00:10Z,56,7,63
"S-waiting-on-bors,S-waiting-on-review,S-waiting-on-review,S-waiting-on-review,S-waiting-on-review,S-waiting-on-review,S-waiting-on-review,S-waiting-on-review,S-waiting-on-bors,S-waiting-on-bors,S-waiting-on-review,S-waiting-on-review,S-waiting-on-review,S-waiting-on-review,S-waiting-on-review,S-waiting-on-review,S-waiting-on-review,S-waiting-on-review,S-waiting-on-review,S-waiting-on-review;T-libs;relnotes",49264,2018-03-22T09:51:42Z,1548,1138,2686
NULL,49266,2018-03-22T10:56:51Z,0,0,0
NULL,49268,2018-03-22T11:59:08Z,44,1,45
"A-macros;C-bug;I-ICE;regression-from-stable-to-beta;regression-from-stable-to-nightly,A-macros;A-metadata;T-compiler,A-macros;A-metadata;T-compiler,A-macros;C-bug;I-ICE;regression-from-stable-to-beta;regression-from-stable-to-nightly",49273,2018-03-22T13:45:19Z,19,2,21
"I-slow;WG-compiler-performance,I-slow;WG-compiler-performance",49274,2018-03-22T14:16:39Z,44,58,102
NULL,49279,2018-03-22T16:40:19Z,13,13,26
NULL,49283,2018-03-22T18:17:01Z,197,33,230
"A-rustbuild;C-enhancement;T-infra,A-rustbuild;C-enhancement;T-infra",49284,2018-03-22T21:32:27Z,38,16,54
NULL,49289,2018-03-23T00:00:14Z,3,2,5
NULL,49291,2018-03-23T03:23:38Z,120,9,129
NULL,49293,2018-03-23T03:52:10Z,82,22,104
NULL,49295,2018-03-23T06:44:55Z,30,0,30
S-waiting-on-review;T-compiler;T-libs,49297,2018-03-23T08:35:31Z,295,4,299
B-RFC-approved;T-lang,49299,2018-03-23T10:53:25Z,26,171,197
"S-waiting-on-review,S-waiting-on-review,S-waiting-on-review,S-waiting-on-review,S-waiting-on-review,S-waiting-on-review,S-waiting-on-review,S-waiting-on-review,S-waiting-on-review,S-waiting-on-review,S-waiting-on-review,S-waiting-on-review",49302,2018-03-23T12:32:59Z,0,0,0
"S-waiting-on-review,S-waiting-on-review",49304,2018-03-23T13:38:10Z,127,28,155
"B-RFC-approved;T-libs,B-RFC-approved;T-libs",49305,2018-03-23T13:41:32Z,147,223,370
"S-waiting-on-review,S-waiting-on-review,S-waiting-on-review,S-waiting-on-review,S-waiting-on-review,S-waiting-on-review,S-waiting-on-review,S-waiting-on-review,S-waiting-on-review,S-waiting-on-review,S-waiting-on-review,S-waiting-on-review,S-waiting-on-review",49306,2018-03-23T13:53:15Z,0,0,0
"S-waiting-on-review,S-waiting-on-review,S-waiting-on-review,S-waiting-on-review,S-waiting-on-review,S-waiting-on-review,S-waiting-on-review,S-waiting-on-review,S-waiting-on-review,S-waiting-on-review,S-waiting-on-review,S-waiting-on-review,S-waiting-on-review,S-waiting-on-review",49308,2018-03-23T14:27:29Z,3062,623,3685
A-build;A-rustbuild;WG-infra-rustbuild,49311,2018-03-23T18:56:22Z,6,0,6
"A-rustdoc,A-rustdoc",49312,2018-03-23T20:27:45Z,7,0,7
"S-waiting-on-author,S-waiting-on-author",49313,2018-03-23T20:37:17Z,97,244,341
NULL,49314,2018-03-23T21:09:03Z,0,1622,1622
NULL,49316,2018-03-23T21:40:42Z,154,0,154
NULL,49317,2018-03-23T22:05:47Z,0,0,0
"B-RFC-approved;C-tracking-issue;T-libs,B-RFC-approved;C-tracking-issue;T-libs",49320,2018-03-24T01:20:44Z,0,0,0
"S-waiting-on-review,C-enhancement;S-waiting-on-review;T-doc,S-waiting-on-review,S-waiting-on-bors,S-waiting-on-review,S-waiting-on-review,S-waiting-on-review;relnotes,S-waiting-on-review,S-waiting-on-review,S-waiting-on-review,S-waiting-on-bors;beta-nominated,S-waiting-on-review,S-waiting-on-review,S-waiting-on-bors;beta-nominated,S-waiting-on-review,S-waiting-on-review,S-waiting-on-review,S-waiting-on-review,S-waiting-on-review,S-waiting-on-review",49324,2018-03-24T10:18:45Z,25,7,32
NULL,49325,2018-03-24T10:25:44Z,0,0,0
"S-waiting-on-bors;beta-nominated,T-compiler;beta-nominated,S-waiting-on-bors;beta-nominated",49329,2018-03-24T14:07:44Z,4,2,6
NULL,49332,2018-03-24T14:43:02Z,21,4,25
"S-waiting-on-review,S-waiting-on-review,S-waiting-on-review,S-waiting-on-review,S-waiting-on-review,S-waiting-on-review,S-waiting-on-review,S-waiting-on-bors;beta-nominated,S-waiting-on-review,S-waiting-on-review,S-waiting-on-review,C-enhancement;S-waiting-on-review;T-doc,S-waiting-on-bors,S-waiting-on-review,S-waiting-on-bors;beta-nominated,S-waiting-on-review,S-waiting-on-review;relnotes,S-waiting-on-review,S-waiting-on-review,S-waiting-on-review",49333,2018-03-24T15:38:53Z,32,8,40
"A-rustbuild;T-infra,A-rustbuild;T-infra",49337,2018-03-24T17:26:49Z,1011,2530,3541
NULL,49341,2018-03-24T20:47:02Z,11,4,15
NULL,49345,2018-03-24T22:41:33Z,82,0,82
"A-NLL;I-needs-decision;WG-compiler-nll,A-NLL;I-needs-decision;WG-compiler-nll",49346,2018-03-24T23:54:59Z,55,0,55
NULL,49348,2018-03-25T03:32:05Z,155,57,212
S-waiting-on-review,49350,2018-03-25T04:23:32Z,544,65,609
NULL,49357,2018-03-25T11:32:53Z,1130,1127,2257
"S-waiting-on-review,S-waiting-on-review",49364,2018-03-25T17:46:27Z,7,2,9
"A-associated-items;A-stability,A-associated-items;A-stability",49366,2018-03-25T21:09:51Z,0,0,0
NULL,49368,2018-03-25T21:43:36Z,32,5,37
"S-waiting-on-review,S-waiting-on-review,S-waiting-on-review,S-waiting-on-review,S-waiting-on-review,S-waiting-on-review,S-waiting-on-review",49371,2018-03-26T03:03:12Z,132,43,175
"S-waiting-on-bors;beta-nominated,S-waiting-on-review,S-waiting-on-review,S-waiting-on-review,S-waiting-on-review,S-waiting-on-review;relnotes,S-waiting-on-review,S-waiting-on-review,S-waiting-on-bors;beta-nominated,S-waiting-on-review,S-waiting-on-review,S-waiting-on-review,S-waiting-on-review,S-waiting-on-review,S-waiting-on-review,S-waiting-on-review,S-waiting-on-bors;beta-nominated,S-waiting-on-review,S-waiting-on-review,S-waiting-on-review,S-waiting-on-bors,S-waiting-on-review,S-waiting-on-review,S-waiting-on-review,S-waiting-on-review,S-waiting-on-review;relnotes,S-waiting-on-review,S-waiting-on-review,S-waiting-on-review,S-waiting-on-bors;beta-nominated,S-waiting-on-review,S-waiting-on-review,S-waiting-on-review,S-waiting-on-review,S-waiting-on-review,S-waiting-on-bors,S-waiting-on-review,S-waiting-on-review",49374,2018-03-26T09:23:58Z,0,0,0
"S-waiting-on-review,S-waiting-on-review,S-waiting-on-review,S-waiting-on-review,S-waiting-on-review,S-waiting-on-review",49379,2018-03-26T13:15:02Z,181,37,218
NULL,49386,2018-03-26T15:19:40Z,7,4,11
"B-RFC-approved;T-libs,B-RFC-approved;T-libs",49389,2018-03-26T18:35:03Z,541,0,541
"A-NLL;I-ICE;WG-compiler-nll,A-NLL;I-ICE;WG-compiler-nll",49392,2018-03-26T20:11:26Z,167,23,190
NULL,49393,2018-03-26T20:47:01Z,0,0,0
"B-RFC-approved;T-lang,T-compiler;WG-compiler-middle,T-compiler;WG-compiler-middle,T-compiler;WG-compiler-middle,B-RFC-approved;T-lang,T-compiler;WG-compiler-middle",49394,2018-03-26T21:45:03Z,55,389,444
NULL,49399,2018-03-26T23:21:17Z,6,6,12
NULL,49400,2018-03-26T23:34:23Z,237,2,239
NULL,49403,2018-03-27T06:32:07Z,38,6,44
"S-waiting-on-review;T-libs,S-waiting-on-review;T-libs",49404,2018-03-27T08:17:44Z,0,0,0
"A-rustdoc,A-rustdoc",49405,2018-03-27T08:34:16Z,20,3,23
"S-waiting-on-review,S-waiting-on-review,S-waiting-on-bors,S-waiting-on-review,S-waiting-on-review,S-waiting-on-review,S-waiting-on-author,S-waiting-on-review,S-waiting-on-review,S-waiting-on-review,S-waiting-on-review,S-waiting-on-bors,S-waiting-on-review,S-waiting-on-review,S-waiting-on-review,S-waiting-on-review,S-waiting-on-bors,S-waiting-on-author,S-waiting-on-review",49406,2018-03-27T08:47:56Z,253,126,379
NULL,49418,2018-03-27T13:38:00Z,80,2,82
NULL,49422,2018-03-27T17:30:01Z,2,6,8
A-associated-items;A-traits;A-typesystem;B-RFC-approved;B-unstable;C-tracking-issue;T-lang,49423,2018-03-27T17:51:37Z,401,16,417
A-const-fn;I-ICE;I-nominated;T-compiler,49424,2018-03-27T18:38:59Z,50,12,62
NULL,49427,2018-03-27T19:27:53Z,117,10,127
NULL,49432,2018-03-27T21:30:25Z,38,4,42
"A-metadata;I-compiletime;WG-compiler-performance,A-metadata;I-compiletime;WG-compiler-performance",49433,2018-03-27T21:55:11Z,14,3,17
"T-compiler;WG-compiler-traits,T-compiler;WG-compiler-traits",49435,2018-03-28T03:44:27Z,212,5,217
NULL,49442,2018-03-28T08:43:46Z,55,32,87
NULL,49444,2018-03-28T08:50:22Z,0,59,59
NULL,49447,2018-03-28T10:05:13Z,18,36,54
NULL,49452,2018-03-28T12:10:58Z,4,3,7
A-rustdoc;B-RFC-approved;T-dev-tools,49459,2018-03-28T15:32:41Z,91,13,104
"S-waiting-on-review,S-waiting-on-review,S-waiting-on-review,S-waiting-on-review,S-waiting-on-bors,S-waiting-on-review,S-waiting-on-review,S-waiting-on-review,S-waiting-on-review,S-waiting-on-review",49460,2018-03-28T15:55:21Z,472,158,630
NULL,49465,2018-03-29T00:10:24Z,4,1,5
B-RFC-approved;T-lang,49469,2018-03-29T03:46:54Z,143,22,165
NULL,49479,2018-03-29T11:29:07Z,4,3,7
"S-waiting-on-bors,S-waiting-on-bors,S-waiting-on-review,S-waiting-on-bors,S-waiting-on-bors,S-waiting-on-bors,S-waiting-on-bors,S-waiting-on-bors,S-waiting-on-bors,S-waiting-on-review,S-waiting-on-bors,S-waiting-on-bors",49489,2018-03-29T23:31:22Z,41,33,74
"S-waiting-on-review,S-waiting-on-review",49499,2018-03-30T09:45:39Z,0,0,0
NULL,49508,2018-03-30T13:03:19Z,0,0,0
"A-rustdoc;B-RFC-approved;T-dev-tools,A-rustdoc;B-RFC-approved;T-dev-tools",49512,2018-03-30T13:44:55Z,55,3,58
NULL,49513,2018-03-30T13:55:54Z,116,15,131
S-waiting-on-review,49518,2018-03-30T14:43:06Z,0,5,5
"S-waiting-on-review,S-waiting-on-review",49521,2018-03-30T17:13:39Z,2,2,4
NULL,49522,2018-03-30T17:18:23Z,8,7,15
"S-waiting-on-review,S-waiting-on-review",49525,2018-03-30T20:32:19Z,33,34,67
NULL,49532,2018-03-31T05:03:26Z,15,0,15
NULL,49533,2018-03-31T06:09:37Z,4,1,5
NULL,49540,2018-03-31T11:58:38Z,19,10,29
A-macros-2.0,49545,2018-03-31T21:18:08Z,164,54,218
NULL,49546,2018-03-31T22:11:23Z,5,17,22
NULL,49547,2018-04-01T00:38:45Z,0,1,1
NULL,49550,2018-04-01T04:09:14Z,0,0,0
NULL,49551,2018-04-01T05:36:47Z,19,13,32
NULL,49552,2018-04-01T06:44:32Z,0,0,0
NULL,49555,2018-04-01T10:01:55Z,9,1,10
NULL,49559,2018-04-01T14:59:37Z,57,7,64
"S-waiting-on-bors,S-waiting-on-review",49561,2018-04-01T16:04:58Z,103,40,143
"WG-embedded,WG-embedded",49563,2018-04-01T17:01:30Z,78,36,114
"B-RFC-approved;B-unstable;T-lang;T-libs,B-RFC-approved;B-unstable;T-lang;T-libs",49573,2018-04-02T02:17:58Z,15,14,29
NULL,49574,2018-04-02T03:58:52Z,1,2,3
"B-unstable;C-tracking-issue;T-libs,B-unstable;C-tracking-issue;T-libs",49575,2018-04-02T04:37:10Z,1,4,5
NULL,49585,2018-04-02T11:20:58Z,137,137,274
A-macros-2.0,49597,2018-04-02T19:16:59Z,732,314,1046
"A-traits;WG-compiler-traits,S-waiting-on-author,A-traits;WG-compiler-traits,S-waiting-on-author",49598,2018-04-02T19:28:30Z,0,0,0
NULL,49603,2018-04-02T22:06:00Z,32,1,33
NULL,49606,2018-04-02T22:57:38Z,19,3,22
NULL,49607,2018-04-03T00:02:02Z,6,21,27
"B-RFC-approved;B-unstable;T-lang;T-libs,B-RFC-approved;B-unstable;T-lang;T-libs",49608,2018-04-03T00:09:26Z,0,0,0
"S-waiting-on-review,S-waiting-on-review",49609,2018-04-03T00:22:26Z,28,1,29
"WG-epoch,WG-epoch",49611,2018-04-03T01:17:53Z,0,0,0
"C-enhancement;T-release,C-enhancement;T-release",49612,2018-04-03T01:35:07Z,1,1,2
"B-unstable;T-libs,B-unstable;T-libs",49613,2018-04-03T01:45:58Z,0,0,0
NULL,49614,2018-04-03T03:20:17Z,30,0,30
"S-waiting-on-review,S-waiting-on-review,S-waiting-on-review,S-waiting-on-bors,S-waiting-on-review",49615,2018-04-03T07:55:01Z,0,0,0
NULL,49618,2018-04-03T12:35:40Z,1,0,1
"S-waiting-on-bors,S-waiting-on-review,S-waiting-on-review,S-waiting-on-review,S-waiting-on-review,S-waiting-on-bors,S-waiting-on-bors;relnotes,S-waiting-on-bors,S-waiting-on-bors,S-waiting-on-review,S-waiting-on-review,S-waiting-on-bors,S-waiting-on-review,S-waiting-on-bors,S-waiting-on-review,S-waiting-on-bors,S-waiting-on-bors,S-waiting-on-bors",49620,2018-04-03T13:42:50Z,0,0,0
"T-compiler;WG-compiler-traits,T-compiler;WG-compiler-traits",49626,2018-04-03T16:04:33Z,87,5,92
NULL,49633,2018-04-04T01:14:36Z,0,0,0
NULL,49634,2018-04-04T01:26:33Z,38,0,38
"B-unstable;T-libs,B-unstable;T-libs",49637,2018-04-04T01:48:02Z,1,1,2
E-mentor;T-compiler;WG-compiler-nll,49641,2018-04-04T08:45:14Z,53,0,53
"S-waiting-on-bors,S-waiting-on-bors,S-waiting-on-bors,S-waiting-on-bors,S-waiting-on-review,S-waiting-on-bors,S-waiting-on-bors,S-waiting-on-review,S-waiting-on-review,S-waiting-on-review,S-waiting-on-review;relnotes,S-waiting-on-review",49642,2018-04-04T09:07:32Z,595,160,755
"T-dev-tools-rustdoc,T-dev-tools-rustdoc",49652,2018-04-04T14:17:44Z,23,10,33
"A-docs;A-infrastructure;T-tools,A-docs;A-infrastructure;T-tools",49654,2018-04-04T15:16:13Z,16,11,27
"B-unstable;T-lang,B-unstable;T-libs,B-unstable;T-lang,B-unstable;T-libs",49664,2018-04-04T19:44:12Z,243,166,409
NULL,49666,2018-04-04T21:02:26Z,0,0,0
"B-RFC-approved;T-lang,B-RFC-approved,B-RFC-approved;T-lang,B-RFC-approved",49669,2018-04-04T21:39:45Z,1038,1496,2534
"S-waiting-on-review,S-waiting-on-review",49672,2018-04-04T23:57:33Z,29,11,40
"S-waiting-on-review,S-waiting-on-review",49673,2018-04-05T00:38:56Z,10,8,18
"S-waiting-on-review,S-waiting-on-review,S-waiting-on-review,WG-embedded,S-waiting-on-review,S-waiting-on-review,S-waiting-on-review,S-waiting-on-review,S-waiting-on-review,S-waiting-on-review,S-waiting-on-review,WG-embedded,S-waiting-on-review,S-waiting-on-review,S-waiting-on-review,S-waiting-on-review",49675,2018-04-05T00:43:23Z,0,0,0
"S-waiting-on-review,S-waiting-on-review",49678,2018-04-05T03:20:00Z,92,14,106
"B-unstable;T-libs,B-unstable;T-libs",49681,2018-04-05T06:31:29Z,1,2,3
"S-waiting-on-review,S-waiting-on-review,S-waiting-on-review,S-waiting-on-review,S-waiting-on-bors,S-waiting-on-bors,WG-embedded",49684,2018-04-05T08:51:28Z,567,121,688
NULL,49692,2018-04-05T15:33:50Z,79,8,87
"S-waiting-on-review,S-waiting-on-review",49695,2018-04-05T15:48:00Z,52,35,87
"S-waiting-on-review,S-waiting-on-bors,S-waiting-on-review",49696,2018-04-05T15:49:23Z,1978,619,2597
"B-unstable;T-libs,B-unstable;T-libs",49698,2018-04-05T17:30:01Z,1398,1537,2935
NULL,49704,2018-04-05T18:27:57Z,13,3,16
NULL,49705,2018-04-05T18:38:31Z,22,0,22
NULL,49711,2018-04-05T20:00:54Z,698,541,1239
NULL,49714,2018-04-05T21:20:23Z,158,23,181
NULL,49715,2018-04-05T22:00:55Z,29,63,92
NULL,49718,2018-04-06T00:42:31Z,759,676,1435
"B-unstable;C-tracking-issue;T-libs,B-unstable;C-tracking-issue;T-libs",49724,2018-04-06T08:36:11Z,139,54,193
NULL,49728,2018-04-06T13:49:32Z,21,3,24
"A-testsuite;E-easy,A-testsuite;E-easy",49729,2018-04-06T14:09:52Z,59,15,74
NULL,49730,2018-04-06T14:33:12Z,29,3,32
"WG-embedded,WG-embedded",49731,2018-04-06T14:36:47Z,4,0,4
"A-macros;T-libs;regression-from-stable-to-nightly,A-macros;T-libs;regression-from-stable-to-nightly",49734,2018-04-06T14:45:42Z,9,2,11
T-doc,49742,2018-04-06T19:17:24Z,12,12,24
"S-waiting-on-bors,S-waiting-on-bors,T-doc,S-waiting-on-review,S-waiting-on-review,S-waiting-on-bors;relnotes",49744,2018-04-06T19:56:20Z,0,0,0
"A-macros-2.0,A-macros-2.0",49748,2018-04-06T22:22:32Z,63,35,98
"S-waiting-on-review,S-waiting-on-review",49750,2018-04-06T22:38:31Z,1,4,5
NULL,49752,2018-04-07T03:07:42Z,65,1,66
"T-doc,S-waiting-on-review,S-waiting-on-bors,S-waiting-on-review,S-waiting-on-bors,S-waiting-on-bors,S-waiting-on-bors",49753,2018-04-07T06:51:35Z,188,80,268
"A-lint;E-mentor,A-lint;E-mentor",49755,2018-04-07T10:59:47Z,0,0,0
NULL,49757,2018-04-07T12:04:38Z,293,11,304
NULL,49759,2018-04-07T14:16:42Z,1,1,2
"A-docs,A-docs",49767,2018-04-07T22:16:46Z,430,101,531
"A-tools;E-mentor,A-tools;E-mentor",49770,2018-04-08T02:22:54Z,2,3,5
NULL,49771,2018-04-08T02:33:02Z,1,7,8
"A-build;I-wrong;T-tools,A-build;I-wrong;T-tools",49778,2018-04-08T09:24:08Z,3,1,4
NULL,49779,2018-04-08T10:54:23Z,129,30,159
NULL,49780,2018-04-08T11:09:35Z,0,0,0
NULL,49781,2018-04-08T11:15:05Z,63,0,63
NULL,49789,2018-04-08T16:06:19Z,204,8,212
B-unstable;T-compiler,49799,2018-04-09T07:31:33Z,34,113,147
"C-cleanup;T-compiler;WG-compiler-traits,C-cleanup;T-compiler;WG-compiler-traits",49800,2018-04-09T07:41:57Z,151,59,210
NULL,49808,2018-04-09T17:10:13Z,69,13,82
"A-rustbuild,A-rustbuild",49809,2018-04-09T17:41:27Z,3,1,4
A-spurious;O-android;T-release,49811,2018-04-09T18:42:12Z,6,4,10
NULL,49812,2018-04-09T18:48:42Z,70,71,141
"A-unicode;T-libs;proposed-final-comment-period,A-unicode;T-libs;proposed-final-comment-period",49818,2018-04-09T20:55:12Z,0,0,0
"A-NLL;WG-compiler-nll,A-NLL;WG-compiler-nll",49822,2018-04-09T21:58:23Z,102,40,142
NULL,49823,2018-04-09T22:04:24Z,8,7,15
"S-waiting-on-review,S-waiting-on-review",49825,2018-04-09T23:13:28Z,0,0,0
"S-waiting-on-review,S-waiting-on-review",49826,2018-04-10T00:37:54Z,2,1,3
"A-docs,A-docs",49829,2018-04-10T02:09:52Z,135,60,195
NULL,49830,2018-04-10T02:29:02Z,74,17,91
NULL,49833,2018-04-10T08:17:09Z,271,307,578
NULL,49834,2018-04-10T09:13:32Z,17,10,27
B-RFC-approved;B-unstable;T-lang,49835,2018-04-10T09:25:43Z,251,15,266
"A-traits;T-compiler;WG-compiler-traits,A-traits;T-compiler;WG-compiler-traits",49840,2018-04-10T12:52:00Z,0,0,0
NULL,49843,2018-04-10T13:19:42Z,13,3,16
"A-rls;A-save-analysis;T-dev-tools,A-rls;A-save-analysis;T-dev-tools",49847,2018-04-10T17:19:55Z,227,49,276
"E-easy;I-cleanup,E-easy;I-cleanup",49849,2018-04-10T17:47:28Z,1,1,2
"A-macros-2.0,A-macros-2.0,A-macros-2.0,A-macros-2.0",49852,2018-04-10T20:06:15Z,121,12,133
NULL,49856,2018-04-10T21:32:27Z,6,0,6
NULL,49857,2018-04-10T21:40:18Z,1,0,1
NULL,49861,2018-04-10T22:51:24Z,3626,56,3682
"S-waiting-on-review,S-waiting-on-review",49864,2018-04-11T00:27:00Z,41,5,46
NULL,49868,2018-04-11T10:12:23Z,0,0,0
NULL,49870,2018-04-11T10:38:08Z,505,92,597
NULL,49871,2018-04-11T11:06:00Z,89,0,89
"S-waiting-on-review,S-waiting-on-author,S-waiting-on-review,S-waiting-on-review,S-waiting-on-review,S-waiting-on-bors,S-waiting-on-review,S-waiting-on-review,S-waiting-on-review,S-waiting-on-review,S-waiting-on-bors",49875,2018-04-11T11:56:55Z,243,64,307
B-RFC-approved;C-tracking-issue;T-lang,49878,2018-04-11T13:43:48Z,711,13,724
"S-waiting-on-review,S-waiting-on-review",49880,2018-04-11T15:09:39Z,65,1,66
NULL,49881,2018-04-11T15:26:33Z,245,96,341
NULL,49885,2018-04-11T18:15:40Z,75,20,95
"A-testsuite;C-bug;T-compiler,A-testsuite;C-bug;T-compiler",49891,2018-04-11T22:43:49Z,7,3,10
NULL,49894,2018-04-12T02:10:14Z,307,149,456
"B-unstable;T-libs,B-unstable;T-libs",49896,2018-04-12T07:58:08Z,4091,3997,8088
NULL,49900,2018-04-12T10:05:36Z,327,268,595
NULL,49902,2018-04-12T11:14:35Z,0,0,0
NULL,49904,2018-04-12T13:17:41Z,22,7,29
NULL,49906,2018-04-12T14:00:44Z,71,16,87
NULL,49908,2018-04-12T14:08:24Z,1,1,2
NULL,49911,2018-04-12T19:32:40Z,79,34,113
"S-waiting-on-review,S-waiting-on-review,S-waiting-on-review,S-waiting-on-bors;beta-accepted;beta-nominated,S-waiting-on-review,S-waiting-on-review,S-waiting-on-review,S-waiting-on-review,S-waiting-on-bors;beta-accepted;beta-nominated",49924,2018-04-13T09:11:05Z,0,0,0
"A-diagnostics,A-diagnostics",49931,2018-04-13T14:04:18Z,19,5,24
NULL,49933,2018-04-13T14:09:22Z,80,84,164
"S-waiting-on-review,S-waiting-on-review,S-waiting-on-review,S-waiting-on-review,S-waiting-on-review,S-waiting-on-review,S-waiting-on-review,S-waiting-on-review,S-waiting-on-review,S-waiting-on-review,S-waiting-on-bors;beta-accepted;beta-nominated,S-waiting-on-review,S-waiting-on-bors;beta-accepted;beta-nominated,S-waiting-on-review,S-waiting-on-review,S-waiting-on-review,S-waiting-on-review,S-waiting-on-review,S-waiting-on-review,S-waiting-on-review,S-waiting-on-review,S-waiting-on-review,S-waiting-on-bors;beta-accepted;beta-nominated",49939,2018-04-13T14:59:24Z,369,89,458
"A-NLL;A-generators;WG-compiler-nll,A-NLL;A-generators;WG-compiler-nll",49943,2018-04-13T15:26:55Z,106,40,146
"A-const-fn;C-bug;T-compiler;regression-from-stable-to-beta,A-const-fn;C-bug;T-compiler;regression-from-stable-to-beta",49947,2018-04-13T15:58:59Z,10,18,28
"S-waiting-on-review,S-waiting-on-review,S-waiting-on-review,S-waiting-on-review",49948,2018-04-13T16:00:33Z,0,0,0
"C-bug;I-nominated;T-compiler;regression-from-stable-to-beta,C-bug;I-nominated;T-compiler;regression-from-stable-to-beta",49949,2018-04-13T16:33:11Z,69,23,92
NULL,49954,2018-04-13T20:54:44Z,231,26,257
"S-waiting-on-review,S-waiting-on-review",49956,2018-04-13T21:29:27Z,125,25,150
NULL,49962,2018-04-14T11:21:28Z,0,0,0
"A-libs,A-libs",49963,2018-04-14T13:21:43Z,12,13,25
"I-nominated;I-wrong,I-nominated;I-wrong",49965,2018-04-14T14:42:55Z,0,4,4
"S-waiting-on-review,S-waiting-on-review",49966,2018-04-14T15:21:26Z,203,131,334
"B-RFC-approved;C-tracking-issue;E-needs-mentor;T-lang;WG-compiler-front,C-tracking-issue;T-lang",49968,2018-04-14T19:25:59Z,155,214,369
"S-waiting-on-review,S-waiting-on-review",49969,2018-04-14T19:26:54Z,743,648,1391
"A-io;B-unstable;T-libs,A-io;B-unstable;T-libs,A-io;B-unstable;T-libs",49970,2018-04-14T21:51:45Z,32,1,33
"A-traits;T-compiler;WG-compiler-traits,A-traits;T-compiler;WG-compiler-traits",49971,2018-04-14T23:17:05Z,0,0,0
regression-from-stable-to-stable,49981,2018-04-15T11:39:03Z,26,5,31
"B-unstable;T-lang,B-unstable;T-lang",49982,2018-04-15T14:00:33Z,290,712,1002
NULL,49985,2018-04-15T18:25:28Z,30,4,34
"A-macros;E-medium;E-mentor,A-macros;E-medium;E-mentor",49986,2018-04-15T20:02:39Z,97,40,137
NULL,49987,2018-04-15T20:48:42Z,158,4,162
NULL,49989,2018-04-15T21:52:50Z,0,0,0
NULL,49990,2018-04-15T23:15:28Z,0,0,0
"A-parallel-queries;E-medium,A-parallel-queries;E-medium",49991,2018-04-16T02:25:58Z,117,331,448
NULL,50000,2018-04-16T14:34:00Z,160,17,177
"S-waiting-on-review,S-waiting-on-review,S-waiting-on-review,S-waiting-on-bors,beta-nominated",50003,2018-04-16T17:51:06Z,86,45,131
NULL,50006,2018-04-16T19:32:24Z,27,1,28
NULL,50010,2018-04-16T22:00:35Z,598,209,807
C-bug;I-compiletime;T-compiler;regression-from-stable-to-nightly,50011,2018-04-16T22:35:28Z,102,97,199
NULL,50014,2018-04-17T02:11:38Z,0,0,0
"A-traits;T-compiler;WG-compiler-traits,A-traits;T-compiler;WG-compiler-traits",50016,2018-04-17T03:43:05Z,269,252,521
NULL,50017,2018-04-17T05:13:30Z,28,59,87
S-waiting-on-bors;beta-accepted;beta-nominated,50024,2018-04-17T13:37:05Z,0,0,0
S-waiting-on-review;beta-nominated,50025,2018-04-17T13:42:19Z,0,0,0
"S-waiting-on-bors;beta-nominated,S-waiting-on-bors;beta-nominated",50026,2018-04-17T13:46:37Z,0,0,0
"S-waiting-on-review;beta-nominated,S-waiting-on-bors;beta-nominated,S-waiting-on-bors;beta-nominated,S-waiting-on-bors;beta-accepted;beta-nominated,S-waiting-on-review;beta-nominated,S-waiting-on-review;beta-nominated,S-waiting-on-bors;beta-accepted;beta-nominated",50027,2018-04-17T13:56:29Z,374,356,730
"S-waiting-on-review,A-attributes;C-tracking-issue;T-dev-tools,S-waiting-on-review,A-attributes;C-tracking-issue;T-dev-tools",50030,2018-04-17T15:12:45Z,391,302,693
NULL,50031,2018-04-17T16:03:40Z,40,7,47
"S-waiting-on-bors,S-waiting-on-bors,S-waiting-on-review",50033,2018-04-17T16:43:19Z,217,158,375
"S-waiting-on-review,S-waiting-on-review",50039,2018-04-18T01:53:05Z,32,7,39
"B-RFC-approved;C-tracking-issue;T-lang,B-RFC-approved;C-tracking-issue;T-lang",50045,2018-04-18T07:52:56Z,510,54,564
"S-waiting-on-bors;beta-accepted;beta-nominated,S-waiting-on-bors;beta-accepted;beta-nominated",50046,2018-04-18T08:01:03Z,22,7,29
NULL,50048,2018-04-18T10:03:23Z,60,27,87
NULL,50058,2018-04-18T17:06:24Z,2,0,2
NULL,50062,2018-04-18T18:49:29Z,60,2,62
"S-waiting-on-review,A-macros,S-waiting-on-review,A-macros",50069,2018-04-19T02:40:24Z,127,9,136
"B-RFC-approved;T-lang,B-RFC-approved;T-lang",50070,2018-04-19T03:04:54Z,676,725,1401
NULL,50072,2018-04-19T11:19:24Z,158,37,195
"S-waiting-on-review,S-waiting-on-review",50076,2018-04-19T13:41:54Z,14,14,28
"T-libs;regression-from-stable-to-beta,S-waiting-on-bors,beta-nominated,T-libs;regression-from-stable-to-beta,S-waiting-on-bors,beta-nominated",50088,2018-04-19T22:56:02Z,5,47,52
"T-libs;beta-accepted;beta-nominated,T-libs;beta-accepted;beta-nominated",50089,2018-04-19T22:56:30Z,5,47,52
"C-bug;I-ICE;I-nominated;T-compiler;regression-from-stable-to-beta,C-bug;I-ICE;I-nominated;T-compiler;regression-from-stable-to-beta",50092,2018-04-19T23:56:35Z,184,16,200
NULL,50093,2018-04-20T00:02:28Z,13,1,14
NULL,50097,2018-04-20T01:01:42Z,51,154,205
NULL,50100,2018-04-20T03:02:59Z,157,15,172
NULL,50101,2018-04-20T04:20:41Z,0,0,0
NULL,50102,2018-04-20T07:49:08Z,508,509,1017
S-waiting-on-review,50105,2018-04-20T09:41:21Z,163,15,178
NULL,50109,2018-04-20T11:57:16Z,1,1,2
"S-waiting-on-review,T-lang;regression-from-stable-to-beta;regression-from-stable-to-nightly,S-waiting-on-review,T-lang;regression-from-stable-to-beta;regression-from-stable-to-nightly",50110,2018-04-20T12:21:58Z,233,75,308
S-waiting-on-review,50114,2018-04-20T13:14:02Z,1,1,2
NULL,50117,2018-04-20T14:12:15Z,4,2,6
NULL,50118,2018-04-20T14:43:22Z,18,10,28
"S-waiting-on-bors,S-waiting-on-bors,S-waiting-on-review,S-waiting-on-review",50119,2018-04-20T15:45:45Z,50,11,61
NULL,50120,2018-04-20T16:05:05Z,265,45,310
NULL,50121,2018-04-20T16:13:41Z,188,49,237
NULL,50126,2018-04-20T19:29:11Z,0,0,0
"S-waiting-on-review,S-waiting-on-review,S-waiting-on-review,S-waiting-on-review,beta-nominated,S-waiting-on-review,beta-nominated,S-waiting-on-review,S-waiting-on-review,S-waiting-on-review,beta-nominated,beta-nominated",50127,2018-04-20T20:34:28Z,423,127,550
"S-waiting-on-review,S-waiting-on-review,S-waiting-on-review,S-waiting-on-review",50129,2018-04-20T23:09:45Z,13,12,25
NULL,50149,2018-04-21T22:21:25Z,224,15,239
"A-macros,A-macros",50152,2018-04-22T01:38:52Z,55,1,56
NULL,50161,2018-04-22T17:53:37Z,201,80,281
T-doc;T-libs,50163,2018-04-22T18:25:10Z,27,40,67
NULL,50170,2018-04-22T22:00:07Z,95,0,95
S-waiting-on-bors,50171,2018-04-23T01:38:01Z,27,11,38
NULL,50175,2018-04-23T09:24:48Z,10,1,11
NULL,50182,2018-04-23T14:37:16Z,221,55,276
"T-libs,S-waiting-on-review,S-waiting-on-bors,S-waiting-on-review,S-waiting-on-review,S-waiting-on-review,S-waiting-on-review,S-waiting-on-bors",50191,2018-04-24T03:57:13Z,425,167,592
NULL,50200,2018-04-24T17:07:14Z,267,337,604
"S-waiting-on-review,S-waiting-on-review",50207,2018-04-25T03:27:32Z,2,1,3
NULL,50208,2018-04-25T03:54:04Z,0,0,0
S-waiting-on-review;beta-nominated,50224,2018-04-25T15:19:28Z,357,100,457
NULL,50227,2018-04-25T16:18:55Z,12,2,14
NULL,50228,2018-04-25T16:46:51Z,2267,2086,4353
NULL,50229,2018-04-25T18:04:07Z,59,31,90
"B-RFC-approved;C-tracking-issue;T-lang,B-RFC-approved;C-tracking-issue;T-lang",50233,2018-04-25T21:40:08Z,28,8,36
NULL,50240,2018-04-26T01:30:34Z,123,12,135
"S-waiting-on-bors,S-waiting-on-review;T-doc,S-waiting-on-review,S-waiting-on-review,S-waiting-on-bors",50245,2018-04-26T08:11:18Z,30,34,64
beta-nominated,50248,2018-04-26T11:54:40Z,148,54,202
"T-compiler;WG-compiler-traits,T-compiler;WG-compiler-traits",50250,2018-04-26T13:18:49Z,82,23,105
NULL,50253,2018-04-26T17:43:11Z,37,5,42
NULL,50254,2018-04-26T18:29:13Z,0,9,9
NULL,50257,2018-04-26T21:22:37Z,28,1,29
NULL,50259,2018-04-26T22:03:49Z,161,75,236
"S-waiting-on-review,S-blocked",50260,2018-04-26T23:11:16Z,189,1,190
"S-waiting-on-review,S-waiting-on-review",50262,2018-04-26T23:56:47Z,0,0,0
"B-unstable;T-compiler;T-tools,B-unstable;T-compiler;T-tools",50265,2018-04-27T00:30:35Z,9,21,30
NULL,50267,2018-04-27T01:22:05Z,226,3,229
NULL,50269,2018-04-27T03:51:50Z,9,9,18
NULL,50271,2018-04-27T04:33:02Z,40,1,41
"C-tracking-issue;T-lang,C-tracking-issue;T-lang",50272,2018-04-27T04:34:36Z,34,0,34
NULL,50273,2018-04-27T05:24:05Z,54,32,86
"S-waiting-on-review,S-waiting-on-bors",50274,2018-04-27T05:51:32Z,69,10,79
"S-waiting-on-review,S-waiting-on-bors,S-waiting-on-review,S-waiting-on-bors,S-waiting-on-review,S-waiting-on-bors,S-waiting-on-review",50275,2018-04-27T06:16:51Z,2939,191,3130
A-rustdoc;T-dev-tools-rustdoc;WG-docs-rustdoc,50284,2018-04-27T15:15:12Z,1,1,2
"S-waiting-on-review,S-waiting-on-review,S-waiting-on-review,S-waiting-on-bors,S-waiting-on-review;beta-nominated,S-waiting-on-review,S-waiting-on-review,S-waiting-on-review,S-waiting-on-review",50290,2018-04-27T19:32:21Z,298,249,547
NULL,50295,2018-04-28T04:34:00Z,20,25,45
NULL,50296,2018-04-28T06:06:24Z,14,0,14
S-waiting-on-review;beta-nominated,50298,2018-04-28T07:51:20Z,28,1,29
"A-rustdoc,A-rustdoc",50302,2018-04-28T15:21:46Z,15,7,22
NULL,50305,2018-04-28T20:14:44Z,47,9,56
NULL,50307,2018-04-29T00:22:43Z,896,119,1015
NULL,50312,2018-04-29T11:58:03Z,40,19,59
"A-resolve;E-easy,A-resolve;E-easy",50315,2018-04-29T17:15:03Z,0,0,0
A-diagnostics,50317,2018-04-29T17:49:22Z,57,0,57
"B-RFC-approved;T-libs,B-RFC-approved;T-libs",50319,2018-04-29T19:32:58Z,521,111,632
NULL,50320,2018-04-29T19:35:52Z,7,5,12
NULL,50327,2018-04-30T00:30:23Z,120,15,135
B-unstable,50330,2018-04-30T05:46:07Z,40,0,40
NULL,50331,2018-04-30T06:10:35Z,11,2,13
S-waiting-on-bors,50334,2018-04-30T07:36:51Z,179,18,197
"WG-embedded,WG-embedded,WG-embedded,WG-embedded",50336,2018-04-30T08:21:51Z,134,4,138
"B-RFC-approved;T-libs,B-RFC-approved;T-libs",50338,2018-04-30T09:00:08Z,492,64,556
NULL,50342,2018-04-30T14:21:30Z,39,2,41
"S-waiting-on-review,S-waiting-on-review",50345,2018-04-30T17:18:44Z,277,57,334
"A-rustdoc;T-doc,A-rustdoc;T-doc",50349,2018-04-30T20:32:51Z,1,1,2
"T-compiler,T-compiler",50351,2018-04-30T21:44:16Z,18,45,63
NULL,50352,2018-04-30T22:00:47Z,128,31,159
NULL,50353,2018-04-30T22:32:38Z,0,0,0
NULL,50354,2018-04-30T23:15:38Z,108,2,110
NULL,50355,2018-05-01T00:32:53Z,122,36,158
NULL,50360,2018-05-01T08:52:54Z,3,3,6
"S-waiting-on-review,S-waiting-on-review",50364,2018-05-01T11:26:29Z,246,1,247
NULL,50366,2018-05-01T12:34:00Z,0,0,0
NULL,50374,2018-05-01T18:32:56Z,10,2,12
NULL,50378,2018-05-01T20:47:08Z,23,9,32
NULL,50383,2018-05-02T01:12:38Z,56,3,59
NULL,50385,2018-05-02T03:03:44Z,7,75,82
NULL,50387,2018-05-02T06:38:30Z,4,4,8
"B-RFC-approved;C-tracking-issue;T-lang,S-waiting-on-review,S-waiting-on-review",50390,2018-05-02T10:32:54Z,42,80,122
"S-waiting-on-review,S-waiting-on-review",50393,2018-05-02T13:35:36Z,30,4,34
"S-waiting-on-author,S-waiting-on-author",50397,2018-05-02T17:55:00Z,168,156,324
"A-testsuite;C-enhancement;T-compiler,A-testsuite;C-enhancement;T-compiler",50400,2018-05-02T23:34:41Z,473,390,863
"S-waiting-on-review,S-waiting-on-review",50401,2018-05-02T23:41:15Z,0,27,27
"T-libs;beta-accepted;beta-nominated,T-libs;beta-accepted;beta-nominated",50402,2018-05-02T23:45:16Z,0,27,27
NULL,50406,2018-05-03T03:10:37Z,32,4,36
NULL,50409,2018-05-03T04:14:37Z,37,3,40
"S-waiting-on-bors,S-waiting-on-bors,S-waiting-on-review,S-waiting-on-review,S-waiting-on-review,T-libs;beta-accepted;beta-nominated,S-waiting-on-review,S-waiting-on-review,S-waiting-on-review,S-waiting-on-review,S-waiting-on-bors",50413,2018-05-03T08:11:36Z,162,61,223
NULL,50416,2018-05-03T11:15:27Z,28,2,30
S-waiting-on-review,50417,2018-05-03T11:20:17Z,1,1,2
"S-waiting-on-review,S-waiting-on-review",50419,2018-05-03T13:32:16Z,39,31,70
NULL,50421,2018-05-03T14:38:44Z,29,2,31
"S-waiting-on-review,A-rustdoc,S-waiting-on-review",50432,2018-05-03T20:57:16Z,48,3,51
"S-waiting-on-review,S-waiting-on-review",50433,2018-05-03T21:44:32Z,7,6,13
"S-waiting-on-review;T-libs,S-waiting-on-review;T-libs",50435,2018-05-03T23:27:16Z,3,72,75
"E-mentor;T-compiler;WG-compiler-front,E-mentor;T-compiler;WG-compiler-front",50440,2018-05-04T09:55:50Z,732,172,904
"A-build,A-build",50444,2018-05-04T13:35:40Z,4,3,7
NULL,50447,2018-05-04T15:47:06Z,5,4,9
"S-waiting-on-bors,S-waiting-on-review,S-waiting-on-bors,S-waiting-on-review,S-waiting-on-review,S-waiting-on-bors,S-waiting-on-bors,S-waiting-on-review,S-waiting-on-review",50449,2018-05-04T17:37:07Z,0,0,0
"A-macros;A-plugin;B-RFC-approved,A-macros;A-plugin;B-RFC-approved",50453,2018-05-04T21:13:30Z,46,1,47
NULL,50457,2018-05-05T05:30:57Z,0,0,0
"S-waiting-on-review,S-waiting-on-review",50460,2018-05-05T08:38:59Z,9,2,11
S-waiting-on-review,50462,2018-05-05T10:36:59Z,0,0,0
"S-waiting-on-review,S-waiting-on-review",50465,2018-05-05T18:24:56Z,488,199,687
"S-waiting-on-review,S-waiting-on-review",50470,2018-05-05T23:03:40Z,4,4,8
A-macros;A-plugin;B-RFC-approved,50473,2018-05-06T00:46:20Z,595,210,805
NULL,50474,2018-05-06T02:10:19Z,24,58,82
"A-traits;T-compiler;WG-compiler-traits,A-traits;T-compiler;WG-compiler-traits",50475,2018-05-06T04:22:53Z,360,184,544
"A-diagnostics,A-diagnostics",50476,2018-05-06T05:38:07Z,67,44,111
"S-waiting-on-review,S-waiting-on-review",50478,2018-05-06T09:45:25Z,64,89,153
S-waiting-on-bors,50479,2018-05-06T10:26:56Z,0,0,0
"B-RFC-approved;T-libs,B-RFC-approved;T-libs",50494,2018-05-07T07:36:14Z,111,43,154
"B-RFC-approved;C-tracking-issue;T-libs,B-RFC-approved;C-tracking-issue;T-libs",50497,2018-05-07T11:04:07Z,34,31,65
NULL,50505,2018-05-07T14:45:21Z,29,0,29
"S-waiting-on-review,S-waiting-on-review",50520,2018-05-07T21:45:46Z,322,318,640
"A-parallel-queries;C-enhancement;E-mentor;WG-compiler-performance,A-parallel-queries;C-enhancement;E-mentor;WG-compiler-performance",50524,2018-05-08T03:21:57Z,74,83,157
NULL,50526,2018-05-08T07:24:38Z,398,101,499
"A-parallel-queries;C-enhancement;E-easy;E-mentor;WG-compiler-performance,A-parallel-queries;C-enhancement;E-easy;E-mentor;WG-compiler-performance",50528,2018-05-08T08:27:45Z,86,153,239
NULL,50530,2018-05-08T11:55:01Z,28,2,30
"C-cleanup;E-easy;E-mentor;I-compiletime;WG-compiler-performance,C-cleanup;E-easy;E-mentor;I-compiletime;WG-compiler-performance",50531,2018-05-08T12:04:33Z,86,220,306
"A-parallel-queries;C-enhancement;E-easy;E-mentor;WG-compiler-performance,A-parallel-queries;C-enhancement;E-easy;E-mentor;WG-compiler-performance",50532,2018-05-08T12:41:52Z,12,8,20
NULL,50533,2018-05-08T13:44:37Z,63,16,79
NULL,50536,2018-05-08T14:43:08Z,84,60,144
"S-waiting-on-review;T-libs;proposed-final-comment-period,S-waiting-on-review,S-waiting-on-review,C-enhancement;T-release,S-waiting-on-review,S-waiting-on-review,S-waiting-on-review,S-waiting-on-review,S-waiting-on-review,S-waiting-on-review,S-waiting-on-review,C-enhancement;T-release,S-waiting-on-review,S-waiting-on-review,S-waiting-on-review;T-libs;proposed-final-comment-period,S-waiting-on-review,S-waiting-on-review,S-waiting-on-review,S-waiting-on-review,S-waiting-on-review,S-waiting-on-review,S-waiting-on-review,S-waiting-on-review,S-waiting-on-review",50546,2018-05-08T21:05:26Z,354,31,385
NULL,50553,2018-05-09T01:30:05Z,36,0,36
NULL,50554,2018-05-09T01:37:42Z,39,2,41
"A-parallel-queries;C-cleanup;E-mentor;WG-compiler-performance,A-parallel-queries;C-cleanup;E-mentor;WG-compiler-performance",50558,2018-05-09T05:51:01Z,51,63,114
NULL,50559,2018-05-09T06:28:14Z,0,0,0
NULL,50572,2018-05-09T13:49:34Z,8,4,12
NULL,50573,2018-05-09T15:36:43Z,33,11,44
"B-unstable;C-tracking-issue;T-libs,B-unstable;C-tracking-issue;T-libs",50574,2018-05-09T16:07:26Z,15,0,15
"I-compiletime;T-compiler;WG-compiler-performance,I-compiletime;T-compiler;WG-compiler-performance",50575,2018-05-09T16:11:20Z,5,3,8
NULL,50587,2018-05-09T22:23:44Z,0,0,0
NULL,50588,2018-05-09T22:41:15Z,23,25,48
"A-diagnostics,S-waiting-on-review,A-diagnostics,S-waiting-on-review",50590,2018-05-09T23:34:50Z,23,23,46
NULL,50603,2018-05-10T10:24:24Z,217,82,299
"S-waiting-on-review,S-waiting-on-review",50607,2018-05-10T14:29:37Z,35,8,43
"S-waiting-on-review,S-waiting-on-review,S-waiting-on-review,S-waiting-on-review,S-waiting-on-review,S-waiting-on-bors,S-waiting-on-review,S-waiting-on-review,S-waiting-on-review,S-waiting-on-review,S-waiting-on-review,B-unstable;C-tracking-issue;T-libs,S-waiting-on-bors,S-waiting-on-review,S-waiting-on-review,S-waiting-on-review,S-waiting-on-bors,S-waiting-on-bors,S-waiting-on-review,S-waiting-on-review,S-waiting-on-review",50608,2018-05-10T15:07:26Z,0,0,0
NULL,50610,2018-05-10T16:14:58Z,132,21,153
"S-waiting-on-review,S-waiting-on-bors,S-waiting-on-review,S-waiting-on-review,S-waiting-on-review,S-waiting-on-review,S-waiting-on-review,B-unstable;C-tracking-issue;T-libs,S-waiting-on-bors,S-waiting-on-review,S-waiting-on-review,S-waiting-on-review,S-waiting-on-bors,S-waiting-on-bors,S-waiting-on-review,S-waiting-on-review,S-waiting-on-review,S-waiting-on-review,S-waiting-on-review,S-waiting-on-review,S-waiting-on-review",50611,2018-05-10T16:35:39Z,1384,486,1870
"S-waiting-on-review,S-waiting-on-review",50612,2018-05-10T17:04:19Z,133,49,182
"S-waiting-on-bors,S-waiting-on-bors",50613,2018-05-10T17:16:19Z,3,3,6
NULL,50615,2018-05-10T17:26:43Z,1547,1548,3095
NULL,50617,2018-05-10T18:13:58Z,17,3,20
"A-codegen;I-nominated;T-compiler,A-codegen;I-nominated;T-compiler",50622,2018-05-10T18:34:16Z,124,46,170
NULL,50623,2018-05-10T18:48:23Z,0,0,0
NULL,50630,2018-05-10T20:24:13Z,24,7,31
"S-waiting-on-review,S-waiting-on-review",50631,2018-05-10T21:01:52Z,5,3,8
NULL,50643,2018-05-11T04:19:23Z,64,18,82
"A-spurious;C-tracking-issue;T-compiler;T-infra,S-waiting-on-review,A-spurious;A-windows,S-waiting-on-review,A-spurious;C-tracking-issue;T-compiler;T-infra,A-spurious;A-windows",50644,2018-05-11T04:39:46Z,5,0,5
NULL,50648,2018-05-11T10:28:17Z,75,81,156
NULL,50656,2018-05-11T14:30:49Z,44,7,51
NULL,50663,2018-05-11T16:16:23Z,62,41,103
"A-diagnostics,A-diagnostics",50665,2018-05-11T18:08:24Z,287,47,334
"S-waiting-on-review,S-waiting-on-review,S-waiting-on-review,S-waiting-on-review,S-waiting-on-review,S-waiting-on-author,S-waiting-on-review,S-waiting-on-review,S-waiting-on-review,S-waiting-on-review",50666,2018-05-11T18:22:16Z,0,0,0
"A-rustdoc;C-tracking-issue;T-dev-tools,S-waiting-on-review,A-rustdoc;C-tracking-issue;T-dev-tools,S-waiting-on-review",50669,2018-05-11T19:24:11Z,202,124,326
NULL,50675,2018-05-12T02:09:40Z,74,17,91
"S-waiting-on-review,S-waiting-on-review,S-waiting-on-review,S-waiting-on-author,S-waiting-on-review,S-waiting-on-review,S-waiting-on-review,S-waiting-on-review,S-waiting-on-review,S-waiting-on-review,S-waiting-on-bors",50681,2018-05-12T10:45:22Z,0,0,0
NULL,50682,2018-05-12T11:01:51Z,81,4,85
NULL,50684,2018-05-12T12:22:44Z,10,3,13
NULL,50685,2018-05-12T12:37:52Z,26,0,26
"S-waiting-on-review,S-waiting-on-review,S-waiting-on-review,S-waiting-on-bors,S-waiting-on-review,S-waiting-on-review,S-waiting-on-review,S-waiting-on-review,S-waiting-on-review,S-waiting-on-author,S-waiting-on-review,S-waiting-on-review,S-waiting-on-review",50686,2018-05-12T13:32:39Z,354,277,631
NULL,50690,2018-05-12T16:49:29Z,389,370,759
"regression-from-stable-to-nightly,regression-from-stable-to-nightly,regression-from-stable-to-nightly",50693,2018-05-12T19:15:58Z,62,1,63
NULL,50694,2018-05-12T19:51:43Z,42,2,44
NULL,50695,2018-05-12T19:55:12Z,1,1,2
"S-waiting-on-review,S-waiting-on-review",50696,2018-05-12T20:09:49Z,5,5,10
NULL,50697,2018-05-12T21:34:02Z,31,3,34
"S-waiting-on-review,S-waiting-on-review,S-waiting-on-review,S-waiting-on-review,S-waiting-on-review,S-waiting-on-review,S-waiting-on-bors,S-waiting-on-review",50704,2018-05-13T08:15:51Z,140,11,151
"S-waiting-on-review,S-waiting-on-review",50708,2018-05-13T14:22:59Z,188,64,252
NULL,50709,2018-05-13T14:46:20Z,15,163,178
NULL,50710,2018-05-13T15:03:29Z,88,56,144
NULL,50712,2018-05-13T16:04:03Z,70,11,81
NULL,50719,2018-05-13T19:46:39Z,1,2,3
NULL,50724,2018-05-13T21:15:27Z,447,117,564
NULL,50728,2018-05-14T03:13:15Z,42,7,49
NULL,50735,2018-05-14T09:24:05Z,20,0,20
S-waiting-on-bors,50737,2018-05-14T11:42:24Z,0,0,0
"S-waiting-on-review,S-waiting-on-review,S-waiting-on-review,S-waiting-on-review",50740,2018-05-14T12:30:50Z,12,123,135
"S-waiting-on-bors;beta-accepted,S-waiting-on-review,S-waiting-on-review,S-waiting-on-bors;beta-accepted;beta-nominated,S-waiting-on-bors",50741,2018-05-14T13:20:34Z,200,85,285
S-waiting-on-review,50742,2018-05-14T13:22:45Z,0,0,0
"A-codegen;A-llvm,A-codegen;A-llvm",50744,2018-05-14T13:57:02Z,14,10,24
"S-waiting-on-review,S-waiting-on-review,S-waiting-on-review,S-waiting-on-review,S-waiting-on-bors,S-waiting-on-review,S-waiting-on-review,S-waiting-on-review,S-waiting-on-review,S-waiting-on-review,S-waiting-on-review",50747,2018-05-14T14:47:21Z,0,0,0
S-waiting-on-bors;beta-accepted,50749,2018-05-14T16:37:14Z,0,0,0
NULL,50750,2018-05-14T17:15:06Z,48,127,175
B-unstable;C-tracking-issue;T-libs,50758,2018-05-14T22:25:21Z,14,20,34
"A-resolve,A-resolve",50760,2018-05-14T23:58:33Z,35,160,195
"A-lint;C-bug;E-mentor,A-lint;C-bug;E-mentor",50763,2018-05-15T06:40:18Z,210,27,237
"S-waiting-on-bors,S-waiting-on-bors,S-waiting-on-review,S-waiting-on-review,S-waiting-on-review,S-waiting-on-review,S-waiting-on-review,S-waiting-on-review,S-waiting-on-review,S-waiting-on-bors,S-waiting-on-review",50769,2018-05-15T12:27:07Z,980,284,1264
B-unstable,50770,2018-05-15T13:00:19Z,0,0,0
"S-waiting-on-bors,S-waiting-on-review,S-waiting-on-bors,S-waiting-on-review,S-waiting-on-review,S-waiting-on-review,S-waiting-on-bors;T-dev-tools,S-waiting-on-review",50775,2018-05-15T17:08:20Z,0,0,0
"S-waiting-on-review,B-RFC-approved;C-tracking-issue;T-lang,S-waiting-on-review,B-RFC-approved;C-tracking-issue;T-lang,S-waiting-on-review,B-RFC-approved;C-tracking-issue;T-lang",50782,2018-05-15T20:53:31Z,153,8,161
"S-waiting-on-review,S-waiting-on-review",50783,2018-05-15T21:34:04Z,790,235,1025
NULL,50787,2018-05-15T23:40:58Z,6,6,12
NULL,50788,2018-05-15T23:43:33Z,31,1,32
"A-build;C-bug;regression-from-stable-to-stable,A-build;C-bug;regression-from-stable-to-stable",50789,2018-05-16T01:05:50Z,9,1,10
NULL,50790,2018-05-16T01:08:28Z,6,11,17
A-testsuite;E-easy;E-mentor,50793,2018-05-16T02:28:54Z,40,23,63
NULL,50803,2018-05-16T13:54:01Z,47,3,50
NULL,50805,2018-05-16T14:57:53Z,0,0,0
NULL,50806,2018-05-16T15:19:29Z,161,70,231
"S-waiting-on-review,S-waiting-on-review,S-waiting-on-review,S-waiting-on-review,S-waiting-on-review,S-waiting-on-review,S-waiting-on-review,S-waiting-on-review;beta-nominated;relnotes,S-waiting-on-review,S-waiting-on-review,S-waiting-on-bors,S-waiting-on-review,S-waiting-on-review,S-waiting-on-review,S-waiting-on-review,S-waiting-on-review,S-waiting-on-review,S-waiting-on-bors,S-waiting-on-review,S-waiting-on-review,S-waiting-on-review,S-waiting-on-review,S-waiting-on-review,S-waiting-on-review,S-waiting-on-review;beta-nominated;relnotes,S-waiting-on-bors,S-waiting-on-review,S-waiting-on-review,S-waiting-on-review,S-waiting-on-review,S-waiting-on-bors,S-waiting-on-review,S-waiting-on-review",50807,2018-05-16T15:23:05Z,589,361,950
"B-RFC-approved;C-tracking-issue;T-libs,B-RFC-approved;C-tracking-issue;T-libs",50808,2018-05-16T16:10:14Z,18,150,168
"S-waiting-on-review,S-waiting-on-review,S-waiting-on-review,S-waiting-on-review",50809,2018-05-16T16:42:14Z,1,1,2
NULL,50812,2018-05-16T20:27:48Z,71,7,78
"A-traits;I-unsound%20%F0%9F%92%A5,A-traits;I-unsound%20%F0%9F%92%A5,S-waiting-on-review",50815,2018-05-17T00:26:29Z,0,0,0
"I-ICE,I-ICE",50819,2018-05-17T03:16:43Z,39,2,41
"S-waiting-on-review,S-waiting-on-review",50820,2018-05-17T03:46:07Z,153,6,159
NULL,50827,2018-05-17T09:14:31Z,2,2,4
NULL,50829,2018-05-17T11:14:54Z,29,0,29
"B-unstable;C-tracking-issue;T-libs,B-unstable;C-tracking-issue;T-libs",50836,2018-05-17T15:33:13Z,153,10,163
"S-waiting-on-review,S-waiting-on-review",50837,2018-05-17T16:45:08Z,101,430,531
"A-macros-2.0,A-macros-2.0",50838,2018-05-17T16:50:07Z,117,17,134
NULL,50841,2018-05-17T17:22:20Z,134,34,168
"S-waiting-on-review,S-waiting-on-bors,S-waiting-on-review,S-waiting-on-review,S-waiting-on-review,S-waiting-on-review,S-waiting-on-review,S-waiting-on-review,S-waiting-on-review,S-waiting-on-review,S-waiting-on-review,S-waiting-on-review,S-waiting-on-review,S-waiting-on-review,S-waiting-on-bors,S-waiting-on-review,S-waiting-on-review,S-waiting-on-review,S-waiting-on-review,S-waiting-on-review,S-waiting-on-review,S-waiting-on-review",50847,2018-05-17T19:51:31Z,595,691,1286
"S-waiting-on-review,S-waiting-on-review",50849,2018-05-17T21:59:28Z,2,1,3
S-waiting-on-review,50850,2018-05-17T22:10:30Z,0,0,0
"S-waiting-on-review,S-waiting-on-review",50851,2018-05-18T00:18:53Z,336,320,656
NULL,50852,2018-05-18T04:18:48Z,4,2,6
"S-waiting-on-review,S-waiting-on-review",50854,2018-05-18T08:03:01Z,80,71,151
NULL,50859,2018-05-18T12:19:48Z,0,0,0
"A-rustdoc;C-enhancement,A-rustdoc;C-enhancement",50875,2018-05-18T19:59:41Z,30,22,52
"T-compiler;regression-from-stable-to-nightly,T-compiler;regression-from-stable-to-nightly",50876,2018-05-18T21:45:35Z,102,5,107
NULL,50877,2018-05-18T22:31:42Z,0,0,0
NULL,50880,2018-05-18T23:02:11Z,206,113,319
NULL,50882,2018-05-19T00:53:07Z,0,0,0
NULL,50892,2018-05-19T15:22:29Z,84,8,92
"S-waiting-on-review,S-waiting-on-review,S-waiting-on-review,S-waiting-on-review,S-waiting-on-review,S-waiting-on-review,S-waiting-on-review,S-waiting-on-review,S-waiting-on-bors",50893,2018-05-19T15:41:07Z,271,308,579
NULL,50894,2018-05-19T15:53:38Z,4,8,12
A-tools;E-easy,50902,2018-05-19T18:38:55Z,0,0,0
"A-rustbuild;E-mentor,A-rustbuild;E-mentor",50904,2018-05-19T20:43:30Z,148,111,259
"A-resolve,A-resolve",50908,2018-05-19T23:42:03Z,40,2,42
A-const-eval;A-const-fn;C-bug;T-compiler;WG-compiler-const,50909,2018-05-20T00:22:11Z,126,17,143
NULL,50912,2018-05-20T01:36:27Z,927,84,1011
NULL,50914,2018-05-20T04:45:09Z,43,3,46
NULL,50916,2018-05-20T12:16:38Z,23,20,43
"S-waiting-on-review,S-waiting-on-review",50922,2018-05-20T18:43:12Z,0,0,0
NULL,50929,2018-05-21T03:51:02Z,146,136,282
NULL,50930,2018-05-21T04:23:56Z,100,34,134
"S-waiting-on-review;T-libs,S-waiting-on-review,B-unstable;T-libs,S-waiting-on-review;T-libs,S-waiting-on-review,B-unstable;T-libs",50933,2018-05-21T09:51:17Z,232,437,669
"S-waiting-on-review,S-waiting-on-review;beta-nominated;relnotes",50939,2018-05-21T14:01:01Z,69,23,92
NULL,50941,2018-05-21T14:53:24Z,4,19,23
NULL,50945,2018-05-21T16:29:09Z,6,6,12
"S-waiting-on-review,A-macros-2.0,S-waiting-on-review,A-macros-2.0",50946,2018-05-21T16:36:23Z,65,1,66
NULL,50947,2018-05-21T16:43:16Z,2,0,2
NULL,50953,2018-05-21T22:32:26Z,53,13,66
NULL,50955,2018-05-22T01:03:26Z,63,40245,40308
"S-waiting-on-review,S-waiting-on-review",50957,2018-05-22T02:17:42Z,0,0,0
NULL,50965,2018-05-22T14:26:09Z,1,1,2
"A-traits;I-unsound%20%F0%9F%92%A5,A-traits;I-unsound%20%F0%9F%92%A5",50966,2018-05-22T15:16:09Z,115,41,156
S-waiting-on-review,50967,2018-05-22T15:36:25Z,1068,988,2056
"S-waiting-on-review,S-waiting-on-review,S-waiting-on-bors;T-libs;relnotes,S-waiting-on-review,S-waiting-on-review,S-waiting-on-review,S-waiting-on-bors,S-waiting-on-review,S-waiting-on-review,S-waiting-on-review,S-waiting-on-review,S-waiting-on-review,S-waiting-on-review",50968,2018-05-22T16:26:25Z,349,67,416
NULL,50969,2018-05-22T16:36:55Z,236,43,279
"A-macros-2.0,A-macros-2.0",50971,2018-05-22T16:57:07Z,156,82,238
"S-waiting-on-review,S-waiting-on-review",50979,2018-05-22T22:02:34Z,8,8,16
"A-rust-2018-preview,A-rust-2018-preview,A-rust-2018-preview,A-rust-2018-preview",50982,2018-05-22T22:59:14Z,44,24,68
A-rust-2018-preview,50983,2018-05-22T23:07:05Z,379,30,409
B-RFC-approved;C-tracking-issue;T-libs,50984,2018-05-23T00:25:45Z,32,3,35
"S-waiting-on-review,A-diagnostics,S-waiting-on-review,A-diagnostics",50987,2018-05-23T04:07:29Z,56,26,82
"S-waiting-on-review,S-waiting-on-review",50995,2018-05-23T14:04:28Z,4,6,10
"I-nominated;T-lang;WG-epoch,I-nominated;T-lang;WG-epoch",50999,2018-05-23T16:50:19Z,0,0,0
"A-rust-2018-preview,A-rust-2018-preview",51010,2018-05-23T20:23:44Z,277,1,278
NULL,51011,2018-05-23T21:56:38Z,10,2,12
"A-rust-2018-preview,T-compiler;WG-epoch,S-waiting-on-review,A-lint,A-rust-2018-preview,T-compiler;WG-epoch,S-waiting-on-review",51015,2018-05-24T00:13:50Z,421,202,623
"A-docs,S-waiting-on-review,A-docs,S-waiting-on-review",51016,2018-05-24T01:12:20Z,0,0,0
NULL,51017,2018-05-24T02:25:46Z,72,1,73
"S-waiting-on-review,S-waiting-on-review,S-waiting-on-review,S-waiting-on-review,S-waiting-on-review,S-waiting-on-review,S-waiting-on-review,S-waiting-on-bors,S-waiting-on-review",51023,2018-05-24T08:02:49Z,137,45,182
"S-waiting-on-review;T-libs,S-waiting-on-review;T-libs",51033,2018-05-24T12:51:08Z,68,108,176
S-waiting-on-review,51034,2018-05-24T13:06:20Z,184,215,399
NULL,51035,2018-05-24T15:05:42Z,21,1,22
"S-waiting-on-review,S-waiting-on-review,S-waiting-on-review,S-waiting-on-review;beta-nominated,S-waiting-on-review,A-stability;S-waiting-on-review;beta-nominated,S-waiting-on-review,S-waiting-on-review,S-waiting-on-review,S-waiting-on-review,S-waiting-on-review,S-waiting-on-review,S-waiting-on-review",51037,2018-05-24T15:51:37Z,529,166,695
NULL,51041,2018-05-24T19:05:10Z,46,16,62
"T-compiler;regression-from-stable-to-nightly,B-RFC-approved;C-tracking-issue;T-lang,T-compiler;regression-from-stable-to-nightly,B-RFC-approved;C-tracking-issue;T-lang",51042,2018-05-24T20:48:14Z,302,56,358
"S-waiting-on-bors,S-waiting-on-review,C-feature-request;I-nominated;T-core;T-release,S-waiting-on-bors,S-waiting-on-review,C-feature-request;I-nominated;T-core;T-release",51045,2018-05-24T21:08:16Z,541,108,649
NULL,51049,2018-05-24T22:26:52Z,92,4,96
NULL,51051,2018-05-24T22:48:27Z,75,31,106
"C-bug;I-nominated;T-compiler;regression-from-stable-to-beta,C-bug;I-nominated;T-compiler;regression-from-stable-to-beta",51052,2018-05-24T22:51:05Z,98,6,104
NULL,51057,2018-05-25T10:52:33Z,725,362,1087
S-waiting-on-review;beta-nominated,51058,2018-05-25T13:54:35Z,0,0,0
"S-waiting-on-review,S-waiting-on-review",51060,2018-05-25T15:32:39Z,449,115,564
"S-waiting-on-review,S-waiting-on-review",51063,2018-05-25T17:01:00Z,165,23,188
NULL,51068,2018-05-25T22:28:41Z,71,10,81
NULL,51070,2018-05-26T01:04:55Z,66,2,68
"S-waiting-on-review,A-incr-comp;A-macros;A-resolve;A-syntaxext;C-bug",51072,2018-05-26T02:37:47Z,208,186,394
A-macros;A-plugin;B-RFC-approved,51073,2018-05-26T02:53:24Z,7,7,14
"S-waiting-on-review,S-waiting-on-review",51075,2018-05-26T05:05:28Z,45,8,53
"B-unstable;T-libs,B-unstable;T-libs",51078,2018-05-26T08:58:38Z,18,17,35
NULL,51079,2018-05-26T09:12:30Z,2,19,21
NULL,51081,2018-05-26T11:29:06Z,37,23,60
"S-waiting-on-review,S-waiting-on-review,S-waiting-on-review,S-waiting-on-review,S-waiting-on-review,S-waiting-on-review,S-waiting-on-bors,S-waiting-on-review,S-waiting-on-bors,S-waiting-on-bors,S-waiting-on-review",51082,2018-05-26T11:32:34Z,512,295,807
NULL,51084,2018-05-26T13:46:50Z,24,4,28
"B-RFC-approved,B-unstable;C-tracking-issue;T-lang,B-unstable;T-libs,B-RFC-approved;T-lang,A-NVPTX;B-unstable,B-unstable;C-tracking-issue;T-lang,B-unstable;C-tracking-issue;O-wasm;T-compiler,A-macros;A-plugin;B-RFC-approved,B-RFC-approved,B-unstable;T-libs,B-unstable;C-tracking-issue;T-lang,B-RFC-approved;T-lang,A-NVPTX;B-unstable,B-unstable;C-tracking-issue;T-lang,B-unstable;C-tracking-issue;O-wasm;T-compiler,A-macros;A-plugin;B-RFC-approved",51090,2018-05-26T15:50:30Z,67,42,109
"S-waiting-on-review,S-waiting-on-bors,S-waiting-on-review",51094,2018-05-26T17:22:57Z,841,366,1207
NULL,51096,2018-05-26T19:04:21Z,82,5,87
NULL,51098,2018-05-26T22:37:27Z,0,0,0
NULL,51099,2018-05-26T22:51:35Z,61,14,75
NULL,51100,2018-05-27T00:07:59Z,144,16,160
"A-diagnostics;T-compiler,A-diagnostics;T-compiler",51104,2018-05-27T04:45:21Z,143,139,282
"NLL-performant;T-compiler;WG-compiler-nll,NLL-performant;T-compiler;WG-compiler-nll",51106,2018-05-27T10:16:51Z,78,14,92
S-waiting-on-review,51108,2018-05-27T15:06:05Z,10,1,11
NULL,51109,2018-05-27T15:41:14Z,0,0,0
NULL,51124,2018-05-28T12:36:59Z,6,4,10
"E-easy;I-cleanup,E-easy;I-cleanup",51135,2018-05-28T17:33:14Z,57,25,82
"A-NLL;NLL-sound;WG-compiler-nll,A-NLL;NLL-sound;WG-compiler-nll",51139,2018-05-28T19:12:31Z,117,7,124
NULL,51140,2018-05-28T19:30:55Z,218,66,284
NULL,51142,2018-05-28T23:53:45Z,29,2,31
NULL,51143,2018-05-28T23:58:34Z,5,5,10
B-unstable;T-libs,51144,2018-05-29T00:24:21Z,1,2,3
"S-waiting-on-review,S-waiting-on-review",51145,2018-05-29T01:49:16Z,69,17,86
NULL,51146,2018-05-29T02:19:58Z,82,3,85
"B-RFC-approved;T-libs,B-RFC-approved;T-libs,B-RFC-approved;T-libs,B-RFC-approved;T-libs",51147,2018-05-29T03:10:12Z,31,4,35
"A-rust-2018-preview,A-rust-2018-preview",51149,2018-05-29T05:56:23Z,373,240,613
NULL,51151,2018-05-29T07:42:50Z,35,35,70
NULL,51153,2018-05-29T08:09:46Z,10,2,12
"C-feature-request;T-libs,C-feature-request;T-libs",51156,2018-05-29T09:05:17Z,0,0,0
NULL,51158,2018-05-29T09:32:46Z,24,0,24
"S-waiting-on-review,regression-from-stable-to-nightly",51165,2018-05-29T12:52:50Z,7,0,7
NULL,51178,2018-05-29T16:18:36Z,32,0,32
"T-compiler,T-compiler",51181,2018-05-29T18:34:29Z,60,1,61
"T-doc,T-doc",51183,2018-05-29T19:46:36Z,30,11,41
"A-diagnostics;E-easy,A-diagnostics;E-easy",51184,2018-05-29T19:52:48Z,51,2,53
"C-enhancement;T-rustdoc,C-enhancement;T-rustdoc",51193,2018-05-29T23:11:27Z,33,8,41
"S-waiting-on-review,S-waiting-on-review",51197,2018-05-30T00:40:12Z,0,0,0
"C-tracking-issue;T-libs,C-tracking-issue;T-libs",51200,2018-05-30T05:30:56Z,8,34,42
"S-waiting-on-review,S-waiting-on-review",51201,2018-05-30T05:34:42Z,169,78,247
"S-waiting-on-review,S-waiting-on-review,S-waiting-on-review,S-waiting-on-review,S-waiting-on-review,S-waiting-on-bors,S-waiting-on-review,S-waiting-on-review,S-waiting-on-review,S-waiting-on-review,S-waiting-on-review",51214,2018-05-30T12:02:22Z,0,0,0
S-waiting-on-review,51215,2018-05-30T13:15:19Z,122,143,265
"A-resolve;B-RFC-approved,A-resolve;B-RFC-approved",51216,2018-05-30T13:28:51Z,0,0,0
NULL,51218,2018-05-30T14:12:16Z,0,0,0
"A-rust-2018-preview,A-rust-2018-preview",51220,2018-05-30T14:47:34Z,132,48,180
NULL,51235,2018-05-30T23:57:48Z,139,68,207
NULL,51237,2018-05-31T04:08:24Z,0,0,0
"B-RFC-approved,A-allocators;I-enhancement;T-libs",51241,2018-05-31T07:13:52Z,566,629,1195
NULL,51242,2018-05-31T08:09:24Z,114,39,153
NULL,51247,2018-05-31T11:00:59Z,105,49,154
"A-traits;T-compiler;WG-compiler-traits,A-traits;T-compiler;WG-compiler-traits",51248,2018-05-31T13:10:40Z,50,56,106
NULL,51249,2018-05-31T14:35:06Z,0,0,0
NULL,51256,2018-05-31T20:13:03Z,17,1,18
"S-waiting-on-review,S-waiting-on-review,S-waiting-on-review,S-waiting-on-review,S-waiting-on-review,S-waiting-on-review",51257,2018-05-31T20:17:18Z,133,42,175
"S-waiting-on-review,S-waiting-on-review",51258,2018-05-31T20:53:48Z,139,71,210
NULL,51260,2018-05-31T22:12:35Z,0,0,0
"A-generators;B-RFC-approved;C-tracking-issue;E-needs-mentor;T-lang,A-generators;B-RFC-approved;C-tracking-issue;E-needs-mentor;T-lang",51263,2018-05-31T23:47:17Z,961,0,961
NULL,51264,2018-06-01T00:02:48Z,12,10,22
NULL,51270,2018-06-01T07:27:43Z,12,5,17
NULL,51274,2018-06-01T13:48:59Z,211,5,216
A-NLL;NLL-diagnostics,51275,2018-06-01T15:35:02Z,670,263,933
NULL,51276,2018-06-01T15:55:55Z,101,2,103
NULL,51283,2018-06-01T21:23:32Z,124,3,127
NULL,51285,2018-06-01T23:09:17Z,57,2219,2276
"S-waiting-on-review,S-waiting-on-review,S-waiting-on-review,S-waiting-on-bors,S-waiting-on-review,S-waiting-on-bors,S-waiting-on-review,S-waiting-on-review,S-waiting-on-bors,S-waiting-on-bors",51287,2018-06-01T23:25:19Z,69,29,98
NULL,51288,2018-06-02T01:03:46Z,6,14,20
"C-tracking-issue;T-lang,C-tracking-issue;T-lang",51298,2018-06-02T12:01:13Z,13,65,78
"S-waiting-on-review,S-waiting-on-review",51299,2018-06-02T12:29:42Z,313,14,327
NULL,51307,2018-06-02T17:42:11Z,82,90,172
NULL,51308,2018-06-02T17:56:03Z,28,22,50
"S-waiting-on-review,S-waiting-on-review,S-waiting-on-review,S-waiting-on-review,S-waiting-on-review",51310,2018-06-02T19:14:30Z,105,17,122
NULL,51312,2018-06-02T20:06:47Z,30,4,34
NULL,51316,2018-06-02T21:44:35Z,882,462,1344
NULL,51318,2018-06-02T22:36:11Z,0,0,0
"S-waiting-on-review,S-waiting-on-review;T-libs;relnotes,S-waiting-on-review,S-waiting-on-review,S-waiting-on-review,S-waiting-on-review,S-waiting-on-review,S-waiting-on-review;T-libs;relnotes,S-waiting-on-review,S-waiting-on-review,S-waiting-on-review,S-waiting-on-review",51319,2018-06-03T01:55:12Z,99,57,156
"B-unstable;I-nominated;T-libs,B-unstable;I-nominated;T-libs",51320,2018-06-03T02:57:48Z,4,18,22
"S-waiting-on-review,S-waiting-on-review",51321,2018-06-03T03:59:24Z,85,74,159
"A-codegen;A-llvm;I-compiletime;P-low,A-codegen;A-llvm;I-compiletime;P-low,A-codegen;A-llvm;I-compiletime;P-low,A-codegen;A-llvm;I-compiletime;P-low",51323,2018-06-03T09:00:45Z,14,5,19
"S-waiting-on-review,S-waiting-on-review,S-waiting-on-review,S-waiting-on-review",51329,2018-06-03T17:11:56Z,0,2,2
"S-waiting-on-review,S-waiting-on-review",51333,2018-06-03T22:05:41Z,3,2,5
"S-waiting-on-bors,S-waiting-on-review,S-waiting-on-review,S-waiting-on-review,S-waiting-on-review,S-waiting-on-review,S-waiting-on-bors,S-waiting-on-review,S-waiting-on-review,S-waiting-on-review,S-waiting-on-review,S-waiting-on-review",51334,2018-06-04T00:18:09Z,363,51,414
"S-waiting-on-review,S-waiting-on-review,S-waiting-on-review,S-waiting-on-review",51335,2018-06-04T01:13:42Z,140,29,169
"S-waiting-on-review,S-waiting-on-review",51336,2018-06-04T02:25:29Z,0,0,0
NULL,51339,2018-06-04T07:50:26Z,54,8,62
S-waiting-on-review,51340,2018-06-04T08:21:05Z,16,3,19
NULL,51357,2018-06-04T22:17:10Z,0,0,0
NULL,51360,2018-06-05T01:53:50Z,92,4,96
A-const-eval;C-bug,51361,2018-06-05T07:21:15Z,1013,177,1190
"B-unstable,B-unstable,B-unstable,B-unstable",51363,2018-06-05T08:50:02Z,11,205,216
"S-waiting-on-review,S-waiting-on-review",51364,2018-06-05T09:04:03Z,0,0,0
"B-RFC-approved;T-libs,B-RFC-approved;T-libs,S-waiting-on-review,S-waiting-on-review,B-RFC-approved;T-libs,B-RFC-approved;T-libs,S-waiting-on-review,B-RFC-approved;T-libs,S-waiting-on-review",51366,2018-06-05T09:30:18Z,17,67,84
NULL,51368,2018-06-05T13:37:32Z,22,1,23
"S-waiting-on-review,S-waiting-on-review,S-waiting-on-review,S-waiting-on-review,S-waiting-on-review,S-waiting-on-review,S-waiting-on-bors",51369,2018-06-05T14:33:52Z,141,48,189
"A-diagnostics;E-easy,S-waiting-on-review,S-waiting-on-review,S-waiting-on-review,S-waiting-on-review,S-waiting-on-review,A-diagnostics;E-easy,S-waiting-on-review,S-waiting-on-review,S-waiting-on-review,S-waiting-on-review,S-waiting-on-review",51379,2018-06-05T21:09:42Z,0,0,0
"S-waiting-on-review,S-waiting-on-review",51383,2018-06-05T22:26:35Z,103,43,146
A-rustdoc,51384,2018-06-05T23:44:03Z,76,3,79
NULL,51389,2018-06-06T07:00:05Z,52,3,55
"S-waiting-on-review,S-waiting-on-review",51391,2018-06-06T07:33:37Z,177,43,220
"B-RFC-approved;T-lang,B-RFC-approved;T-lang",51395,2018-06-06T11:38:22Z,8,0,8
"B-RFC-approved;C-tracking-issue;T-libs,B-RFC-approved;C-tracking-issue;T-libs",51396,2018-06-06T11:54:55Z,2,2,4
"NLL-performant;T-compiler;WG-compiler-nll,NLL-performant;T-compiler;WG-compiler-nll",51399,2018-06-06T16:32:56Z,9,7,16
"T-compiler,T-compiler",51401,2018-06-06T17:03:13Z,398,202,600
"S-waiting-on-bors,S-waiting-on-review,S-waiting-on-bors,S-waiting-on-review,S-waiting-on-review,S-waiting-on-review,S-waiting-on-review,S-waiting-on-review,S-waiting-on-review",51403,2018-06-06T22:33:26Z,0,0,0
"S-waiting-on-review,S-waiting-on-review,S-waiting-on-review,S-waiting-on-review,S-waiting-on-review,S-waiting-on-bors,S-waiting-on-review,S-waiting-on-review,S-waiting-on-review,S-waiting-on-review,S-waiting-on-review,S-waiting-on-review,S-waiting-on-bors,S-waiting-on-review",51406,2018-06-07T01:13:33Z,0,0,0
"S-waiting-on-review,S-waiting-on-review",51408,2018-06-07T05:15:48Z,0,0,0
NULL,51417,2018-06-07T15:10:03Z,156,72,228
NULL,51425,2018-06-07T22:36:20Z,220,67,287
"S-waiting-on-review,S-waiting-on-review,S-waiting-on-review;T-lang;beta-nominated,S-waiting-on-review,S-waiting-on-review,S-waiting-on-bors,S-waiting-on-bors;beta-nominated,S-waiting-on-review,S-waiting-on-bors",51426,2018-06-07T23:05:49Z,533,174,707
"S-waiting-on-bors,A-testsuite;E-mentor,S-waiting-on-bors",51427,2018-06-08T00:12:36Z,51,8,59
S-waiting-on-review,51428,2018-06-08T02:49:56Z,65,94,159
"S-waiting-on-review,S-waiting-on-review;T-compiler;beta-nominated,S-waiting-on-bors;beta-nominated,S-waiting-on-review;T-lang;beta-nominated,S-waiting-on-review,S-waiting-on-review;T-compiler;beta-nominated,S-waiting-on-review;T-lang;beta-nominated,S-waiting-on-bors;beta-nominated",51432,2018-06-08T08:02:20Z,346,127,473
"A-rust-2018-preview;T-libs,A-rust-2018-preview;T-libs",51434,2018-06-08T13:51:50Z,0,0,0
NULL,51436,2018-06-08T14:31:32Z,1,4,5
S-waiting-on-review,51440,2018-06-08T18:59:36Z,0,0,0
"E-easy;I-cleanup,A-diagnostics;A-impl-trait,A-diagnostics;A-impl-trait",51444,2018-06-08T22:27:20Z,206,1,207
"S-waiting-on-review;T-lang,S-waiting-on-review,S-waiting-on-review,S-waiting-on-review,S-waiting-on-review,S-waiting-on-review,S-waiting-on-review,A-testsuite;E-mentor,S-waiting-on-review,S-waiting-on-review,S-waiting-on-review,S-waiting-on-review,S-waiting-on-review,S-waiting-on-review",51448,2018-06-08T23:21:11Z,1086,435,1521
NULL,51450,2018-06-09T01:25:44Z,87,1,88
"A-diagnostics;A-rust-2018-preview;T-compiler;WG-epoch,A-diagnostics;A-rust-2018-preview;T-compiler;WG-epoch",51456,2018-06-09T14:15:06Z,138,22,160
A-rustbuild;A-sanitizers;A-spurious;C-tracking-issue,51459,2018-06-09T20:33:54Z,59,28,87
NULL,51461,2018-06-09T21:28:28Z,30,4,34
"S-waiting-on-review,S-waiting-on-review",51462,2018-06-09T22:11:25Z,5,3,8
S-waiting-on-review,51463,2018-06-09T23:19:44Z,559,376,935
"B-RFC-approved;T-libs,B-RFC-approved;T-libs",51464,2018-06-09T23:52:08Z,0,0,0
NULL,51467,2018-06-10T06:35:41Z,25,1,26
NULL,51474,2018-06-10T11:22:56Z,39,13,52
"A-macros;C-bug,A-macros;C-bug",51480,2018-06-10T21:39:46Z,52,1,53
"T-rustdoc,T-rustdoc",51482,2018-06-10T22:32:15Z,3,7,10
"A-incr-comp;A-macros;A-resolve;A-syntaxext;C-bug,S-waiting-on-review,A-incr-comp;A-macros;A-resolve;A-syntaxext;C-bug,S-waiting-on-review",51492,2018-06-11T10:05:13Z,673,867,1540
"S-waiting-on-review,S-waiting-on-review",51498,2018-06-11T14:13:54Z,1,1,2
"S-waiting-on-review,S-waiting-on-review",51502,2018-06-11T16:53:29Z,2,2,4
"S-waiting-on-review,S-waiting-on-review,S-waiting-on-review,S-waiting-on-review,S-waiting-on-review,S-waiting-on-review,S-waiting-on-review,S-waiting-on-review",51504,2018-06-11T17:04:03Z,0,0,0
NULL,51507,2018-06-11T19:12:19Z,0,2,2
"S-waiting-on-review,S-waiting-on-bors,S-waiting-on-review,S-waiting-on-bors,S-waiting-on-review,S-waiting-on-review",51508,2018-06-11T19:20:11Z,2,2,4
B-unstable;C-tracking-issue;T-libs,51511,2018-06-11T21:15:25Z,7,15,22
"S-waiting-on-review,S-waiting-on-review",51514,2018-06-12T08:34:59Z,0,0,0
A-macros;C-bug,51519,2018-06-12T12:52:33Z,147,32,179
"S-waiting-on-review,S-waiting-on-review,C-enhancement;S-waiting-on-review;T-release;beta-nominated",51521,2018-06-12T17:22:55Z,188,3,191
"A-diagnostics;WG-compiler-nll,A-diagnostics;WG-compiler-nll",51536,2018-06-13T15:16:55Z,559,399,958
"S-waiting-on-review,S-waiting-on-review",51538,2018-06-13T15:51:06Z,3147,1773,4920
E-easy,51542,2018-06-13T22:19:21Z,0,234,234
"S-waiting-on-review,S-waiting-on-review",51549,2018-06-14T08:20:08Z,2,2,4
NULL,51555,2018-06-14T16:01:13Z,0,3,3
"B-RFC-approved;T-lang,B-RFC-approved;T-lang",51562,2018-06-14T19:01:36Z,9,237,246
NULL,51563,2018-06-14T21:04:40Z,0,0,0
NULL,51564,2018-06-14T21:32:46Z,191,101,292
NULL,51566,2018-06-15T00:23:10Z,0,0,0
"B-unstable;T-libs,B-unstable;T-libs",51569,2018-06-15T02:13:48Z,121,105,226
NULL,51571,2018-06-15T04:15:48Z,0,0,0
"A-generators;B-RFC-approved;C-tracking-issue;E-needs-mentor;T-lang,S-waiting-on-review,A-generators;B-RFC-approved;C-tracking-issue;E-needs-mentor;T-lang,S-waiting-on-review",51580,2018-06-15T21:32:34Z,1796,538,2334
"T-doc,T-doc",51581,2018-06-15T21:39:58Z,84,2,86
"S-waiting-on-review,S-waiting-on-review",51583,2018-06-15T23:08:38Z,96,50,146
"T-rustdoc,T-rustdoc",51584,2018-06-15T23:20:36Z,60,0,60
"A-associated-items;A-traits;A-typesystem;B-RFC-approved;B-unstable;C-tracking-issue;T-lang,A-associated-items;A-traits;A-typesystem;B-RFC-approved;B-unstable;C-tracking-issue;T-lang,A-associated-items;A-traits;A-typesystem;B-RFC-approved;B-unstable;C-tracking-issue;T-lang,A-associated-items;A-traits;A-typesystem;B-RFC-approved;B-unstable;C-tracking-issue;T-lang",51589,2018-06-16T08:40:45Z,0,0,0
S-waiting-on-bors;beta-nominated,51591,2018-06-16T11:42:21Z,0,7,7
NULL,51592,2018-06-16T12:15:24Z,22,4,26
"C-enhancement;S-waiting-on-review;T-release;beta-nominated,S-waiting-on-bors;beta-nominated",51593,2018-06-16T12:20:33Z,158,0,158
NULL,51594,2018-06-16T13:02:37Z,37,2,39
NULL,51596,2018-06-16T17:13:48Z,5,1,6
"A-iterators;S-waiting-on-review;T-libs,A-libs;I-slow,A-iterators;S-waiting-on-review;T-libs,A-libs;I-slow",51601,2018-06-16T21:13:01Z,81,7,88
"A-allocators;C-tracking-issue;T-libs,A-allocators;C-tracking-issue;T-libs",51607,2018-06-17T15:04:31Z,0,0,0
"S-waiting-on-review,S-waiting-on-review",51611,2018-06-17T20:02:19Z,124,47,171
NULL,51612,2018-06-17T23:51:09Z,49,2,51
"A-diagnostics;C-enhancement,A-diagnostics;C-enhancement",51614,2018-06-18T01:30:52Z,38,29,67
NULL,51622,2018-06-18T21:05:35Z,208,112,320
NULL,51628,2018-06-19T03:58:39Z,23,10,33
"S-waiting-on-review,S-waiting-on-review",51630,2018-06-19T06:03:59Z,40,34,74
NULL,51638,2018-06-19T18:14:24Z,784,454,1238
NULL,51642,2018-06-19T22:07:29Z,3,0,3
"S-waiting-on-review,S-waiting-on-review,S-waiting-on-review,S-waiting-on-review",51643,2018-06-19T22:09:49Z,0,0,0
NULL,51645,2018-06-19T23:34:30Z,7,0,7
NULL,51651,2018-06-20T04:33:07Z,58,0,58
"T-compiler;WG-compiler-performance,T-compiler;WG-compiler-performance",51657,2018-06-20T12:20:00Z,332,1,333
"NLL-performant;T-compiler;WG-compiler-nll,NLL-performant;T-compiler;WG-compiler-nll",51660,2018-06-20T16:14:47Z,84,33,117
NULL,51662,2018-06-20T17:05:58Z,6,6,12
"S-waiting-on-review,S-waiting-on-review",51664,2018-06-20T19:03:45Z,3,3,6
NULL,51670,2018-06-20T23:56:29Z,100,12,112
"S-waiting-on-review,S-waiting-on-review",51681,2018-06-21T13:39:52Z,17,2,19
NULL,51686,2018-06-21T17:34:14Z,48,5,53
NULL,51687,2018-06-21T18:03:47Z,52,0,52
NULL,51688,2018-06-21T18:09:42Z,768,486,1254
NULL,51690,2018-06-21T20:40:04Z,87,14,101
NULL,51695,2018-06-22T00:05:01Z,5,1,6
NULL,51696,2018-06-22T01:19:38Z,41,1,42
NULL,51701,2018-06-22T07:23:03Z,6,0,6
NULL,51702,2018-06-22T08:01:08Z,301,26,327
NULL,51703,2018-06-22T08:24:41Z,1,0,1
"S-waiting-on-bors,S-waiting-on-review,S-waiting-on-review,S-waiting-on-review,S-waiting-on-review,S-waiting-on-review",51704,2018-06-22T08:50:47Z,37,8,45
"A-rustbuild,A-rustbuild",51712,2018-06-22T14:17:47Z,12,0,12
NULL,51723,2018-06-22T22:37:18Z,38,0,38
"S-waiting-on-review,S-waiting-on-review",51724,2018-06-22T23:43:24Z,2,2,4
"S-waiting-on-review,S-waiting-on-review",51725,2018-06-23T01:46:11Z,3,6,9
"A-borrow-checker;A-diagnostics;WG-compiler-nll,A-borrow-checker;A-diagnostics;WG-compiler-nll,A-borrow-checker;A-diagnostics;WG-compiler-nll",51729,2018-06-23T11:24:55Z,997,321,1318
B-RFC-approved;C-tracking-issue;T-libs,51730,2018-06-23T11:35:52Z,15,14,29
NULL,51731,2018-06-23T12:29:15Z,87,31,118
"A-rustdoc,A-rustdoc",51732,2018-06-23T13:10:02Z,58,20,78
NULL,51733,2018-06-23T13:43:25Z,32,4,36
S-waiting-on-review,51740,2018-06-23T18:15:32Z,13,13,26
NULL,51747,2018-06-23T21:35:31Z,44,10,54
"A-rust-2018-preview,A-rust-2018-preview,A-rust-2018-preview",51750,2018-06-24T00:12:34Z,218,56,274
NULL,51753,2018-06-24T07:46:31Z,20,0,20
NULL,51762,2018-06-24T17:45:34Z,549,169,718
"S-waiting-on-review,S-waiting-on-review,S-waiting-on-review,S-waiting-on-review,S-waiting-on-review",51782,2018-06-25T16:02:18Z,0,0,0
NULL,51786,2018-06-25T19:43:08Z,2,2,4
"S-waiting-on-review,S-waiting-on-review",51789,2018-06-25T20:46:53Z,39,11,50
NULL,51790,2018-06-25T21:17:59Z,5,6,11
NULL,51793,2018-06-25T22:39:15Z,1,1,2
"S-waiting-on-bors,S-waiting-on-review,S-waiting-on-review,S-waiting-on-review,S-waiting-on-review,S-waiting-on-review,S-waiting-on-review,S-waiting-on-review,S-waiting-on-review,S-waiting-on-review,S-waiting-on-review",51805,2018-06-26T09:35:46Z,397,244,641
NULL,51807,2018-06-26T10:41:22Z,25,23,48
"regression-from-stable-to-nightly,C-bug;O-macos;T-compiler;regression-from-stable-to-nightly",51828,2018-06-26T22:57:05Z,96,3,99
"S-waiting-on-review,S-waiting-on-review",51829,2018-06-26T23:29:12Z,365,595,960
"A-io;B-unstable;T-libs,A-io;B-unstable;T-libs",51832,2018-06-27T03:59:04Z,0,0,0
NULL,51833,2018-06-27T04:06:44Z,118,25,143
NULL,51835,2018-06-27T05:20:11Z,4,12,16
"A-traits;I-compiletime;T-compiler;WG-compiler-traits,A-traits;I-compiletime;T-compiler;WG-compiler-traits",51837,2018-06-27T08:26:20Z,0,0,0
"NLL-performant;T-compiler;WG-compiler-nll,NLL-performant;T-compiler;WG-compiler-nll",51849,2018-06-27T15:53:44Z,448,362,810
NULL,51851,2018-06-27T16:13:19Z,0,0,0
I-ICE;T-compiler;regression-from-stable-to-beta,51852,2018-06-27T16:25:44Z,29,1,30
NULL,51854,2018-06-27T19:57:29Z,81,10,91
"S-waiting-on-review;beta-nominated,S-waiting-on-bors;beta-nominated,S-waiting-on-review,S-waiting-on-review;beta-nominated,S-waiting-on-bors;beta-nominated,S-waiting-on-review,S-waiting-on-bors,S-waiting-on-review",51857,2018-06-27T21:47:59Z,220,42,262
"S-waiting-on-review,S-waiting-on-review,S-waiting-on-review,S-waiting-on-review,S-waiting-on-review,S-waiting-on-review",51859,2018-06-27T22:15:45Z,271,67,338
"A-diagnostics,S-waiting-on-review,A-diagnostics,S-waiting-on-review",51866,2018-06-28T06:58:30Z,345,189,534
"S-waiting-on-review,S-waiting-on-review",51867,2018-06-28T09:19:37Z,0,0,0
NULL,51876,2018-06-28T14:59:01Z,0,0,0
"S-waiting-on-review,S-waiting-on-review",51877,2018-06-28T15:41:34Z,127,117,244
"S-waiting-on-review,S-waiting-on-review",51880,2018-06-28T21:17:18Z,973,801,1774
NULL,51882,2018-06-28T21:53:24Z,28,11,39
"A-diagnostics;A-frontend;C-feature-request,A-diagnostics;A-frontend;C-feature-request",51883,2018-06-28T22:00:25Z,62,6,68
"S-waiting-on-review,S-waiting-on-review,S-waiting-on-review,S-waiting-on-bors,S-waiting-on-review,S-waiting-on-review",51884,2018-06-28T22:07:18Z,577,827,1404
NULL,51885,2018-06-28T22:15:29Z,77,97,174
"NLL-performant;T-compiler;WG-compiler-nll,NLL-performant;T-compiler;WG-compiler-nll",51889,2018-06-28T23:39:08Z,336,437,773
"A-typesystem;I-wrong,A-typesystem;I-wrong",51894,2018-06-29T08:52:25Z,357,16,373
"S-waiting-on-review,S-waiting-on-review",51895,2018-06-29T09:45:35Z,205,67,272
NULL,51899,2018-06-29T13:03:49Z,17,101,118
NULL,51901,2018-06-29T14:19:17Z,192,44,236
NULL,51912,2018-06-29T18:50:40Z,24,0,24
"A-amusing;A-traits,A-amusing;A-traits",51914,2018-06-29T19:14:14Z,10,7,17
NULL,51920,2018-06-29T20:57:09Z,29,4,33
NULL,51921,2018-06-29T21:04:34Z,26,4,30
"WG-embedded,WG-embedded",51922,2018-06-29T21:20:06Z,15,12,27
S-waiting-on-review,51923,2018-06-29T22:30:20Z,1,1,2
NULL,51926,2018-06-29T23:09:34Z,42,28,70
"S-waiting-on-review,S-waiting-on-review,S-waiting-on-review,S-waiting-on-review,S-waiting-on-review,S-waiting-on-review,S-waiting-on-review,S-waiting-on-review,S-waiting-on-bors,S-waiting-on-review,S-waiting-on-review,S-waiting-on-review,S-waiting-on-review,S-waiting-on-review,S-waiting-on-review,S-waiting-on-review,S-waiting-on-review,S-waiting-on-review,S-waiting-on-review,S-waiting-on-bors",51930,2018-06-30T00:53:01Z,0,0,0
"A-diagnostics;T-compiler,A-diagnostics;T-compiler",51938,2018-06-30T05:34:25Z,82,2,84
"S-waiting-on-review,S-waiting-on-bors,S-waiting-on-review,A-iterators;S-waiting-on-crater;S-waiting-on-review;T-libs;relnotes,B-unstable;C-tracking-issue;T-libs,S-waiting-on-review,S-waiting-on-review,S-waiting-on-bors,S-waiting-on-review,S-waiting-on-bors,S-waiting-on-review,S-waiting-on-review,S-waiting-on-review,A-iterators;S-waiting-on-crater;S-waiting-on-review;T-libs;relnotes,S-waiting-on-bors,B-unstable;C-tracking-issue;T-libs,S-waiting-on-review,S-waiting-on-review,S-waiting-on-review,S-waiting-on-review",51948,2018-06-30T18:26:32Z,0,0,0
NULL,51952,2018-06-30T19:34:21Z,450,173,623
NULL,51953,2018-06-30T20:03:39Z,52,13,65
"A-diagnostics;C-enhancement;E-easy;WG-compiler-errors,A-diagnostics;C-enhancement;E-easy;WG-compiler-errors",51955,2018-06-30T21:13:32Z,18,0,18
"T-rustdoc;regression-from-stable-to-nightly,T-rustdoc;regression-from-stable-to-nightly",51956,2018-06-30T22:28:25Z,57,4,61
NULL,51958,2018-07-01T03:09:21Z,786,678,1464
NULL,51959,2018-07-01T03:40:46Z,503,235,738
"A-NLL;NLL-diagnostics,NLL-complete;T-compiler;WG-compiler-nll,A-NLL;NLL-diagnostics,NLL-complete;T-compiler;WG-compiler-nll",51964,2018-07-01T16:17:49Z,212,48,260
"B-unstable;C-tracking-issue;T-libs,S-waiting-on-review,S-waiting-on-review,S-waiting-on-review,S-waiting-on-bors,S-waiting-on-review,A-iterators;S-waiting-on-crater;S-waiting-on-review;T-libs;relnotes,S-waiting-on-review",51965,2018-07-01T16:22:28Z,0,0,0
"A-LLVM;C-tracking-issue,S-waiting-on-review",51966,2018-07-01T16:55:39Z,202,198,400
NULL,51967,2018-07-01T17:33:49Z,288,156,444
"S-waiting-on-review,S-waiting-on-bors,S-waiting-on-review,A-iterators;S-waiting-on-crater;S-waiting-on-review;T-libs;relnotes,B-unstable;C-tracking-issue;T-libs,S-waiting-on-review,S-waiting-on-review,S-waiting-on-review",51969,2018-07-01T19:18:52Z,89,42,131
NULL,51973,2018-07-01T22:12:11Z,26,0,26
NULL,51978,2018-07-02T03:04:48Z,38,6,44
NULL,51980,2018-07-02T09:43:24Z,10,4,14
"A-incr-comp,A-incr-comp",51982,2018-07-02T14:23:06Z,51,11,62
NULL,51989,2018-07-02T16:59:48Z,0,0,0
"S-waiting-on-review,S-waiting-on-review,S-waiting-on-review,S-waiting-on-review,S-waiting-on-review;T-libs,S-waiting-on-review,S-waiting-on-review,S-waiting-on-review,S-waiting-on-review,S-waiting-on-review,S-waiting-on-review,S-waiting-on-review,S-waiting-on-review,S-waiting-on-review,S-waiting-on-review,S-waiting-on-review,S-waiting-on-review,S-waiting-on-review,S-waiting-on-review,S-waiting-on-review;T-libs,S-waiting-on-review,S-waiting-on-review,S-waiting-on-review,S-waiting-on-review",52001,2018-07-02T19:16:30Z,0,0,0
"B-RFC-approved;C-tracking-issue;T-libs,B-RFC-approved;C-tracking-issue;T-libs,B-RFC-approved;C-tracking-issue;T-libs,B-RFC-approved;C-tracking-issue;T-libs",52003,2018-07-02T20:54:02Z,43,0,43
"A-LLVM;O-wasm,A-LLVM;O-wasm",52005,2018-07-02T20:56:38Z,1,1,2
"NLL-performant;T-compiler;WG-compiler-nll,NLL-performant;T-compiler;WG-compiler-nll",52007,2018-07-02T22:21:14Z,0,0,0
"T-compiler,T-compiler",52010,2018-07-03T02:29:03Z,130,104,234
B-RFC-approved;C-tracking-issue;T-lang,52011,2018-07-03T07:50:29Z,368,25,393
"S-waiting-on-review,S-waiting-on-review,S-waiting-on-review,S-waiting-on-bors,S-waiting-on-review,S-waiting-on-review,S-waiting-on-review,S-waiting-on-bors,S-waiting-on-review,S-waiting-on-review,S-waiting-on-review,S-waiting-on-review,S-waiting-on-review",52013,2018-07-03T09:23:35Z,0,0,0
"S-waiting-on-review,S-waiting-on-bors,S-waiting-on-review,S-waiting-on-review,S-waiting-on-review,S-waiting-on-bors,S-waiting-on-review,S-waiting-on-review,S-waiting-on-review,S-waiting-on-review,S-waiting-on-review,S-waiting-on-review",52014,2018-07-03T09:31:15Z,1259,921,2180
NULL,52016,2018-07-03T10:04:32Z,4,24,28
A-attributes;C-tracking-issue;T-dev-tools,52018,2018-07-03T11:55:46Z,201,0,201
"A-allocators;T-compiler,A-allocators;I-enhancement;T-libs,A-allocators;T-compiler,A-allocators;I-enhancement;T-libs",52020,2018-07-03T15:10:25Z,0,0,0
"S-waiting-on-review,S-waiting-on-review",52021,2018-07-03T15:48:43Z,694,295,989
NULL,52031,2018-07-03T20:20:27Z,7,6,13
"A-rustbuild;E-mentor,A-rustbuild;E-mentor,S-waiting-on-review",52036,2018-07-03T22:16:04Z,90,109,199
"E-mentor;I-nominated;NLL-performant;WG-compiler-nll,E-mentor;I-nominated;NLL-performant;WG-compiler-nll",52037,2018-07-03T22:32:43Z,9,0,9
"S-waiting-on-review,S-waiting-on-review",52046,2018-07-04T01:20:56Z,246,44,290
"S-waiting-on-review,S-waiting-on-review",52051,2018-07-04T10:23:24Z,41,1,42
NULL,52058,2018-07-04T19:09:05Z,70,41,111
NULL,52067,2018-07-05T01:49:30Z,45,45,90
"S-waiting-on-review,E-needs-mentor;T-compiler;WG-compiler-middle,S-waiting-on-review,E-needs-mentor;T-compiler;WG-compiler-middle",52069,2018-07-05T04:34:41Z,324,53,377
S-waiting-on-review,52076,2018-07-05T14:33:02Z,120,7,127
NULL,52077,2018-07-05T15:01:08Z,0,0,0
NULL,52080,2018-07-05T17:04:00Z,23,6,29
A-attributes;A-macros;A-rust-2018-preview;P-high;T-dev-tools,52081,2018-07-05T17:53:59Z,241,515,756
NULL,52087,2018-07-05T22:56:22Z,7,1,8
"S-waiting-on-review,S-waiting-on-review,S-waiting-on-review,S-waiting-on-review,S-waiting-on-review,S-waiting-on-review,S-waiting-on-review,S-waiting-on-review,S-waiting-on-bors,S-waiting-on-review,S-waiting-on-review,S-waiting-on-review,S-waiting-on-review,S-waiting-on-review,S-waiting-on-review,S-waiting-on-review,S-waiting-on-review,S-waiting-on-review,S-waiting-on-bors,S-waiting-on-review,S-waiting-on-review,S-waiting-on-review",52088,2018-07-05T23:07:25Z,138,73,211
NULL,52089,2018-07-05T23:43:38Z,69,37,106
NULL,52091,2018-07-06T00:41:20Z,0,0,0
"B-unstable;O-wasm;T-compiler,B-unstable;O-wasm;T-compiler",52093,2018-07-06T01:17:03Z,2,2,4
"S-waiting-on-review,S-waiting-on-review,S-waiting-on-review,S-waiting-on-review,S-waiting-on-review,S-waiting-on-review,S-waiting-on-review,S-waiting-on-review",52101,2018-07-06T06:13:27Z,133,44,177
"B-unstable;C-tracking-issue;T-libs,B-unstable;C-tracking-issue;T-libs",52103,2018-07-06T07:02:01Z,2,4,6
"A-diagnostics;E-easy,A-diagnostics;E-easy",52106,2018-07-06T10:16:27Z,48,1,49
NULL,52107,2018-07-06T11:10:42Z,0,2,2
"A-allocators;C-tracking-issue;T-libs,A-allocators;C-tracking-issue;T-libs",52110,2018-07-06T14:45:17Z,0,0,0
"NLL-performant;T-compiler;WG-compiler-nll,NLL-performant;T-compiler;WG-compiler-nll",52115,2018-07-06T17:09:57Z,302,357,659
"S-waiting-on-review,S-waiting-on-review",52116,2018-07-06T17:55:57Z,30,2,32
S-waiting-on-review,52121,2018-07-06T23:58:11Z,42,44,86
"S-waiting-on-review,S-waiting-on-bors,S-waiting-on-review,S-waiting-on-review,S-waiting-on-review,S-waiting-on-review,S-waiting-on-review,S-waiting-on-bors",52123,2018-07-07T03:29:22Z,354,175,529
"S-waiting-on-bors,S-waiting-on-review,S-waiting-on-bors",52132,2018-07-07T14:27:03Z,8,3,11
NULL,52136,2018-07-07T17:30:42Z,0,0,0
NULL,52145,2018-07-07T21:34:43Z,6,1,7
"B-RFC-approved;T-libs,B-RFC-approved;T-libs,A-attributes;B-RFC-implemented;S-waiting-on-review;T-lang;T-libs",52149,2018-07-08T03:15:11Z,3,0,3
NULL,52151,2018-07-08T13:07:44Z,18,14,32
T-compiler;WG-compiler-traits,52153,2018-07-08T15:30:04Z,44,1,45
NULL,52156,2018-07-08T16:26:23Z,30,10,40
"S-waiting-on-review,S-waiting-on-review",52160,2018-07-08T19:19:00Z,35,0,35
NULL,52166,2018-07-09T03:06:11Z,9,3,12
A-frontend;I-wrong,52175,2018-07-09T12:00:03Z,137,49,186
NULL,52177,2018-07-09T13:43:44Z,8,0,8
"A-diagnostics;C-enhancement,A-diagnostics;C-enhancement",52178,2018-07-09T13:59:02Z,0,0,0
NULL,52181,2018-07-09T15:37:19Z,132,55,187
"A-NLL,S-waiting-on-review,S-waiting-on-review,A-NLL",52190,2018-07-09T21:07:41Z,174,121,295
NULL,52193,2018-07-09T22:09:11Z,22,1,23
"S-waiting-on-review,S-waiting-on-review",52196,2018-07-09T23:39:10Z,32,5,37
NULL,52197,2018-07-10T00:26:51Z,110,25,135
"S-waiting-on-review,S-waiting-on-review,S-waiting-on-review;T-release;beta-accepted;beta-nominated,S-waiting-on-review,S-waiting-on-review,S-waiting-on-review,S-waiting-on-review,S-waiting-on-review,S-waiting-on-review,S-waiting-on-review,S-waiting-on-review,S-waiting-on-review;T-release;beta-accepted;beta-nominated,S-waiting-on-review,S-waiting-on-review,S-waiting-on-review,S-waiting-on-review",52199,2018-07-10T01:36:47Z,0,0,0
NULL,52204,2018-07-10T05:16:42Z,55,1,56
NULL,52205,2018-07-10T06:24:31Z,0,0,0
NULL,52206,2018-07-10T07:08:12Z,277,212,489
NULL,52207,2018-07-10T09:09:26Z,114,50,164
"regression-from-stable-to-nightly,S-waiting-on-review,S-waiting-on-review,S-waiting-on-review,S-waiting-on-review,regression-from-stable-to-nightly,S-waiting-on-review,S-waiting-on-review,S-waiting-on-review,S-waiting-on-review",52212,2018-07-10T14:51:37Z,0,7,7
"S-waiting-on-review,S-waiting-on-review,S-waiting-on-review,S-waiting-on-review;T-release;beta-accepted;beta-nominated,S-waiting-on-review,S-waiting-on-review,S-waiting-on-review,S-waiting-on-review",52229,2018-07-10T20:56:44Z,226,25,251
"A-macros-1.2;A-macros-2.0,A-macros-1.2;A-macros-2.0",52230,2018-07-10T21:06:50Z,69,1,70
"S-waiting-on-review,S-waiting-on-review",52232,2018-07-10T22:16:24Z,31,4,35
S-waiting-on-review,52234,2018-07-10T23:54:47Z,415,32,447
NULL,52238,2018-07-11T02:26:21Z,5,1,6
"S-waiting-on-review,S-waiting-on-review,S-waiting-on-review",52242,2018-07-11T06:40:29Z,239,60,299
"S-waiting-on-review,S-waiting-on-review,S-waiting-on-review,S-waiting-on-review,S-waiting-on-bors",52245,2018-07-11T08:02:05Z,187,168,355
"S-waiting-on-review,S-waiting-on-review",52257,2018-07-11T14:13:15Z,16,72,88
NULL,52264,2018-07-11T15:39:37Z,2058,1968,4026
"S-waiting-on-review,S-waiting-on-review,S-waiting-on-review,S-waiting-on-review,S-waiting-on-review,S-waiting-on-review,S-waiting-on-review,S-waiting-on-review,S-waiting-on-review,S-waiting-on-review,S-waiting-on-review,S-waiting-on-review,S-waiting-on-review,S-waiting-on-review",52268,2018-07-11T18:38:50Z,865,480,1345
"A-edition-2018-lints,A-edition-2018-lints",52275,2018-07-11T21:27:51Z,99,1,100
NULL,52276,2018-07-11T22:50:47Z,78,4,82
"S-waiting-on-review,S-waiting-on-review,S-waiting-on-review,S-waiting-on-review,S-waiting-on-review,S-waiting-on-review,S-waiting-on-review",52303,2018-07-12T12:25:34Z,182,68,250
"S-waiting-on-review,S-waiting-on-review,S-waiting-on-review,S-waiting-on-review,S-waiting-on-review;T-release;beta-accepted;beta-nominated",52308,2018-07-12T15:14:01Z,234,66,300
NULL,52314,2018-07-12T16:12:57Z,28,1,29
"A-diagnostics,A-diagnostics",52315,2018-07-12T17:01:16Z,1,21,22
"S-waiting-on-review,S-waiting-on-review",52322,2018-07-12T19:33:54Z,1,1,2
"S-waiting-on-review,S-waiting-on-bors,S-waiting-on-review,S-waiting-on-review,S-waiting-on-review,S-waiting-on-review,S-waiting-on-review,S-waiting-on-review,A-diagnostics,S-waiting-on-review,S-waiting-on-review,S-waiting-on-review,S-waiting-on-bors,S-waiting-on-review",52324,2018-07-12T20:12:53Z,0,0,0
"A-edition-2018-lints;A-lint,A-edition-2018-lints;A-lint",52326,2018-07-12T21:19:25Z,32,3,35
NULL,52328,2018-07-12T23:12:10Z,39,10,49
NULL,52332,2018-07-13T03:51:01Z,14,10,24
NULL,52340,2018-07-13T10:53:57Z,48,0,48
"S-waiting-on-review,S-waiting-on-review,A-diagnostics,S-waiting-on-review,S-waiting-on-review,S-waiting-on-review,S-waiting-on-review,S-waiting-on-review,S-waiting-on-bors,S-waiting-on-bors,S-waiting-on-review,S-waiting-on-review,S-waiting-on-review,S-waiting-on-review,S-waiting-on-review,S-waiting-on-review,S-waiting-on-review",52344,2018-07-13T13:36:28Z,0,0,0
NULL,52346,2018-07-13T13:51:44Z,3,3,6
NULL,52348,2018-07-13T14:31:45Z,41,6,47
"S-waiting-on-review,S-waiting-on-review,S-waiting-on-review,S-waiting-on-bors,S-waiting-on-review,S-waiting-on-review,S-waiting-on-bors,S-waiting-on-review,S-waiting-on-review,S-waiting-on-review,S-waiting-on-review,S-waiting-on-review,S-waiting-on-review,A-diagnostics,S-waiting-on-review,S-waiting-on-review,S-waiting-on-bors,S-waiting-on-review",52352,2018-07-13T18:57:00Z,239,88,327
"B-unstable;C-tracking-issue;O-wasm;T-compiler,B-unstable;C-tracking-issue;O-wasm;T-compiler",52353,2018-07-13T19:16:07Z,147,328,475
"S-waiting-on-review,S-waiting-on-review",52354,2018-07-13T20:52:35Z,5,5,10
NULL,52359,2018-07-13T22:42:27Z,101,88,189
NULL,52360,2018-07-14T00:49:31Z,42,38,80
NULL,52361,2018-07-14T02:51:03Z,27,5,32
"S-waiting-on-bors;beta-nominated;stable-nominated,S-waiting-on-review",52366,2018-07-14T07:55:27Z,88,8,96
NULL,52367,2018-07-14T08:34:23Z,0,0,0
NULL,52368,2018-07-14T10:05:59Z,102,4,106
NULL,52372,2018-07-14T13:53:51Z,4,4,8
E-medium;P-medium;WG-epoch,52375,2018-07-14T14:41:50Z,599,183,782
A-spurious,52379,2018-07-14T15:22:26Z,7,0,7
"T-compiler,T-compiler",52381,2018-07-14T15:40:14Z,20,31,51
"S-waiting-on-review,A-macros-1.2,S-waiting-on-review,A-macros-1.2",52383,2018-07-14T17:40:11Z,247,11,258
NULL,52385,2018-07-14T18:47:25Z,26,1,27
NULL,52394,2018-07-15T03:53:23Z,351,123,474
NULL,52397,2018-07-15T07:07:22Z,92,10,102
NULL,52399,2018-07-15T07:38:30Z,9,0,9
NULL,52401,2018-07-15T11:47:09Z,52,0,52
"WG-compiler-nll,A-borrow-checker;A-diagnostics;WG-compiler-nll,WG-compiler-nll,A-borrow-checker;A-diagnostics;WG-compiler-nll",52405,2018-07-15T18:01:03Z,1822,351,2173
"A-diagnostics;E-mentor;WG-compiler-errors,A-diagnostics;E-mentor;WG-compiler-errors",52409,2018-07-15T21:13:04Z,9768,208,9976
NULL,52418,2018-07-16T05:31:54Z,57,3,60
NULL,52419,2018-07-16T06:48:08Z,3,129,132
"S-waiting-on-review,B-unstable;T-libs,S-waiting-on-review",52420,2018-07-16T07:19:05Z,0,0,0
S-waiting-on-review,52422,2018-07-16T08:11:34Z,171,457,628
"I-compiletime,I-compiletime,I-compiletime,I-compiletime",52426,2018-07-16T12:44:10Z,0,21,21
NULL,52429,2018-07-16T13:59:45Z,186,172,358
"S-waiting-on-review,S-waiting-on-review,S-waiting-on-bors,S-waiting-on-review,S-waiting-on-review,S-waiting-on-review,S-waiting-on-review,S-waiting-on-bors,S-waiting-on-review,S-waiting-on-bors,S-waiting-on-review,S-waiting-on-review,S-waiting-on-review,S-waiting-on-review,S-waiting-on-review,S-waiting-on-review",52433,2018-07-16T15:11:38Z,97,41,138
NULL,52439,2018-07-16T17:54:46Z,3,2,5
B-unstable;O-wasm;T-compiler,52441,2018-07-16T18:34:13Z,0,0,0
"B-unstable;O-wasm;T-compiler,B-unstable;O-wasm;T-compiler",52445,2018-07-16T20:39:09Z,165,160,325
"S-waiting-on-review,S-waiting-on-review",52448,2018-07-16T23:31:36Z,1,1,2
"A-diagnostics,A-diagnostics",52453,2018-07-17T11:04:07Z,8,1,9
NULL,52461,2018-07-17T15:58:58Z,3982,4321,8303
"S-waiting-on-review,S-waiting-on-review",52464,2018-07-17T16:40:22Z,2,0,2
NULL,52465,2018-07-17T17:14:27Z,11,2,13
"A-lint;E-mentor,A-lint;E-mentor,S-waiting-on-review,A-edition-2018-lints,A-lint;E-mentor,A-lint;E-mentor,S-waiting-on-review",52467,2018-07-17T18:30:05Z,125,1,126
"S-waiting-on-review,S-waiting-on-review",52476,2018-07-18T02:14:17Z,563,453,1016
NULL,52477,2018-07-18T03:40:21Z,3,1,4
NULL,52480,2018-07-18T12:00:25Z,0,3,3
S-waiting-on-bors;beta-nominated;stable-nominated,52481,2018-07-18T12:38:46Z,43,5,48
"S-waiting-on-review,S-waiting-on-review,S-waiting-on-review,S-waiting-on-review,S-waiting-on-bors,S-waiting-on-review,S-waiting-on-review,S-waiting-on-review,S-waiting-on-review,S-waiting-on-review,S-waiting-on-review,S-waiting-on-review,S-waiting-on-review,S-waiting-on-bors,S-waiting-on-review,S-waiting-on-review,S-waiting-on-review,S-waiting-on-review,S-waiting-on-review,S-waiting-on-review,S-waiting-on-review,S-waiting-on-review",52486,2018-07-18T14:35:05Z,153,42,195
"A-rustbuild;A-sanitizers;A-spurious;C-tracking-issue,A-rustbuild;A-sanitizers;A-spurious;C-tracking-issue",52487,2018-07-18T14:45:56Z,28,15,43
NULL,52498,2018-07-18T16:53:38Z,207,148,355
NULL,52502,2018-07-18T17:37:35Z,1,1,2
"A-rustdoc,A-rustdoc",52510,2018-07-18T20:41:46Z,0,1,1
"A-linkage,A-linkage",52526,2018-07-19T08:14:46Z,0,1,1
"I-ICE,I-ICE,I-ICE,I-ICE",52527,2018-07-19T08:31:10Z,0,10,10
NULL,52530,2018-07-19T09:30:05Z,0,0,0
NULL,52535,2018-07-19T14:02:44Z,1,9,10
NULL,52536,2018-07-19T14:09:00Z,132,5,137
"A-macros;C-bug,A-macros;C-bug",52539,2018-07-19T14:47:10Z,63,0,63
A-traits;T-compiler,52546,2018-07-19T17:26:37Z,121,22,143
B-RFC-approved;T-libs,52547,2018-07-19T18:37:59Z,0,0,0
NULL,52548,2018-07-19T19:17:11Z,9,8,17
"S-waiting-on-review,S-waiting-on-review",52552,2018-07-19T21:22:43Z,465,570,1035
"S-waiting-on-review,S-waiting-on-review,S-waiting-on-review",52556,2018-07-20T00:43:10Z,0,0,0
"S-waiting-on-review,S-waiting-on-review",52564,2018-07-20T12:30:51Z,107,12,119
"S-waiting-on-review,S-waiting-on-author,S-waiting-on-review,S-waiting-on-bors,S-waiting-on-review,S-waiting-on-review,S-waiting-on-review",52567,2018-07-20T13:47:49Z,0,0,0
NULL,52568,2018-07-20T14:00:48Z,151,46,197
"S-waiting-on-review,S-waiting-on-review,S-waiting-on-review,S-waiting-on-review,S-waiting-on-review,S-waiting-on-review,S-waiting-on-review,S-waiting-on-author",52570,2018-07-20T14:51:54Z,0,0,0
NULL,52571,2018-07-20T16:47:27Z,46,3,49
NULL,52572,2018-07-20T16:59:11Z,367,157,524
"S-waiting-on-review,S-waiting-on-review,S-waiting-on-review,S-waiting-on-review,S-waiting-on-review,S-waiting-on-review",52574,2018-07-20T18:59:14Z,73,61,134
NULL,52580,2018-07-20T23:15:32Z,0,0,0
S-waiting-on-review,52581,2018-07-21T00:26:33Z,43,58,101
NULL,52585,2018-07-21T12:36:48Z,246,69,315
S-waiting-on-review,52586,2018-07-21T13:00:19Z,0,0,0
"S-waiting-on-review,S-waiting-on-review,S-waiting-on-review,S-waiting-on-bors,S-waiting-on-author,S-waiting-on-review,S-waiting-on-review,S-waiting-on-review,S-waiting-on-review,S-waiting-on-review,S-waiting-on-review",52588,2018-07-21T15:59:00Z,0,0,0
S-waiting-on-review,52589,2018-07-21T19:09:32Z,49,17,66
"S-waiting-on-review,B-RFC-approved;C-tracking-issue;T-lang,A-const-fn;B-RFC-approved;T-lang,B-RFC-approved;C-tracking-issue;T-lang,A-const-fn;B-RFC-approved;T-lang",52602,2018-07-22T01:50:02Z,320,224,544
"A-diagnostics,A-diagnostics",52605,2018-07-22T05:34:28Z,38,42,80
"S-waiting-on-review,S-waiting-on-review,S-waiting-on-review,S-waiting-on-review,S-waiting-on-review,S-waiting-on-review,S-waiting-on-review,S-waiting-on-review,S-waiting-on-bors,S-waiting-on-bors,S-waiting-on-review",52616,2018-07-22T14:10:22Z,165,109,274
NULL,52618,2018-07-22T15:58:08Z,156,43,199
"S-waiting-on-bors,S-waiting-on-bors",52624,2018-07-22T19:50:32Z,46,3,49
"S-waiting-on-review,S-waiting-on-review,S-waiting-on-review,S-waiting-on-review",52626,2018-07-22T20:30:16Z,606,193,799
"A-codegen,A-codegen",52635,2018-07-23T01:36:44Z,121,47,168
"S-waiting-on-review,S-waiting-on-review",52637,2018-07-23T09:33:22Z,17,9,26
NULL,52640,2018-07-23T11:47:11Z,5,4,9
"A-lint;C-bug,A-lint;C-bug,A-lint;C-bug",52644,2018-07-23T12:54:59Z,1040,1210,2250
NULL,52645,2018-07-23T13:15:42Z,28,0,28
"A-diagnostics,A-diagnostics",52647,2018-07-23T14:20:34Z,32,0,32
"A-NLL;NLL-diagnostics;WG-compiler-nll,A-NLL;NLL-diagnostics;WG-compiler-nll",52648,2018-07-23T14:38:20Z,328,149,477
NULL,52654,2018-07-24T00:16:24Z,19,17,36
"S-waiting-on-review,S-waiting-on-review,S-waiting-on-review,S-waiting-on-review,S-waiting-on-review,S-waiting-on-review,S-waiting-on-review,S-waiting-on-review,S-waiting-on-review,S-waiting-on-review,S-waiting-on-bors,S-waiting-on-review,S-waiting-on-review,S-waiting-on-review,S-waiting-on-review,S-waiting-on-review,S-waiting-on-review,S-waiting-on-review,S-waiting-on-review,S-waiting-on-bors",52655,2018-07-24T01:50:01Z,95,99,194
NULL,52668,2018-07-24T16:24:58Z,16,4,20
NULL,52672,2018-07-24T18:23:46Z,0,0,0
NULL,52673,2018-07-24T18:48:29Z,23,2,25
"S-waiting-on-review;beta-nominated;relnotes,S-waiting-on-review,S-waiting-on-review,S-waiting-on-review,S-waiting-on-review,S-waiting-on-review,S-waiting-on-review",52680,2018-07-24T22:43:53Z,191,66,257
"S-waiting-on-review,S-waiting-on-review;beta-nominated;relnotes,S-waiting-on-review;beta-nominated;relnotes,S-waiting-on-review,S-waiting-on-review",52687,2018-07-25T06:25:45Z,156,61,217
"T-compiler;regression-from-stable-to-nightly,T-compiler;regression-from-stable-to-nightly",52695,2018-07-25T11:06:02Z,117,11,128
"A-diagnostics,A-diagnostics",52702,2018-07-25T14:36:22Z,23,0,23
NULL,52711,2018-07-25T18:24:09Z,251,96,347
NULL,52718,2018-07-25T23:43:31Z,4,2,6
NULL,52723,2018-07-26T01:05:11Z,48,4,52
NULL,52730,2018-07-26T11:10:42Z,0,0,0
"S-waiting-on-review,S-waiting-on-review",52733,2018-07-26T13:22:46Z,137,40,177
S-waiting-on-review,52734,2018-07-26T14:57:29Z,37,10,47
"S-waiting-on-review,S-waiting-on-review,S-waiting-on-review,S-waiting-on-review,S-waiting-on-review,S-waiting-on-review,S-waiting-on-review,S-waiting-on-review,S-waiting-on-bors,S-waiting-on-bors,S-waiting-on-review,S-waiting-on-author,S-waiting-on-review,S-waiting-on-review,S-waiting-on-review,S-waiting-on-review,S-waiting-on-review",52735,2018-07-26T15:18:43Z,1355,436,1791
NULL,52740,2018-07-26T16:17:52Z,69,1,70
NULL,52744,2018-07-26T16:30:37Z,7,10,17
S-waiting-on-review,52750,2018-07-26T19:42:11Z,112,12,124
S-waiting-on-review,52753,2018-07-26T20:58:16Z,0,0,0
NULL,52760,2018-07-27T00:27:11Z,12,13,25
"B-RFC-approved;T-lang,B-RFC-approved;T-lang",52761,2018-07-27T00:34:43Z,199,7,206
NULL,52775,2018-07-27T12:22:49Z,0,0,0
"S-waiting-on-review,S-waiting-on-review",52779,2018-07-27T13:12:12Z,7,7,14
"A-borrow-checker;WG-compiler-nll,A-borrow-checker;WG-compiler-nll,E-easy;I-cleanup,A-borrow-checker;WG-compiler-nll",52782,2018-07-27T16:00:22Z,586,9,595
"S-waiting-on-bors,S-waiting-on-review,S-waiting-on-review,S-waiting-on-review,S-waiting-on-review,S-waiting-on-review,S-waiting-on-review,S-waiting-on-review,S-waiting-on-bors,S-waiting-on-review,S-waiting-on-review,S-waiting-on-review,S-waiting-on-review,S-waiting-on-review,S-waiting-on-review,S-waiting-on-bors,S-waiting-on-review,S-waiting-on-review,S-waiting-on-review,S-waiting-on-review,S-waiting-on-review,S-waiting-on-bors,S-waiting-on-review,S-waiting-on-review",52791,2018-07-27T21:47:59Z,0,0,0
"A-NLL;NLL-complete;T-compiler;WG-compiler-nll,A-NLL;NLL-complete;T-compiler;WG-compiler-nll",52793,2018-07-27T22:10:22Z,60,0,60
"S-waiting-on-review;T-rustdoc;disposition-merge;proposed-final-comment-period,T-rustdoc;regression-from-stable-to-nightly,T-rustdoc;regression-from-stable-to-nightly,S-waiting-on-review;T-rustdoc;disposition-merge;proposed-final-comment-period",52796,2018-07-27T23:19:46Z,5,1,6
NULL,52800,2018-07-28T04:26:10Z,899,672,1571
"S-waiting-on-review,S-waiting-on-bors,S-waiting-on-review,S-waiting-on-review,S-waiting-on-review,S-waiting-on-review,S-waiting-on-review,S-waiting-on-bors,S-waiting-on-review,S-waiting-on-review,S-waiting-on-review,S-waiting-on-review",52802,2018-07-28T08:25:09Z,185,113,298
NULL,52809,2018-07-28T17:23:57Z,27,0,27
"S-waiting-on-review,S-waiting-on-review",52813,2018-07-28T23:01:20Z,120,1,121
"S-waiting-on-review,S-waiting-on-review",52822,2018-07-29T08:38:03Z,5,3,8
"S-waiting-on-review,S-waiting-on-review",52825,2018-07-29T11:43:22Z,42,0,42
S-waiting-on-review,52826,2018-07-29T12:11:12Z,0,0,0
"NLL-complete;T-compiler;WG-compiler-nll,NLL-complete;T-compiler;WG-compiler-nll",52830,2018-07-29T17:17:40Z,16,15,31
"NLL-complete;T-compiler;WG-compiler-nll,NLL-complete;T-compiler;WG-compiler-nll",52834,2018-07-29T21:41:45Z,30,0,30
NULL,52835,2018-07-29T22:09:14Z,56,23,79
NULL,52838,2018-07-29T23:39:45Z,0,0,0
NULL,52841,2018-07-30T00:52:26Z,675,135,810
"S-waiting-on-review,S-waiting-on-review",52842,2018-07-30T01:15:13Z,1,1,2
"S-waiting-on-review,S-waiting-on-review,S-waiting-on-review,S-waiting-on-review,S-waiting-on-review,S-waiting-on-review,S-waiting-on-bors,S-waiting-on-review,S-waiting-on-review,S-waiting-on-review,S-waiting-on-review,S-waiting-on-review,S-waiting-on-review,S-waiting-on-review,S-waiting-on-bors,S-waiting-on-review",52844,2018-07-30T01:32:56Z,0,0,0
"S-waiting-on-review,S-waiting-on-review",52850,2018-07-30T10:07:55Z,12,4,16
"S-waiting-on-review,A-attributes;C-tracking-issue;T-dev-tools,S-waiting-on-review,A-attributes;C-tracking-issue;T-dev-tools",52851,2018-07-30T10:08:03Z,172,29,201
"S-waiting-on-review,S-waiting-on-review",52854,2018-07-30T12:02:25Z,16,10,26
"S-waiting-on-bors,S-waiting-on-review,S-waiting-on-review,S-waiting-on-bors,S-waiting-on-bors,S-waiting-on-review,S-waiting-on-review,S-waiting-on-review,S-waiting-on-review",52857,2018-07-30T13:01:15Z,0,0,0
"S-waiting-on-review,S-waiting-on-review",52859,2018-07-30T13:17:22Z,128,4,132
NULL,52872,2018-07-30T18:51:10Z,118,99,217
"NLL-complete;T-compiler;WG-compiler-nll,S-waiting-on-review,NLL-complete;T-compiler;WG-compiler-nll,S-waiting-on-review",52878,2018-07-30T21:21:03Z,1,1,2
"S-waiting-on-review,S-waiting-on-review,S-waiting-on-bors,S-waiting-on-review;T-libs;relnotes,S-waiting-on-review,S-waiting-on-review,S-waiting-on-review,S-waiting-on-review,S-waiting-on-review,S-waiting-on-review,S-waiting-on-review,S-waiting-on-review,S-waiting-on-review,S-waiting-on-review,S-waiting-on-bors,S-waiting-on-review,S-waiting-on-review,S-waiting-on-review,S-waiting-on-review,S-waiting-on-review,S-waiting-on-review,S-waiting-on-review,S-waiting-on-bors,S-waiting-on-review",52882,2018-07-30T22:40:28Z,0,0,0
"A-NLL;A-diagnostics;E-easy;NLL-diagnostics;WG-compiler-nll,A-NLL;A-diagnostics;E-easy;NLL-diagnostics;WG-compiler-nll",52883,2018-07-30T22:42:15Z,53,21,74
"S-waiting-on-review,S-waiting-on-review",52888,2018-07-31T01:19:20Z,70,39,109
NULL,52890,2018-07-31T02:27:12Z,100,5,105
NULL,52895,2018-07-31T07:04:07Z,7,0,7
NULL,52904,2018-07-31T12:54:29Z,353,351,704
NULL,52906,2018-07-31T15:02:59Z,4,5,9
A-NLL;NLL-diagnostics;WG-compiler-nll,52907,2018-07-31T15:30:59Z,86,44,130
NULL,52908,2018-07-31T15:43:46Z,38,6,44
S-waiting-on-review,52910,2018-07-31T16:20:13Z,0,0,0
A-testsuite,52914,2018-07-31T19:49:05Z,1,0,1
NULL,52915,2018-07-31T20:05:57Z,39,5,44
"S-waiting-on-review,S-waiting-on-review,S-waiting-on-review,S-waiting-on-review,S-waiting-on-bors,S-waiting-on-review,S-waiting-on-review,S-waiting-on-review,S-waiting-on-review,S-waiting-on-review,S-waiting-on-review,S-waiting-on-review,S-waiting-on-review,S-waiting-on-review,S-waiting-on-review,S-waiting-on-bors,S-waiting-on-review,S-waiting-on-bors,S-waiting-on-review",52916,2018-07-31T20:48:42Z,0,0,0
B-RFC-approved;C-tracking-issue;T-lang,52923,2018-07-31T22:18:08Z,1295,271,1566
NULL,52925,2018-07-31T22:27:46Z,9,3,12
"A-edition-2018-lints,A-edition-2018-lints",52926,2018-07-31T22:50:09Z,17,12,29
A-rust-2018-preview,52930,2018-08-01T01:34:05Z,32,0,32
"S-waiting-on-review,S-waiting-on-review,S-waiting-on-review,S-waiting-on-bors,S-waiting-on-review,S-waiting-on-review,S-waiting-on-bors,S-waiting-on-review,S-waiting-on-review,S-waiting-on-review,S-waiting-on-review,S-waiting-on-review,S-waiting-on-review,S-waiting-on-bors,S-waiting-on-review,S-waiting-on-review,S-waiting-on-review,S-waiting-on-review,S-waiting-on-review,S-waiting-on-review,S-waiting-on-review,S-waiting-on-review,S-waiting-on-review,S-waiting-on-review,S-waiting-on-review,S-waiting-on-review",52931,2018-08-01T01:41:16Z,0,0,0
S-waiting-on-review,52932,2018-08-01T03:30:46Z,0,0,0
NULL,52936,2018-08-01T07:46:54Z,28,0,28
"S-waiting-on-review,S-waiting-on-review,S-waiting-on-review,S-waiting-on-review,S-waiting-on-bors,S-waiting-on-review,S-waiting-on-review,S-waiting-on-review,S-waiting-on-review,S-waiting-on-review,S-waiting-on-review,S-waiting-on-review,S-waiting-on-review,S-waiting-on-review,S-waiting-on-review,S-waiting-on-review,S-waiting-on-review,S-waiting-on-review,S-waiting-on-review,S-waiting-on-bors,S-waiting-on-review,S-waiting-on-bors,S-waiting-on-review,S-waiting-on-review",52937,2018-08-01T08:13:11Z,2101,1725,3826
NULL,52939,2018-08-01T09:08:03Z,16,3,19
S-waiting-on-review,52942,2018-08-01T11:03:26Z,5,12,17
"S-waiting-on-review,S-waiting-on-review,S-waiting-on-review,S-waiting-on-review,S-waiting-on-review",52944,2018-08-01T13:03:33Z,0,0,0
NULL,52946,2018-08-01T15:04:35Z,3,0,3
NULL,52948,2018-08-01T15:42:27Z,92,13,105
NULL,52952,2018-08-01T16:44:34Z,0,0,0
"C-cleanup,C-cleanup",52953,2018-08-01T16:46:13Z,879,858,1737
NULL,52954,2018-08-01T16:50:55Z,24,0,24
"S-waiting-on-review,S-waiting-on-review,S-waiting-on-review,S-waiting-on-author,S-waiting-on-review,S-waiting-on-review,S-waiting-on-review,S-waiting-on-review,S-waiting-on-bors,S-waiting-on-review",52958,2018-08-01T19:46:41Z,512,211,723
NULL,52959,2018-08-01T20:57:36Z,1253,330,1583
"S-waiting-on-review,S-waiting-on-review",52968,2018-08-02T04:12:24Z,57,19,76
NULL,52972,2018-08-02T09:40:17Z,28,3,31
NULL,52973,2018-08-02T10:04:32Z,103,5,108
A-NLL;T-compiler,52975,2018-08-02T11:56:27Z,43,3,46
"A-attributes;C-tracking-issue;T-dev-tools,A-attributes;C-tracking-issue;T-dev-tools",52982,2018-08-02T14:42:57Z,0,0,0
NULL,52983,2018-08-02T15:00:50Z,4,4,8
"A-traits;T-compiler;WG-compiler-traits,A-traits;T-compiler;WG-compiler-traits",52984,2018-08-02T15:29:36Z,65,49,114
"S-waiting-on-review,S-waiting-on-bors,S-waiting-on-review",52986,2018-08-02T15:54:40Z,19,8,27
NULL,52987,2018-08-02T16:35:11Z,0,0,0
"S-waiting-on-bors,S-waiting-on-bors,S-waiting-on-review,S-waiting-on-review,S-waiting-on-review,S-waiting-on-review,S-waiting-on-bors,S-waiting-on-review,S-waiting-on-review,S-waiting-on-bors,S-waiting-on-bors",52988,2018-08-02T18:26:05Z,0,0,0
"S-waiting-on-review,S-waiting-on-review,S-waiting-on-bors,S-waiting-on-review,S-waiting-on-review,S-waiting-on-bors,S-waiting-on-bors,S-waiting-on-bors,S-waiting-on-review,S-waiting-on-review",52989,2018-08-02T18:36:00Z,0,0,0
NULL,52990,2018-08-02T18:44:22Z,136,5,141
"NLL-performant;T-compiler;WG-compiler-nll,NLL-performant;T-compiler;WG-compiler-nll",52991,2018-08-02T19:02:43Z,331,65,396
NULL,52993,2018-08-02T19:44:21Z,345,152,497
"S-waiting-on-review,S-waiting-on-review",52994,2018-08-02T19:46:12Z,195,43,238
NULL,53001,2018-08-02T21:44:31Z,1,1,2
NULL,53002,2018-08-02T21:47:49Z,108,24,132
"T-rustdoc,T-rustdoc",53003,2018-08-02T22:02:14Z,2,2,4
"B-RFC-approved;T-lang,A-edition-2018-lints,B-RFC-approved;T-lang,A-edition-2018-lints;E-help-wanted;E-mentor;E-needs-mentor;T-compiler;T-dev-tools;WG-epoch,A-edition-2018-lints,B-RFC-approved;T-lang,A-edition-2018-lints,B-RFC-approved;T-lang,A-edition-2018-lints;E-help-wanted;E-mentor;E-needs-mentor;T-compiler;T-dev-tools;WG-epoch,A-edition-2018-lints",53013,2018-08-03T05:42:18Z,1095,1,1096
"B-RFC-approved;T-lang,S-waiting-on-review,A-lifetimes,S-waiting-on-review,A-lifetimes",53016,2018-08-03T07:16:36Z,88,32,120
"S-waiting-on-review,S-waiting-on-review,S-waiting-on-review,S-waiting-on-review",53019,2018-08-03T08:34:04Z,18,7,25
S-waiting-on-review,53021,2018-08-03T09:08:39Z,0,0,0
"S-waiting-on-review,S-waiting-on-review",53022,2018-08-03T10:16:40Z,30,0,30
"S-waiting-on-review,I-compiletime;T-compiler,A-compiler;I-slow,S-waiting-on-review,A-compiler;I-slow,I-compiletime;T-compiler",53025,2018-08-03T11:33:29Z,12,12,24
"S-waiting-on-review;relnotes,S-waiting-on-review;relnotes",53033,2018-08-03T16:09:33Z,11,3,14
NULL,53041,2018-08-03T21:30:45Z,2,2,4
"S-waiting-on-review,S-waiting-on-review",53043,2018-08-03T22:04:06Z,13,0,13
NULL,53044,2018-08-03T22:13:52Z,42,252,294
"A-NLL;I-unsound%20%F0%9F%92%A5;NLL-sound;P-high;WG-compiler-nll,A-NLL;I-unsound%20%F0%9F%92%A5;NLL-sound;P-high;WG-compiler-nll",53045,2018-08-03T22:17:16Z,48,6,54
"S-waiting-on-review,S-waiting-on-review,S-waiting-on-bors,S-waiting-on-review,S-waiting-on-bors,S-waiting-on-review,S-waiting-on-review,S-waiting-on-review,S-waiting-on-review,S-waiting-on-bors,S-waiting-on-review,S-waiting-on-review,S-waiting-on-review,S-waiting-on-review,S-waiting-on-review,S-waiting-on-bors,S-waiting-on-review,S-waiting-on-review,S-waiting-on-review,S-waiting-on-bors,S-waiting-on-review,S-waiting-on-bors,S-waiting-on-review,S-waiting-on-review,S-waiting-on-review,S-waiting-on-review",53049,2018-08-03T23:13:12Z,0,0,0
NULL,53051,2018-08-04T01:22:28Z,122,16,138
"A-docs;A-rustdoc,A-docs;A-rustdoc",53052,2018-08-04T01:54:28Z,0,33,33
"S-waiting-on-review,S-waiting-on-review,S-waiting-on-review,S-waiting-on-bors,S-waiting-on-review,S-waiting-on-review,S-waiting-on-review,S-waiting-on-review,S-waiting-on-review,S-waiting-on-bors,S-waiting-on-review,S-waiting-on-bors,S-waiting-on-review,S-waiting-on-review",53056,2018-08-04T06:36:03Z,261,107,368
"A-codegen;I-slow,A-codegen;I-slow,A-codegen;I-slow,A-codegen;I-slow",53080,2018-08-05T03:37:35Z,37,2,39
"S-waiting-on-bors,S-waiting-on-bors",53082,2018-08-05T05:54:15Z,63,63,126
NULL,53086,2018-08-05T11:05:09Z,0,0,0
"A-macros;C-bug,A-macros;C-bug",53093,2018-08-05T16:04:05Z,28,0,28
"T-rustdoc,T-rustdoc",53094,2018-08-05T16:23:26Z,19,0,19
"A-lint;E-easy;E-mentor,A-lint;E-easy;E-mentor",53100,2018-08-06T01:29:07Z,17,13,30
"B-RFC-approved;C-tracking-issue;T-libs,B-RFC-approved;C-tracking-issue;T-libs",53104,2018-08-06T08:18:52Z,24,4,28
"S-waiting-on-review,S-waiting-on-review",53109,2018-08-06T11:18:20Z,108,331,439
NULL,53110,2018-08-06T12:13:41Z,3,5,8
"A-diagnostics;NLL-diagnostics,A-NLL;NLL-diagnostics;T-compiler;WG-compiler-nll",53115,2018-08-06T16:34:18Z,205,187,392
"A-NLL;NLL-diagnostics;T-compiler;WG-compiler-nll,A-NLL;NLL-diagnostics;T-compiler;WG-compiler-nll",53124,2018-08-06T19:15:56Z,95,58,153
"A-NLL,A-NLL",53129,2018-08-06T20:42:52Z,8,8,16
NULL,53131,2018-08-06T20:55:03Z,104,51,155
NULL,53133,2018-08-06T21:24:09Z,42,1,43
NULL,53135,2018-08-06T21:48:23Z,1,1,2
"S-waiting-on-bors,S-waiting-on-bors",53139,2018-08-07T01:38:57Z,1,0,1
"S-waiting-on-review,S-waiting-on-review",53141,2018-08-07T03:48:40Z,75,146,221
S-waiting-on-review,53145,2018-08-07T07:18:50Z,0,0,0
"A-borrow-checker;A-diagnostics,A-borrow-checker;A-diagnostics",53147,2018-08-07T08:20:11Z,3104,279,3383
"S-waiting-on-review,S-waiting-on-review,S-waiting-on-review,S-waiting-on-review,S-waiting-on-review,S-waiting-on-review,S-waiting-on-review,S-waiting-on-review",53150,2018-08-07T08:55:45Z,141,212,353
"S-waiting-on-review,S-waiting-on-review",53162,2018-08-07T15:25:45Z,643,221,864
NULL,53163,2018-08-07T16:38:18Z,23,5,28
NULL,53164,2018-08-07T16:48:28Z,153,63,216
"S-waiting-on-review,S-waiting-on-review",53165,2018-08-07T17:07:21Z,39,0,39
"NLL-performant;T-compiler;WG-compiler-nll,NLL-performant;T-compiler;WG-compiler-nll,NLL-performant;T-compiler;WG-compiler-nll,NLL-performant;T-compiler;WG-compiler-nll",53168,2018-08-07T18:54:16Z,0,0,0
"S-waiting-on-review,S-waiting-on-review",53175,2018-08-07T21:25:12Z,235,176,411
"S-waiting-on-review,S-waiting-on-review,A-NLL;NLL-performant;T-compiler;WG-compiler-nll,A-NLL;NLL-performant;T-compiler;WG-compiler-nll",53177,2018-08-07T22:04:44Z,388,202,590
"S-waiting-on-review,S-waiting-on-review",53183,2018-08-08T05:34:00Z,73,19,92
"S-waiting-on-review,S-waiting-on-review,S-waiting-on-review,S-waiting-on-bors,S-waiting-on-review,S-waiting-on-review,S-waiting-on-review,S-waiting-on-review,S-waiting-on-review,S-waiting-on-review,S-waiting-on-review,S-waiting-on-bors,S-waiting-on-review,S-waiting-on-review,S-waiting-on-review",53184,2018-08-08T06:06:25Z,0,0,0
NLL-complete;T-compiler;WG-compiler-nll,53186,2018-08-08T07:06:37Z,78,14,92
S-waiting-on-review,53192,2018-08-08T11:21:47Z,1,1,2
"S-waiting-on-review,S-waiting-on-review,S-waiting-on-bors,S-waiting-on-review,S-waiting-on-review,S-waiting-on-review,S-waiting-on-review,S-waiting-on-review,S-waiting-on-review,S-waiting-on-bors,S-waiting-on-review,S-waiting-on-review,S-waiting-on-review,S-waiting-on-review,S-waiting-on-review",53194,2018-08-08T14:01:44Z,0,0,0
"S-waiting-on-review,S-waiting-on-review,S-waiting-on-review,S-waiting-on-review,S-waiting-on-review,S-waiting-on-bors,S-waiting-on-review,S-waiting-on-review,S-waiting-on-review,S-waiting-on-review,S-waiting-on-review,S-waiting-on-review,S-waiting-on-review,S-waiting-on-bors,S-waiting-on-review",53195,2018-08-08T14:01:44Z,0,0,0
"A-diagnostics;E-mentor;WG-compiler-errors,A-diagnostics;E-mentor;WG-compiler-errors",53196,2018-08-08T14:47:50Z,61965,2493,64458
"S-waiting-on-review,S-waiting-on-review,S-waiting-on-review,S-waiting-on-review,S-waiting-on-review,S-waiting-on-bors,S-waiting-on-review,S-waiting-on-review,S-waiting-on-review,S-waiting-on-review,S-waiting-on-review,S-waiting-on-review,S-waiting-on-review,S-waiting-on-review",53197,2018-08-08T15:41:18Z,0,0,0
"S-waiting-on-bors,S-waiting-on-review,S-waiting-on-review,S-waiting-on-review,NLL-complete;T-compiler;WG-compiler-nll,S-waiting-on-review,S-waiting-on-review,S-waiting-on-review,S-waiting-on-review,S-waiting-on-review,S-waiting-on-review,S-waiting-on-review,S-waiting-on-review,S-waiting-on-review",53206,2018-08-08T21:37:02Z,0,0,0
"C-bug;O-linux;T-libs,C-bug;O-linux;T-libs",53208,2018-08-08T23:09:02Z,30,5,35
"A-build,A-build",53210,2018-08-09T04:43:15Z,1,1,2
A-NLL;I-nominated;NLL-complete;T-compiler;WG-compiler-nll,53211,2018-08-09T05:57:23Z,8,0,8
"NLL-complete;T-compiler;WG-compiler-nll,NLL-complete;T-compiler;WG-compiler-nll",53212,2018-08-09T07:01:26Z,49,1,50
NULL,53213,2018-08-09T07:54:30Z,5,20,25
A-NLL;I-nominated;NLL-complete;T-compiler;WG-compiler-nll,53214,2018-08-09T08:16:35Z,10,0,10
"S-waiting-on-review,S-waiting-on-review,S-waiting-on-review,S-waiting-on-review,S-waiting-on-review,S-waiting-on-review,S-waiting-on-review,S-waiting-on-bors,S-waiting-on-review,S-waiting-on-review,S-waiting-on-review,S-waiting-on-review,S-waiting-on-review,S-waiting-on-review,S-waiting-on-review",53216,2018-08-09T08:58:51Z,791,409,1200
A-NLL;I-nominated;NLL-complete;T-compiler;WG-compiler-nll,53219,2018-08-09T11:08:43Z,13,0,13
"A-NLL;T-compiler;WG-compiler-nll,A-NLL;T-compiler;WG-compiler-nll",53225,2018-08-09T16:04:38Z,1757,79,1836
"S-waiting-on-review,S-waiting-on-review",53226,2018-08-09T16:57:22Z,28,5,33
"B-RFC-approved;C-tracking-issue;T-libs,S-waiting-on-review,B-RFC-approved;C-tracking-issue;T-libs,S-waiting-on-review",53227,2018-08-09T18:24:12Z,496,365,861
NULL,53229,2018-08-09T18:44:54Z,12,8,20
"A-NLL;I-nominated;NLL-complete;T-compiler;WG-compiler-nll,A-NLL;I-nominated;NLL-complete;T-compiler;WG-compiler-nll",53230,2018-08-09T19:36:01Z,25,4,29
NULL,53231,2018-08-09T19:36:23Z,31,1,32
NULL,53234,2018-08-09T20:15:41Z,0,10,10
NULL,53235,2018-08-09T20:44:58Z,26,8,34
"B-RFC-approved;C-tracking-issue;T-lang,B-RFC-approved;C-tracking-issue;T-lang",53236,2018-08-09T20:59:08Z,42,109,151
"S-waiting-on-review,S-waiting-on-review",53239,2018-08-09T23:45:06Z,24,2,26
S-waiting-on-review,53245,2018-08-10T10:31:26Z,144,23,167
"A-NLL;A-mir;NLL-performant;T-compiler;WG-compiler-nll,A-NLL;A-mir;NLL-performant;T-compiler;WG-compiler-nll",53247,2018-08-10T13:12:06Z,0,0,0
"S-waiting-on-review,S-waiting-on-review,S-waiting-on-review,S-waiting-on-review,S-waiting-on-review,S-waiting-on-review,S-waiting-on-review,S-waiting-on-review,S-waiting-on-review,S-waiting-on-bors,S-waiting-on-review,S-waiting-on-review,S-waiting-on-review,S-waiting-on-bors,S-waiting-on-review,S-waiting-on-review,S-waiting-on-review,S-waiting-on-review,S-waiting-on-review,S-waiting-on-bors,S-waiting-on-review,S-waiting-on-review,S-waiting-on-review,S-waiting-on-review,S-waiting-on-review,S-waiting-on-review,S-waiting-on-review,S-waiting-on-review,S-waiting-on-review,S-waiting-on-review,S-waiting-on-review,S-waiting-on-review,S-waiting-on-review,S-waiting-on-review,S-waiting-on-review,S-waiting-on-review",53252,2018-08-10T16:31:11Z,0,0,0
NULL,53255,2018-08-10T17:52:43Z,183,49,232
NULL,53256,2018-08-10T18:41:48Z,56,5,61
"A-NLL;NLL-performant;NLL-sound;T-compiler;WG-compiler-nll,A-NLL;NLL-performant;NLL-sound;T-compiler;WG-compiler-nll",53258,2018-08-10T22:08:25Z,425,90,515
NULL,53267,2018-08-11T13:44:32Z,4,4,8
"A-macros;T-compiler;regression-from-stable-to-nightly,A-macros;T-compiler;regression-from-stable-to-nightly,S-waiting-on-review",53270,2018-08-11T14:40:01Z,262,116,378
"S-waiting-on-review,B-RFC-approved;T-lang,B-RFC-approved;T-lang",53272,2018-08-11T16:18:04Z,23,18,41
NULL,53283,2018-08-12T05:57:36Z,106,2,108
NULL,53288,2018-08-12T16:59:45Z,82,5,87
NULL,53290,2018-08-12T18:03:03Z,9,2,11
"S-waiting-on-review,S-waiting-on-review",53293,2018-08-12T18:46:39Z,128,55,183
NULL,53296,2018-08-12T19:28:44Z,90,34,124
"S-waiting-on-review,S-waiting-on-review,S-waiting-on-review,S-waiting-on-review,S-waiting-on-review,S-waiting-on-review,S-waiting-on-review,S-waiting-on-review,S-waiting-on-review,S-waiting-on-review,S-waiting-on-bors,S-waiting-on-bors,S-waiting-on-review,S-waiting-on-review,S-waiting-on-review,S-waiting-on-bors",53297,2018-08-12T21:27:06Z,465,405,870
NULL,53299,2018-08-13T01:00:27Z,20,0,20
NULL,53305,2018-08-13T05:28:22Z,0,0,0
"I-nominated;NLL-performant;T-compiler;WG-compiler-nll,I-nominated;NLL-performant;T-compiler;WG-compiler-nll",53306,2018-08-13T07:46:27Z,0,0,0
"S-waiting-on-review,S-waiting-on-review",53307,2018-08-13T13:06:00Z,0,0,0
"S-waiting-on-review,S-waiting-on-review,S-waiting-on-review,S-waiting-on-review,S-waiting-on-review,S-waiting-on-review,S-waiting-on-review,S-waiting-on-review,S-waiting-on-review,S-waiting-on-review,S-waiting-on-review,S-waiting-on-review,S-waiting-on-review,S-waiting-on-review,S-waiting-on-review,S-waiting-on-review,S-waiting-on-review,S-waiting-on-review,S-waiting-on-review,S-waiting-on-review,S-waiting-on-review,S-waiting-on-review,S-waiting-on-review,S-waiting-on-review,S-waiting-on-review,S-waiting-on-review",53309,2018-08-13T16:30:25Z,0,0,0
NULL,53311,2018-08-13T19:16:15Z,2,0,2
"WG-compiler-nll,WG-compiler-nll",53314,2018-08-13T21:31:53Z,1001,608,1609
"C-cleanup;T-compiler,C-cleanup;T-compiler",53315,2018-08-13T21:35:13Z,299,200,499
NULL,53316,2018-08-13T22:10:30Z,70,9,79
NULL,53317,2018-08-13T22:29:44Z,46,0,46
NULL,53323,2018-08-14T01:48:19Z,0,0,0
B-RFC-approved;C-tracking-issue;T-lang,53324,2018-08-14T01:53:25Z,153,37,190
"E-mentor;T-compiler;WG-compiler-nll,E-mentor;T-compiler;WG-compiler-nll",53326,2018-08-14T02:52:15Z,58,0,58
I-ICE,53335,2018-08-14T08:42:12Z,20,2,22
NULL,53349,2018-08-14T14:32:39Z,76,0,76
"S-waiting-on-bors,S-waiting-on-review,S-waiting-on-review,S-waiting-on-review,S-waiting-on-review,S-waiting-on-review,S-waiting-on-bors,S-waiting-on-review,S-waiting-on-review,S-waiting-on-review,S-waiting-on-review,S-waiting-on-review,S-waiting-on-review",53354,2018-08-14T15:59:19Z,486,229,715
"S-waiting-on-review,S-waiting-on-review",53356,2018-08-14T16:08:59Z,331,172,503
"S-waiting-on-review,S-waiting-on-review",53357,2018-08-14T16:41:12Z,62,1,63
"S-waiting-on-review,C-tracking-issue;T-libs,S-waiting-on-review,C-tracking-issue;T-libs",53358,2018-08-14T16:49:28Z,90,18,108
NULL,53360,2018-08-14T18:25:21Z,32,1,33
S-waiting-on-review,53364,2018-08-14T20:31:17Z,152,47,199
"S-waiting-on-review,A-NLL,S-waiting-on-review,A-NLL",53369,2018-08-14T23:18:00Z,626,130,756
NULL,53370,2018-08-14T23:32:47Z,22,82,104
NULL,53371,2018-08-14T23:49:14Z,54,4,58
NULL,53376,2018-08-15T03:32:03Z,11,0,11
NULL,53384,2018-08-15T11:04:22Z,156,434,590
NULL,53385,2018-08-15T11:13:30Z,1,9,10
NULL,53386,2018-08-15T11:36:10Z,0,0,0
C-bug;T-rustdoc,53388,2018-08-15T13:07:51Z,15,9,24
NULL,53389,2018-08-15T13:23:44Z,6,0,6
NULL,53397,2018-08-15T16:37:08Z,39,55,94
"S-waiting-on-bors,S-waiting-on-review,S-waiting-on-review,S-waiting-on-review,S-waiting-on-bors,S-waiting-on-review,S-waiting-on-review",53400,2018-08-15T17:20:30Z,205,57,262
"A-NLL;NLL-performant;T-compiler;WG-compiler-nll,A-NLL;NLL-performant;T-compiler;WG-compiler-nll",53403,2018-08-15T18:46:01Z,172,234,406
NULL,53404,2018-08-15T18:54:46Z,10,0,10
NULL,53406,2018-08-15T19:31:47Z,46,2,48
"S-waiting-on-review,S-waiting-on-review",53407,2018-08-15T21:42:22Z,236,23,259
NULL,53409,2018-08-15T22:47:13Z,31,73,104
NULL,53412,2018-08-15T23:14:08Z,24,48,72
NULL,53422,2018-08-16T07:43:27Z,0,0,0
"S-waiting-on-review,S-waiting-on-review",53425,2018-08-16T12:22:58Z,25,18,43
"I-nominated;NLL-complete;T-compiler;WG-compiler-nll,I-nominated;NLL-complete;T-compiler;WG-compiler-nll,I-nominated;NLL-complete;T-compiler;WG-compiler-nll,I-nominated;NLL-complete;T-compiler;WG-compiler-nll,I-nominated;NLL-complete;T-compiler;WG-compiler-nll,I-nominated;NLL-complete;T-compiler;WG-compiler-nll,I-nominated;NLL-complete;T-compiler;WG-compiler-nll,I-nominated;NLL-complete;T-compiler;WG-compiler-nll",53426,2018-08-16T12:34:06Z,0,0,0
NULL,53427,2018-08-16T13:20:41Z,195,56,251
"S-waiting-on-review,S-waiting-on-review,S-waiting-on-review,S-waiting-on-review,S-waiting-on-review,S-waiting-on-review,S-waiting-on-review,S-waiting-on-review,S-waiting-on-review",53433,2018-08-16T16:13:30Z,297,245,542
"S-waiting-on-review,S-waiting-on-review",53434,2018-08-16T17:19:55Z,0,12,12
"C-bug;O-SystemZ;T-libs;regression-from-stable-to-stable,C-bug;O-SystemZ;T-libs;regression-from-stable-to-stable",53436,2018-08-16T18:48:10Z,30,24,54
"C-bug;O-SystemZ;T-libs;regression-from-stable-to-stable,C-bug;O-SystemZ;T-libs;regression-from-stable-to-stable",53437,2018-08-16T20:20:50Z,44,35,79
"NLL-complete;T-compiler;WG-compiler-nll,NLL-complete;T-compiler;WG-compiler-nll",53438,2018-08-16T20:29:15Z,1197,906,2103
NULL,53439,2018-08-16T22:01:11Z,106,90,196
NULL,53441,2018-08-17T00:15:37Z,94,23,117
NULL,53442,2018-08-17T03:07:35Z,12,2,14
"S-waiting-on-review,S-waiting-on-review",53444,2018-08-17T10:41:03Z,27,12,39
"S-waiting-on-review,S-waiting-on-review,S-waiting-on-review,S-waiting-on-review,S-waiting-on-review,S-waiting-on-review,S-waiting-on-bors,S-waiting-on-review,S-waiting-on-review,S-waiting-on-review",53449,2018-08-17T15:23:47Z,750,183,933
"S-waiting-on-review,A-attributes;C-tracking-issue;T-dev-tools,S-waiting-on-review,S-waiting-on-review,A-attributes;C-tracking-issue;T-dev-tools,S-waiting-on-review",53459,2018-08-17T23:02:08Z,27,131,158
NULL,53462,2018-08-18T03:24:30Z,3,1,4
NULL,53465,2018-08-18T10:09:27Z,25,53,78
NULL,53470,2018-08-18T11:56:48Z,1,1,2
S-waiting-on-review,53471,2018-08-18T12:28:25Z,423,388,811
NULL,53476,2018-08-18T21:25:04Z,22,1,23
"S-waiting-on-review,S-waiting-on-review,S-waiting-on-review,S-waiting-on-review,S-waiting-on-review,S-waiting-on-review,S-waiting-on-review,S-waiting-on-review,S-waiting-on-review,S-waiting-on-review",53483,2018-08-19T01:34:04Z,0,0,0
"S-waiting-on-review,S-waiting-on-review",53499,2018-08-19T16:11:52Z,0,0,0
NULL,53504,2018-08-19T19:09:11Z,217,125,342
NULL,53506,2018-08-19T21:07:46Z,15,2,17
NULL,53507,2018-08-19T21:17:48Z,5,0,5
"B-RFC-approved;C-tracking-issue;T-lang;T-libs,B-RFC-approved;C-tracking-issue;T-lang;T-libs,B-RFC-approved;C-tracking-issue;T-lang;T-libs,B-RFC-approved;C-tracking-issue;T-lang;T-libs",53508,2018-08-19T21:39:58Z,350,85,435
NULL,53509,2018-08-19T22:06:22Z,26,0,26
"S-waiting-on-review,S-waiting-on-review",53511,2018-08-19T23:20:39Z,0,0,0
"S-waiting-on-review,B-RFC-approved;T-libs",53514,2018-08-20T00:47:16Z,0,0,0
NULL,53516,2018-08-20T01:00:38Z,38,11,49
NULL,53517,2018-08-20T02:06:59Z,13,0,13
NULL,53518,2018-08-20T02:13:29Z,26,0,26
NULL,53522,2018-08-20T06:10:15Z,8,0,8
NULL,53523,2018-08-20T06:35:59Z,141,0,141
NULL,53526,2018-08-20T12:42:29Z,0,0,0
NULL,53527,2018-08-20T13:33:16Z,119,81,200
"S-waiting-on-review,S-waiting-on-review,S-waiting-on-review,S-waiting-on-review,S-waiting-on-review,S-waiting-on-review,S-waiting-on-review,S-waiting-on-review,S-waiting-on-review,S-waiting-on-review,S-waiting-on-review,S-waiting-on-review,S-waiting-on-review,S-waiting-on-review,S-waiting-on-review,S-waiting-on-review,S-waiting-on-review,S-waiting-on-review,S-waiting-on-review,S-waiting-on-review,S-waiting-on-review,S-waiting-on-review,S-waiting-on-review,S-waiting-on-review,S-waiting-on-review,S-waiting-on-review,S-waiting-on-bors,S-waiting-on-review,S-waiting-on-review,S-waiting-on-review,S-waiting-on-review",53530,2018-08-20T17:20:29Z,571,510,1081
"S-waiting-on-review,S-waiting-on-review",53533,2018-08-20T18:29:47Z,66,1,67
NULL,53535,2018-08-20T18:55:36Z,139,9,148
"S-waiting-on-review,S-waiting-on-review",53536,2018-08-20T19:14:13Z,10,3,13
B-unstable,53542,2018-08-20T22:51:51Z,746,370,1116
"A-diagnostics;C-bug,A-diagnostics;C-bug",53544,2018-08-20T23:17:12Z,9,8,17
NULL,53545,2018-08-20T23:29:08Z,72,7,79
NULL,53558,2018-08-21T11:00:32Z,10,3,13
NULL,53559,2018-08-21T11:02:22Z,40,6,46
"S-waiting-on-review,S-waiting-on-review",53562,2018-08-21T13:47:42Z,4,0,4
"S-waiting-on-review,S-waiting-on-review,S-waiting-on-review",53564,2018-08-21T14:33:38Z,47,5,52
"A-diagnostics;C-enhancement,A-diagnostics;C-enhancement",53565,2018-08-21T15:30:22Z,86,27,113
NULL,53571,2018-08-21T17:58:24Z,27,167,194
NULL,53575,2018-08-21T19:59:14Z,129,47,176
NULL,53577,2018-08-21T22:21:40Z,30,10,40
"S-waiting-on-review,S-waiting-on-review",53578,2018-08-21T22:26:40Z,0,0,0
"A-NLL;NLL-complete;T-compiler;WG-compiler-nll,A-NLL;NLL-complete;T-compiler;WG-compiler-nll",53580,2018-08-21T23:27:18Z,211,27,238
C-cleanup;E-easy,53584,2018-08-22T01:40:37Z,127,291,418
NULL,53587,2018-08-22T02:56:42Z,0,0,0
"B-RFC-approved;B-RFC-implemented;C-tracking-issue;T-lang,B-RFC-approved;B-RFC-implemented;C-tracking-issue;T-lang",53604,2018-08-22T14:02:22Z,1713,279,1992
"S-waiting-on-review,S-waiting-on-review,S-waiting-on-review,S-waiting-on-review,S-waiting-on-review,S-waiting-on-bors,S-waiting-on-review,S-waiting-on-review,S-waiting-on-review,S-waiting-on-review,S-waiting-on-bors",53607,2018-08-22T15:45:44Z,391,147,538
"E-easy,E-easy",53609,2018-08-22T17:24:03Z,331,73,404
"S-waiting-on-review,B-RFC-approved;T-lang,S-waiting-on-review,B-RFC-approved;T-lang",53612,2018-08-22T18:45:23Z,70,83,153
NULL,53617,2018-08-22T22:19:59Z,0,53,53
"B-RFC-approved;T-libs,B-RFC-approved;T-libs",53619,2018-08-22T22:44:04Z,164,79,243
"S-waiting-on-bors,S-waiting-on-review,S-waiting-on-review,S-waiting-on-review,S-waiting-on-bors,S-waiting-on-bors,S-waiting-on-review,S-waiting-on-review,S-waiting-on-bors,S-waiting-on-review,S-waiting-on-review,S-waiting-on-review,S-waiting-on-review,S-waiting-on-bors,S-waiting-on-bors,S-waiting-on-review,S-waiting-on-review,S-waiting-on-review",53620,2018-08-22T23:03:05Z,0,0,0
"O-ARM;O-windows,O-ARM;O-windows",53621,2018-08-22T23:17:06Z,115,2,117
"S-waiting-on-review,S-waiting-on-review",53624,2018-08-23T03:10:27Z,34,45,79
NULL,53626,2018-08-23T07:55:00Z,36,16,52
NULL,53640,2018-08-23T16:23:51Z,151,35,186
NULL,53641,2018-08-23T17:32:48Z,0,0,0
"S-waiting-on-review,S-waiting-on-review",53642,2018-08-23T18:05:39Z,49,18,67
NULL,53649,2018-08-23T20:51:25Z,0,0,0
"A-macros;I-ICE;regression-from-stable-to-nightly,T-compiler,A-macros;I-ICE;regression-from-stable-to-nightly,T-compiler",53653,2018-08-24T00:02:08Z,62,13,75
"S-waiting-on-bors,S-waiting-on-bors",53654,2018-08-24T01:51:10Z,0,0,0
NULL,53655,2018-08-24T01:52:56Z,60,27,87
"A-typesystem;C-cleanup;T-compiler,A-typesystem;C-cleanup;T-compiler",53661,2018-08-24T07:21:48Z,0,0,0
"S-waiting-on-review,S-waiting-on-review,S-waiting-on-review,S-waiting-on-review,S-waiting-on-bors,S-waiting-on-review,S-waiting-on-bors,S-waiting-on-bors,S-waiting-on-review,S-waiting-on-review,S-waiting-on-review,S-waiting-on-review,S-waiting-on-bors,S-waiting-on-review",53662,2018-08-24T08:44:53Z,382,305,687
NULL,53664,2018-08-24T10:22:50Z,1,4,5
NULL,53666,2018-08-24T11:15:01Z,1,1,2
"S-waiting-on-review,S-waiting-on-review",53671,2018-08-24T14:46:16Z,1595,1405,3000
"S-waiting-on-review,S-waiting-on-review",53673,2018-08-24T15:10:04Z,647,297,944
"A-typesystem;C-cleanup;T-compiler,S-waiting-on-review,A-typesystem;C-cleanup;T-compiler,S-waiting-on-review",53677,2018-08-24T17:38:51Z,0,0,0
NULL,53679,2018-08-24T18:17:39Z,139,42,181
NULL,53684,2018-08-24T21:01:49Z,128,1,129
NULL,53685,2018-08-24T21:31:21Z,125,45,170
NULL,53687,2018-08-24T22:36:58Z,0,0,0
NULL,53693,2018-08-25T07:59:53Z,540,17,557
"S-waiting-on-review,S-waiting-on-review,S-waiting-on-review,S-waiting-on-bors",53694,2018-08-25T09:11:26Z,149,11,160
NULL,53697,2018-08-25T10:43:30Z,1033,58,1091
"S-waiting-on-review;beta-nominated,S-waiting-on-review,S-waiting-on-review,S-waiting-on-review,S-waiting-on-review,S-waiting-on-review;beta-nominated",53700,2018-08-25T13:46:09Z,157,29,186
S-waiting-on-bors,53701,2018-08-25T16:25:52Z,35,137,172
"C-cleanup;E-easy,C-cleanup;E-easy",53705,2018-08-25T20:31:12Z,228,224,452
NULL,53706,2018-08-25T21:17:22Z,2,3,5
"A-typesystem;I-nominated;T-lang,A-typesystem;I-nominated;T-lang",53707,2018-08-25T21:30:23Z,60,8,68
NULL,53711,2018-08-25T22:57:19Z,195,31,226
"S-waiting-on-review,S-waiting-on-review,S-waiting-on-review,S-waiting-on-bors,S-waiting-on-review,S-waiting-on-review,S-waiting-on-review",53717,2018-08-26T10:05:29Z,77,20,97
NULL,53721,2018-08-26T13:39:41Z,156,58,214
NULL,53727,2018-08-26T23:54:45Z,36,17,53
NULL,53736,2018-08-27T13:30:46Z,0,0,0
NULL,53743,2018-08-27T19:03:31Z,27,27,54
"A-NLL;NLL-complete;T-compiler;WG-compiler-nll,A-NLL;NLL-complete;T-compiler;WG-compiler-nll",53745,2018-08-27T21:21:39Z,178,80,258
NULL,53747,2018-08-27T22:07:12Z,6,0,6
NULL,53748,2018-08-27T22:40:17Z,0,0,0
"B-RFC-approved;C-tracking-issue;T-lang,B-RFC-approved;C-tracking-issue;T-lang",53751,2018-08-28T04:55:30Z,469,149,618
"A-attributes;C-tracking-issue;T-dev-tools,A-attributes;C-tracking-issue;T-dev-tools",53762,2018-08-28T12:45:18Z,231,51,282
"S-waiting-on-review,S-waiting-on-review,S-waiting-on-bors,S-waiting-on-review,S-waiting-on-review,S-waiting-on-review,S-waiting-on-review,S-waiting-on-review,S-waiting-on-review,S-waiting-on-review,S-waiting-on-review,S-waiting-on-review,S-waiting-on-review,S-waiting-on-review,S-waiting-on-review,S-waiting-on-review,S-waiting-on-review,S-waiting-on-review,S-waiting-on-review,S-waiting-on-review,S-waiting-on-bors,S-waiting-on-review,S-waiting-on-review,S-waiting-on-review,S-waiting-on-review,S-waiting-on-review,S-waiting-on-review,S-waiting-on-review,S-waiting-on-review,S-waiting-on-review",53765,2018-08-28T17:10:40Z,0,0,0
"S-waiting-on-review,S-waiting-on-bors,S-waiting-on-review,S-waiting-on-review,S-waiting-on-review,S-waiting-on-review,S-waiting-on-review,S-waiting-on-review,S-waiting-on-review,S-waiting-on-review,S-waiting-on-review,S-waiting-on-review,S-waiting-on-bors,S-waiting-on-review,S-waiting-on-review,S-waiting-on-review,S-waiting-on-review,S-waiting-on-review,S-waiting-on-review",53775,2018-08-28T22:19:34Z,0,0,0
NULL,53777,2018-08-29T01:39:34Z,30,0,30
"S-waiting-on-review,S-waiting-on-review",53783,2018-08-29T12:45:45Z,701,549,1250
NULL,53784,2018-08-29T13:23:48Z,14,3,17
"A-lint,A-lint",53786,2018-08-29T13:26:17Z,52,52,104
NULL,53788,2018-08-29T14:03:15Z,0,0,0
NULL,53790,2018-08-29T16:14:52Z,25,0,25
"B-RFC-approved;T-lang,B-RFC-approved;T-lang",53793,2018-08-29T17:11:29Z,802,753,1555
"S-waiting-on-review,S-waiting-on-review,S-waiting-on-review,S-waiting-on-review,S-waiting-on-bors,S-waiting-on-review,S-waiting-on-review,S-waiting-on-review,S-waiting-on-review,S-waiting-on-review,S-waiting-on-review,S-waiting-on-review,S-waiting-on-bors,S-waiting-on-review,S-waiting-on-review,S-waiting-on-review,S-waiting-on-review,S-waiting-on-review,S-waiting-on-review,S-waiting-on-review,S-waiting-on-review",53798,2018-08-29T19:32:15Z,0,0,0
"S-waiting-on-review,S-waiting-on-review,S-waiting-on-review,S-waiting-on-review,S-waiting-on-review,S-waiting-on-review,S-waiting-on-review,S-waiting-on-review,S-waiting-on-review,S-waiting-on-review,S-waiting-on-review,S-waiting-on-review,S-waiting-on-bors,S-waiting-on-bors,S-waiting-on-review,S-waiting-on-review,S-waiting-on-review,S-waiting-on-review,S-waiting-on-review,S-waiting-on-review,S-waiting-on-review,S-waiting-on-review,S-waiting-on-review,S-waiting-on-review,S-waiting-on-review,S-waiting-on-review,S-waiting-on-review,S-waiting-on-review,S-waiting-on-review,S-waiting-on-review,S-waiting-on-review,S-waiting-on-bors,S-waiting-on-review,S-waiting-on-review,S-waiting-on-review,S-waiting-on-bors,S-waiting-on-review,S-waiting-on-review,S-waiting-on-review,S-waiting-on-review",53799,2018-08-29T20:14:32Z,0,0,0
"C-bug;T-rustdoc,C-bug;T-rustdoc",53801,2018-08-29T21:02:50Z,9,5,14
"S-waiting-on-bors;T-infra,S-waiting-on-bors;T-infra",53803,2018-08-29T21:07:35Z,68,7,75
"S-waiting-on-review,S-waiting-on-review",53804,2018-08-29T21:14:43Z,7,7,14
"T-rustdoc,T-rustdoc",53806,2018-08-29T22:36:24Z,11,0,11
"B-RFC-approved;C-tracking-issue;T-lang,B-RFC-approved;C-tracking-issue;T-lang",53815,2018-08-30T04:25:15Z,115,35,150
"B-RFC-approved;T-lang,B-RFC-approved;T-lang,B-RFC-approved;T-lang,B-RFC-approved;T-lang",53816,2018-08-30T05:28:53Z,557,545,1102
A-const-eval;A-incr-comp;WG-compiler-performance,53821,2018-08-30T11:45:00Z,1130,1229,2359
"S-waiting-on-bors,S-waiting-on-bors",53825,2018-08-30T14:55:03Z,12,6,18
S-waiting-on-review,53828,2018-08-30T16:50:23Z,7,5,12
"A-borrow-checker;A-diagnostics;NLL-diagnostics;WG-compiler-nll,A-borrow-checker;A-diagnostics;NLL-diagnostics;WG-compiler-nll",53830,2018-08-30T17:47:19Z,137,12,149
"S-waiting-on-review,S-waiting-on-review,S-waiting-on-review,S-waiting-on-review,S-waiting-on-review,S-waiting-on-review,S-waiting-on-review,S-waiting-on-review,S-waiting-on-review,S-waiting-on-review,S-waiting-on-review,S-waiting-on-review,S-waiting-on-review,S-waiting-on-bors,S-waiting-on-bors,S-waiting-on-review,S-waiting-on-review,S-waiting-on-bors,S-waiting-on-review,S-waiting-on-review,S-waiting-on-review,S-waiting-on-review,S-waiting-on-review,S-waiting-on-review,S-waiting-on-review,S-waiting-on-review,S-waiting-on-review,S-waiting-on-review,S-waiting-on-review,S-waiting-on-review,S-waiting-on-review,S-waiting-on-review,S-waiting-on-bors,S-waiting-on-review,S-waiting-on-review,S-waiting-on-review,S-waiting-on-bors,S-waiting-on-review,S-waiting-on-review,S-waiting-on-bors",53832,2018-08-30T18:15:50Z,568,344,912
NULL,53846,2018-08-31T07:43:39Z,0,0,0
"A-const-eval;C-cleanup;E-easy,A-const-eval;C-cleanup;E-easy",53850,2018-08-31T10:34:15Z,15,28,43
"B-RFC-approved;C-tracking-issue;T-lang,B-RFC-approved;C-tracking-issue;T-lang",53854,2018-08-31T14:14:47Z,261,0,261
"S-waiting-on-review,S-waiting-on-review",53855,2018-08-31T14:45:50Z,0,0,0
"A-NLL;I-nominated,A-NLL;I-nominated,A-NLL;I-nominated",53860,2018-08-31T15:35:59Z,92797,88972,181769
S-waiting-on-review,53863,2018-08-31T16:36:11Z,0,0,0
NULL,53865,2018-08-31T19:00:23Z,150,2104,2254
NULL,53867,2018-08-31T19:48:02Z,4,4,8
"A-libs;A-testsuite;I-wrong,E-easy;I-cleanup,A-libs;A-testsuite;I-wrong,E-easy;I-cleanup,A-pretty;E-easy;I-wrong,A-linkage;A-mac-osx,A-libs;A-testsuite;I-wrong,A-libs;A-testsuite;I-wrong,E-easy;I-cleanup,A-pretty;E-easy;I-wrong,E-easy;I-cleanup,A-linkage;A-mac-osx",53870,2018-08-31T20:27:27Z,49,43,92
"NLL-sound;T-compiler,A-NLL;T-compiler;WG-compiler-nll,A-NLL;T-compiler;WG-compiler-nll",53873,2018-08-31T23:39:23Z,1873,1008,2881
"B-RFC-approved;C-tracking-issue;T-libs,B-RFC-approved;C-tracking-issue;T-libs",53874,2018-08-31T23:56:17Z,33,2,35
"B-RFC-approved;C-tracking-issue;T-libs,C-bug;T-compiler,B-RFC-approved;C-tracking-issue;T-libs,C-bug;T-compiler",53877,2018-09-01T04:56:23Z,371,459,830
"S-waiting-on-bors,S-waiting-on-bors",53880,2018-09-01T08:27:23Z,33,10,43
"S-waiting-on-review,S-waiting-on-review,S-waiting-on-review,S-waiting-on-review,S-waiting-on-review,S-waiting-on-review,S-waiting-on-review,S-waiting-on-review,S-waiting-on-review",53884,2018-09-01T13:14:19Z,282,241,523
"S-waiting-on-review,S-waiting-on-review",53887,2018-09-01T16:08:27Z,57,1,58
"S-waiting-on-review,S-waiting-on-review",53892,2018-09-01T23:00:43Z,0,0,0
NULL,53893,2018-09-02T00:01:47Z,180,54,234
S-waiting-on-review,53897,2018-09-02T06:20:35Z,10,20,30
"NLL-diagnostics,NLL-diagnostics",53900,2018-09-02T09:12:36Z,276,124,400
"A-macros-2.0,A-macros-2.0,A-macros-2.0,A-macros-2.0",53902,2018-09-02T14:08:03Z,191,113,304
"A-const-eval;E-easy;E-medium;WG-compiler-const,A-const-eval;E-easy;E-medium;WG-compiler-const",53903,2018-09-02T14:39:27Z,81,31,112
"A-macros-2.0,A-macros-2.0",53904,2018-09-02T14:43:01Z,0,0,0
"A-NLL;NLL-performant,A-NLL;NLL-performant",53909,2018-09-02T19:48:58Z,822,478,1300
"B-RFC-approved;C-tracking-issue;T-libs,B-RFC-approved;C-tracking-issue;T-libs",53910,2018-09-02T21:13:07Z,48,35,83
"S-waiting-on-crater,S-waiting-on-review,S-waiting-on-review",53913,2018-09-03T02:22:49Z,353,71,424
"A-macros-2.0,A-macros-2.0",53930,2018-09-03T19:00:43Z,0,0,0
NULL,53933,2018-09-03T22:06:54Z,58,7,65
"S-waiting-on-review,S-waiting-on-review",53936,2018-09-03T23:42:06Z,81,79,160
"S-waiting-on-bors,S-waiting-on-bors",53939,2018-09-04T07:02:05Z,1,1,2
NULL,53941,2018-09-04T08:31:39Z,50,4,54
NULL,53942,2018-09-04T09:26:15Z,79,41,120
S-waiting-on-review;beta-nominated,53944,2018-09-04T11:13:00Z,93,7,100
"A-NLL;NLL-complete;WG-compiler-nll,A-NLL;NLL-complete;WG-compiler-nll,A-NLL;NLL-complete;WG-compiler-nll,A-NLL;NLL-complete;WG-compiler-nll",53948,2018-09-04T14:25:53Z,692,0,692
"S-waiting-on-bors,S-waiting-on-bors",53952,2018-09-04T18:32:28Z,3,3,6
"S-waiting-on-review,S-waiting-on-review",53955,2018-09-04T20:13:56Z,4,2,6
"A-diagnostics,A-diagnostics",53960,2018-09-05T10:40:40Z,66,12,78
A-incr-comp;I-ICE;T-compiler,53962,2018-09-05T11:55:10Z,4,4,8
NULL,53969,2018-09-05T16:12:33Z,1,1,2
NULL,53973,2018-09-05T19:14:52Z,21,12,33
"S-waiting-on-review,S-waiting-on-review",53976,2018-09-05T22:06:53Z,34,30,64
"S-waiting-on-review,S-waiting-on-review,S-waiting-on-review,S-waiting-on-review",53978,2018-09-05T22:40:03Z,0,3,3
"S-waiting-on-review,S-waiting-on-review,S-waiting-on-review,S-waiting-on-review",53979,2018-09-05T22:42:38Z,0,3,3
B-RFC-approved;C-tracking-issue;T-lang,53982,2018-09-06T05:21:30Z,0,0,0
NULL,53987,2018-09-06T10:28:46Z,11,0,11
NULL,53988,2018-09-06T10:34:50Z,49,43,92
"S-waiting-on-review,S-waiting-on-review,S-waiting-on-review",53991,2018-09-06T11:19:04Z,59,4,63
"A-NLL;I-nominated,A-NLL;I-nominated",53992,2018-09-06T11:56:44Z,34,1,35
NULL,53993,2018-09-06T12:06:58Z,46,1,47
"A-NLL;I-nominated,A-NLL;I-nominated",53994,2018-09-06T12:58:25Z,291,0,291
"A-diagnostics;NLL-diagnostics,A-diagnostics;NLL-diagnostics",53995,2018-09-06T13:56:06Z,111,121,232
S-waiting-on-review,53996,2018-09-06T14:54:13Z,143,1,144
"A-codegen;I-ICE,A-codegen;I-ICE",53998,2018-09-06T15:48:09Z,63,12,75
NULL,54000,2018-09-06T18:04:41Z,89,21,110
"A-debuginfo,A-debuginfo,A-debuginfo;C-bug;T-compiler",54004,2018-09-06T18:50:15Z,1691,261,1952
NULL,54007,2018-09-06T19:27:53Z,65,9,74
"S-waiting-on-review,S-waiting-on-review,S-waiting-on-review",54011,2018-09-06T22:04:34Z,307,48,355
"S-waiting-on-review,S-waiting-on-review",54012,2018-09-06T22:11:00Z,0,0,0
T-rustdoc,54014,2018-09-06T22:13:55Z,0,0,0
"A-testsuite,A-testsuite,A-testsuite",54020,2018-09-07T05:47:15Z,0,0,0
"S-waiting-on-review,S-waiting-on-review,S-waiting-on-review,S-waiting-on-bors,S-waiting-on-review,S-waiting-on-review,S-waiting-on-review,S-waiting-on-review,S-waiting-on-review,S-waiting-on-bors,S-waiting-on-review,S-waiting-on-review,S-waiting-on-review,S-waiting-on-bors,S-waiting-on-review,S-waiting-on-review,S-waiting-on-review,S-waiting-on-review",54021,2018-09-07T05:47:28Z,102265,97239,199504
"S-waiting-on-review,S-waiting-on-review",54029,2018-09-07T10:49:11Z,0,0,0
"A-typesystem;T-compiler,S-waiting-on-review",54033,2018-09-07T15:42:56Z,0,0,0
B-RFC-approved,54034,2018-09-07T15:54:40Z,318,21,339
"S-waiting-on-review,S-waiting-on-review,S-waiting-on-review,S-waiting-on-review,S-waiting-on-review,S-waiting-on-bors,S-waiting-on-review,S-waiting-on-review,C-cleanup;E-easy,S-waiting-on-review,S-waiting-on-review,S-waiting-on-review,S-waiting-on-review,S-waiting-on-review,S-waiting-on-review,S-waiting-on-bors,S-waiting-on-review,S-waiting-on-review,C-cleanup;E-easy",54036,2018-09-07T17:28:08Z,0,0,0
"S-waiting-on-crater,S-waiting-on-crater",54037,2018-09-07T18:36:52Z,219,33,252
S-waiting-on-review,54043,2018-09-07T20:50:42Z,673,6,679
"S-waiting-on-review,S-waiting-on-review,S-waiting-on-review,S-waiting-on-review,S-waiting-on-review,S-waiting-on-review,S-waiting-on-review,S-waiting-on-bors,S-waiting-on-review,S-waiting-on-review",54051,2018-09-08T08:07:49Z,553,342,895
"S-waiting-on-review,S-waiting-on-review,S-waiting-on-review",54057,2018-09-08T12:59:24Z,34,31,65
"S-waiting-on-review,S-waiting-on-review,A-NLL;S-waiting-on-bors,S-waiting-on-review,S-waiting-on-bors,S-waiting-on-review,S-waiting-on-review,S-waiting-on-review,S-waiting-on-bors,S-waiting-on-review,S-waiting-on-review,S-waiting-on-review,S-waiting-on-review,S-waiting-on-review,S-waiting-on-review,A-NLL;S-waiting-on-bors,S-waiting-on-review,S-waiting-on-review,S-waiting-on-review,S-waiting-on-bors,S-waiting-on-bors,S-waiting-on-review,S-waiting-on-review,S-waiting-on-review",54068,2018-09-08T20:39:56Z,0,0,0
"S-waiting-on-review,A-macros;T-compiler;regression-from-stable-to-nightly,S-waiting-on-crater,S-waiting-on-review,S-waiting-on-crater,A-macros;T-compiler;regression-from-stable-to-nightly",54069,2018-09-08T21:51:31Z,64,35,99
"B-RFC-approved;C-tracking-issue;T-lang,B-RFC-approved;C-tracking-issue;T-lang",54072,2018-09-09T02:45:29Z,0,0,0
"S-waiting-on-review,S-waiting-on-review",54074,2018-09-09T04:36:22Z,2,12,14
"A-docs,A-docs",54078,2018-09-09T11:34:35Z,148,4,152
NULL,54080,2018-09-09T12:08:50Z,68,1,69
A-macros-1.2;A-macros-2.0,54086,2018-09-09T17:15:09Z,221,106,327
"C-bug;T-rustdoc,S-waiting-on-review,C-bug;T-rustdoc,S-waiting-on-review",54087,2018-09-09T17:37:48Z,49,14,63
"A-NLL;NLL-diagnostics,A-NLL;NLL-diagnostics",54088,2018-09-09T18:52:13Z,133,32,165
"S-waiting-on-review,S-waiting-on-review",54090,2018-09-09T20:23:19Z,0,0,0
"I-compiletime;P-high;T-compiler;regression-from-stable-to-nightly,S-waiting-on-review,S-waiting-on-review,I-compiletime;P-high;T-compiler;regression-from-stable-to-nightly",54092,2018-09-09T21:58:00Z,23,26,49
"S-waiting-on-review,S-waiting-on-review",54093,2018-09-10T00:57:24Z,48,12,60
C-cleanup;E-easy,54095,2018-09-10T02:35:58Z,68,68,136
"T-rustdoc,T-rustdoc",54097,2018-09-10T09:28:35Z,3,2,5
"A-lint;E-easy,A-lint;E-easy",54101,2018-09-10T13:56:49Z,19,13,32
NULL,54102,2018-09-10T14:24:42Z,0,0,0
NULL,54104,2018-09-10T14:36:06Z,2,136,138
"A-edition-2018-lints;A-rust-2018-preview,A-edition-2018-lints;A-rust-2018-preview",54111,2018-09-10T21:21:43Z,81,14,95
A-resolve;I-ICE,54116,2018-09-11T01:19:02Z,516,254,770
"S-waiting-on-review,S-waiting-on-review,S-waiting-on-review,S-waiting-on-review",54123,2018-09-11T11:43:09Z,0,0,0
"S-waiting-on-review,S-waiting-on-review,S-waiting-on-review",54125,2018-09-11T12:05:36Z,157,105,262
"S-blocked,S-waiting-on-review",54127,2018-09-11T13:47:58Z,0,0,0
NULL,54136,2018-09-11T19:13:25Z,2,2,4
"A-NLL;I-nominated,A-NLL;I-nominated",54139,2018-09-11T20:50:32Z,0,0,0
NULL,54142,2018-09-11T21:34:33Z,4,3,7
"S-waiting-on-review,S-waiting-on-review,S-waiting-on-review,A-parser;I-ICE,S-waiting-on-review,S-waiting-on-bors,S-waiting-on-review,S-waiting-on-review,S-waiting-on-review,S-waiting-on-review,S-waiting-on-bors,S-waiting-on-bors,S-waiting-on-review,S-waiting-on-review",54146,2018-09-12T04:17:42Z,265,365,630
"A-const-eval;E-easy;E-needstest,A-const-eval;E-easy;E-needstest",54147,2018-09-12T04:52:46Z,55,0,55
A-linkage,54152,2018-09-12T10:50:11Z,44,19,63
"A-diagnostics,A-diagnostics",54157,2018-09-12T18:19:23Z,179,164,343
"T-rustdoc,S-waiting-on-review",54162,2018-09-12T21:32:52Z,128,45,173
"S-waiting-on-review,S-waiting-on-review",54163,2018-09-12T21:37:49Z,1,1,2
"A-NLL;NLL-diagnostics;T-compiler,A-NLL;NLL-diagnostics;T-compiler",54164,2018-09-12T23:05:05Z,852,192,1044
"S-waiting-on-review;stable-accepted;stable-nominated,S-waiting-on-review,S-waiting-on-review,S-waiting-on-review,S-waiting-on-review,S-waiting-on-review,S-waiting-on-review,S-waiting-on-review,S-waiting-on-review,S-waiting-on-review,S-waiting-on-review,S-waiting-on-review,S-waiting-on-review;T-compiler,S-waiting-on-review;stable-accepted;stable-nominated,S-waiting-on-review,S-waiting-on-review,S-waiting-on-review,S-waiting-on-review,S-waiting-on-review,S-waiting-on-review,S-waiting-on-review",54168,2018-09-13T02:02:26Z,398,113,511
"A-diagnostics,A-diagnostics",54173,2018-09-13T06:48:08Z,143,10,153
NULL,54174,2018-09-13T07:27:33Z,26,18,44
NULL,54179,2018-09-13T12:27:05Z,0,0,0
"S-waiting-on-review,S-waiting-on-review",54181,2018-09-13T13:05:45Z,153,0,153
"A-NLL;NLL-sound;WG-compiler-nll,A-NLL;NLL-sound;WG-compiler-nll",54188,2018-09-13T15:19:58Z,185,102,287
"S-waiting-on-review,S-waiting-on-review",54199,2018-09-13T19:53:38Z,214,15,229
"B-RFC-approved;C-tracking-issue;T-lang,S-waiting-on-review,S-waiting-on-review,B-RFC-approved;C-tracking-issue;T-lang,S-waiting-on-review,S-waiting-on-review",54201,2018-09-13T20:40:29Z,89,73,162
NULL,54203,2018-09-13T21:28:38Z,2,2,4
"T-doc,T-doc",54207,2018-09-13T22:40:59Z,1,0,1
"A-macros;regression-from-stable-to-nightly,A-macros;regression-from-stable-to-nightly",54209,2018-09-13T23:52:28Z,51,51,102
"S-waiting-on-review,S-waiting-on-review;T-doc;beta-nominated,S-waiting-on-review,S-waiting-on-review,S-waiting-on-review,S-waiting-on-review,S-waiting-on-review,S-waiting-on-review,S-waiting-on-review",54215,2018-09-14T06:50:19Z,529,376,905
"A-testsuite,A-NLL;I-nominated,A-testsuite,A-NLL;I-nominated,A-testsuite",54223,2018-09-14T11:26:08Z,463,20,483
"A-macros;regression-from-stable-to-nightly,A-macros;regression-from-stable-to-nightly",54225,2018-09-14T12:06:36Z,36,0,36
S-waiting-on-review,54226,2018-09-14T12:24:42Z,0,0,0
"S-waiting-on-bors,S-waiting-on-bors",54227,2018-09-14T12:31:53Z,1,1,2
"B-unstable;T-libs,B-unstable;T-libs",54228,2018-09-14T12:57:47Z,0,0,0
"A-NLL;A-diagnostics;NLL-diagnostics;WG-compiler-nll,A-NLL;A-diagnostics;NLL-diagnostics;WG-compiler-nll",54229,2018-09-14T13:48:37Z,1338,431,1769
"S-waiting-on-review,S-waiting-on-review",54235,2018-09-14T18:52:27Z,0,0,0
NULL,54240,2018-09-15T01:49:02Z,14,0,14
"A-docs,A-docs",54244,2018-09-15T06:31:39Z,7,0,7
"A-lint,A-lint",54251,2018-09-15T14:27:49Z,94,45,139
C-bug;T-compiler,54252,2018-09-15T14:28:23Z,488,192,680
NULL,54255,2018-09-15T15:34:44Z,97,1,98
NULL,54258,2018-09-15T16:16:57Z,4,0,4
"C-cleanup;E-easy,S-waiting-on-review,C-cleanup;E-easy,S-waiting-on-review",54260,2018-09-15T17:15:54Z,157,101,258
"B-RFC-approved;C-tracking-issue;E-needs-mentor;T-lang;WG-compiler-front,B-RFC-approved;C-tracking-issue;E-needs-mentor;T-lang;WG-compiler-front",54261,2018-09-15T17:25:49Z,72,14,86
NULL,54265,2018-09-15T20:33:25Z,131,24,155
NULL,54266,2018-09-15T20:34:49Z,2,2,4
"A-diagnostics;E-mentor,S-waiting-on-review",54269,2018-09-16T04:40:05Z,67,14,81
"A-NLL;S-waiting-on-review,S-waiting-on-review,S-waiting-on-review,S-waiting-on-review,S-waiting-on-review",54270,2018-09-16T10:25:47Z,285,73,358
B-unstable;T-lang,54271,2018-09-16T10:33:45Z,30,213,243
"A-diagnostics,A-diagnostics",54273,2018-09-16T13:24:27Z,113,21,134
"S-waiting-on-review,S-waiting-on-review",54277,2018-09-16T17:26:48Z,160,51,211
"S-waiting-on-review,S-waiting-on-review",54278,2018-09-16T17:38:37Z,272,297,569
"S-waiting-on-review,S-waiting-on-review",54280,2018-09-16T21:10:39Z,23,0,23
"S-waiting-on-review,S-waiting-on-review",54281,2018-09-16T22:15:34Z,20,2,22
"A-linkage;C-bug;I-ICE;O-ARM;T-compiler,A-linkage;C-bug;I-ICE;O-ARM;T-compiler",54290,2018-09-17T12:44:36Z,2,3,5
NULL,54292,2018-09-17T13:11:24Z,38,0,38
S-waiting-on-review,54293,2018-09-17T13:40:28Z,1,1,2
"S-waiting-on-review,S-waiting-on-review",54298,2018-09-17T16:06:27Z,4,1,5
"A-diagnostics,A-diagnostics",54299,2018-09-17T16:31:38Z,18,15,33
NULL,54301,2018-09-17T16:53:40Z,35,36,71
NULL,54308,2018-09-17T21:55:14Z,69,14,83
"A-NLL;NLL-diagnostics,A-NLL;NLL-diagnostics",54310,2018-09-18T00:10:21Z,346,73,419
"T-libs,T-libs",54317,2018-09-18T05:54:50Z,332,0,332
"S-waiting-on-review,S-waiting-on-review",54318,2018-09-18T06:35:00Z,222,380,602
"S-waiting-on-review,S-waiting-on-review,S-waiting-on-review,S-waiting-on-review,A-macros;regression-from-stable-to-nightly,S-waiting-on-review,S-waiting-on-review,S-waiting-on-review,S-waiting-on-review,S-waiting-on-review",54319,2018-09-18T08:21:45Z,230,84,314
NULL,54323,2018-09-18T13:04:57Z,1,42,43
A-NLL;NLL-complete;WG-compiler-nll,54324,2018-09-18T14:43:08Z,0,0,0
S-waiting-on-bors,54335,2018-09-18T21:46:46Z,0,0,0
NULL,54338,2018-09-19T00:25:20Z,47,15,62
S-waiting-on-review,54339,2018-09-19T00:52:24Z,93,568,661
S-waiting-on-bors,54342,2018-09-19T02:40:47Z,1,1,2
A-NLL;NLL-diagnostics,54343,2018-09-19T04:54:54Z,345,249,594
"A-rustdoc,A-rustdoc",54345,2018-09-19T05:21:26Z,0,0,0
NULL,54346,2018-09-19T08:25:36Z,5,1,6
"S-waiting-on-review,S-waiting-on-review",54347,2018-09-19T08:55:28Z,0,0,0
NULL,54349,2018-09-19T09:15:14Z,142,29,171
NULL,54350,2018-09-19T09:30:06Z,149,36,185
"S-waiting-on-review,S-waiting-on-review,S-waiting-on-review,S-waiting-on-review",54352,2018-09-19T10:37:02Z,0,0,0
NULL,54355,2018-09-19T12:49:31Z,32,0,32
"A-NLL;NLL-deferred;T-compiler,A-NLL;NLL-deferred;T-compiler",54367,2018-09-19T20:55:05Z,35,0,35
"A-rustdoc,A-rustdoc",54368,2018-09-19T22:50:44Z,1,1,2
S-waiting-on-review,54383,2018-09-20T09:40:44Z,904,128,1032
"S-waiting-on-review,S-waiting-on-review,S-waiting-on-review,S-waiting-on-review,S-waiting-on-review,S-waiting-on-bors,S-waiting-on-review,S-waiting-on-review,S-waiting-on-review,S-waiting-on-review,S-waiting-on-bors,S-waiting-on-review,S-waiting-on-review,S-waiting-on-bors,S-waiting-on-review",54389,2018-09-20T13:36:38Z,636,525,1161
"A-diagnostics;A-edition-2018-lints;A-resolve;T-compiler,A-diagnostics;A-edition-2018-lints;A-resolve;T-compiler",54391,2018-09-20T15:09:31Z,296,19,315
"S-waiting-on-review,S-waiting-on-review",54394,2018-09-20T15:59:44Z,0,0,0
"S-waiting-on-review,S-waiting-on-review",54396,2018-09-20T16:30:40Z,36,37,73
S-waiting-on-review,54397,2018-09-20T16:38:22Z,42,2,44
"S-waiting-on-review,S-waiting-on-review",54398,2018-09-20T16:38:25Z,28,1,29
"S-waiting-on-review,S-waiting-on-review",54399,2018-09-20T16:38:28Z,28,1,29
"regression-from-stable-to-stable,regression-from-stable-to-stable",54401,2018-09-20T17:58:58Z,0,0,0
NULL,54402,2018-09-20T18:16:21Z,1,1,2
"I-nominated;S-waiting-on-review;T-lang;beta-nominated,I-nominated;S-waiting-on-review;T-lang;beta-nominated",54404,2018-09-20T20:16:36Z,61,181,242
"C-bug;I-nominated;T-compiler;regression-from-stable-to-beta,C-bug;I-nominated;T-compiler;regression-from-stable-to-beta",54409,2018-09-20T23:46:59Z,51,13,64
"A-rust-2018-preview;P-high;WG-epoch,A-rust-2018-preview;P-high;WG-epoch",54411,2018-09-21T00:42:17Z,244,4,248
NULL,54412,2018-09-21T01:12:08Z,3,1,4
NULL,54413,2018-09-21T01:20:51Z,67,0,67
NULL,54414,2018-09-21T01:35:04Z,0,0,0
"E-easy,E-easy",54416,2018-09-21T01:49:42Z,41,2,43
NULL,54424,2018-09-21T11:51:15Z,0,0,0
S-waiting-on-review,54426,2018-09-21T13:29:48Z,0,0,0
NULL,54430,2018-09-21T14:13:17Z,1,7,8
"S-waiting-on-bors,S-waiting-on-bors,S-waiting-on-review,S-waiting-on-review,S-waiting-on-review,S-waiting-on-review,S-waiting-on-review,S-waiting-on-review,S-waiting-on-review,S-waiting-on-review,S-waiting-on-review,S-waiting-on-review,S-waiting-on-bors,S-waiting-on-bors,S-waiting-on-review,S-waiting-on-review,S-waiting-on-review,S-waiting-on-review,S-waiting-on-review,S-waiting-on-review,S-waiting-on-review",54432,2018-09-21T15:15:19Z,0,0,0
NULL,54438,2018-09-21T16:23:46Z,0,0,0
NULL,54442,2018-09-21T16:47:23Z,0,0,0
NULL,54443,2018-09-21T17:26:26Z,4,4,8
"A-NLL;T-compiler,A-NLL;T-compiler",54447,2018-09-21T19:04:08Z,176,64,240
NULL,54451,2018-09-21T23:03:43Z,400,307,707
"NLL-complete;T-compiler;WG-compiler-nll,NLL-complete;T-compiler;WG-compiler-nll",54453,2018-09-21T23:32:36Z,2573,1603,4176
"S-waiting-on-review,S-waiting-on-review,S-waiting-on-review,S-waiting-on-review,S-waiting-on-review,S-waiting-on-bors,S-waiting-on-review,S-waiting-on-review,S-waiting-on-review,S-waiting-on-review,S-waiting-on-review,S-waiting-on-review,S-waiting-on-review,S-waiting-on-review,S-waiting-on-review,S-waiting-on-review,S-waiting-on-review",54457,2018-09-22T07:56:45Z,912,447,1359
NULL,54458,2018-09-22T08:47:30Z,83,29,112
"S-waiting-on-review,S-waiting-on-review",54461,2018-09-22T10:39:03Z,990,547,1537
NULL,54468,2018-09-22T13:16:29Z,172,80,252
"S-waiting-on-review,S-waiting-on-review",54484,2018-09-22T17:15:26Z,132,66,198
"S-waiting-on-review,S-waiting-on-review",54485,2018-09-22T18:59:59Z,30,11,41
S-waiting-on-review,54487,2018-09-22T20:59:07Z,88,152,240
NULL,54488,2018-09-22T20:59:15Z,74,1,75
"T-compiler,T-compiler",54490,2018-09-22T22:12:35Z,240,287,527
"A-diagnostics,A-diagnostics",54495,2018-09-23T02:40:44Z,10,8,18
"B-unstable;C-tracking-issue;T-lang,B-unstable;C-tracking-issue;T-lang",54497,2018-09-23T05:27:44Z,197,161,358
"B-RFC-approved;C-tracking-issue;P-high;T-compiler;T-lang,B-RFC-approved;C-tracking-issue;P-high;T-compiler;T-lang",54507,2018-09-23T15:01:10Z,29,1,30
"A-NLL;NLL-complete;WG-compiler-nll,A-NLL;NLL-complete;WG-compiler-nll",54509,2018-09-23T15:31:50Z,282,416,698
"A-resolve;C-bug;I-nominated;T-compiler;regression-from-stable-to-beta,A-resolve;C-bug;I-nominated;T-compiler;regression-from-stable-to-beta",54518,2018-09-24T00:55:34Z,90,21,111
"A-linkage;C-bug;I-ICE;O-ARM;T-compiler,A-linkage;C-bug;I-ICE;O-ARM;T-compiler",54529,2018-09-24T12:49:02Z,9,1,10
"A-testsuite,S-waiting-on-review,A-testsuite",54530,2018-09-24T13:06:25Z,37501,36530,74031
"A-NLL;S-waiting-on-review,S-waiting-on-review,S-waiting-on-review,A-NLL;S-waiting-on-review,S-waiting-on-review,S-waiting-on-review",54532,2018-09-24T15:37:25Z,0,0,0
NULL,54537,2018-09-24T19:49:02Z,101,101,202
NULL,54544,2018-09-25T01:56:43Z,13,2,15
NULL,54547,2018-09-25T03:14:03Z,11,4,15
"S-waiting-on-review,S-waiting-on-review",54554,2018-09-25T13:11:03Z,85,254,339
NULL,54557,2018-09-25T15:14:18Z,0,1,1
NULL,54564,2018-09-25T17:49:39Z,13,0,13
NULL,54565,2018-09-25T17:50:27Z,13,0,13
NULL,54568,2018-09-25T18:51:02Z,122,6,128
"S-waiting-on-review,S-waiting-on-review,S-waiting-on-bors,S-waiting-on-review,S-waiting-on-review,S-waiting-on-review,S-waiting-on-review,S-waiting-on-review,S-waiting-on-review,S-waiting-on-review,S-waiting-on-review,S-waiting-on-review;beta-nominated",54575,2018-09-25T20:34:52Z,538,224,762
NULL,54576,2018-09-25T20:40:05Z,14,3,17
NULL,54577,2018-09-25T21:46:14Z,374,52,426
"S-waiting-on-review,S-waiting-on-review",54580,2018-09-25T22:39:09Z,1058,35,1093
"A-parser;I-nominated;T-compiler;regression-from-stable-to-beta,A-parser;I-nominated;T-compiler;regression-from-stable-to-beta",54581,2018-09-26T00:14:55Z,28,0,28
NULL,54590,2018-09-26T14:52:39Z,1,0,1
"S-waiting-on-review,S-waiting-on-review",54591,2018-09-26T15:38:33Z,344,392,736
NULL,54592,2018-09-26T16:55:35Z,89,7,96
NULL,54596,2018-09-26T20:06:30Z,69,13,82
"A-NLL;A-impl-trait;C-bug;I-ICE,A-NLL;A-impl-trait;C-bug;I-ICE",54599,2018-09-26T21:07:18Z,37,5,42
NULL,54601,2018-09-26T21:29:23Z,94,571,665
"A-diagnostics;A-edition-2018-lints;A-rust-2018-preview;T-compiler,A-diagnostics;A-edition-2018-lints;A-rust-2018-preview;T-compiler",54603,2018-09-26T23:19:39Z,241,49,290
NULL,54604,2018-09-27T01:34:07Z,38,15,53
"C-bug;I-nominated;T-compiler;regression-from-stable-to-beta,C-bug;I-nominated;T-compiler;regression-from-stable-to-beta",54605,2018-09-27T02:40:24Z,130,23,153
"S-waiting-on-review,S-waiting-on-review,S-waiting-on-review;beta-nominated,S-waiting-on-review,S-waiting-on-review,S-waiting-on-review",54607,2018-09-27T04:32:33Z,0,0,0
"A-docs,A-docs",54609,2018-09-27T05:23:02Z,54,21,75
"E-easy;E-help-wanted;E-mentor;T-libs,E-easy;E-help-wanted;E-mentor;T-libs",54613,2018-09-27T10:10:52Z,2,0,2
"A-NLL;NLL-diagnostics,A-NLL;NLL-diagnostics",54621,2018-09-27T21:11:29Z,0,0,0
"S-waiting-on-review,regression-from-stable-to-stable,regression-from-stable-to-stable,S-waiting-on-review",54624,2018-09-27T21:55:03Z,328,5,333
NULL,54626,2018-09-27T23:53:53Z,59,24,83
NULL,54635,2018-09-28T12:03:17Z,2,2,4
"A-rustbuild;C-enhancement;E-mentor;T-dev-tools;T-infra,A-rustbuild;C-enhancement;E-mentor;T-dev-tools;T-infra",54638,2018-09-28T13:57:22Z,36,5,41
"S-waiting-on-review,A-LLVM;T-compiler;regression-from-stable-to-beta,A-LLVM;T-compiler;regression-from-stable-to-beta",54639,2018-09-28T14:49:31Z,48,10,58
"A-LLVM;T-compiler;regression-from-stable-to-beta,S-waiting-on-bors;T-compiler;beta-nominated;stable-nominated",54640,2018-09-28T14:50:51Z,48,10,58
S-waiting-on-review,54643,2018-09-28T15:55:59Z,1,1,2
"S-waiting-on-review,S-waiting-on-review",54645,2018-09-28T16:37:55Z,225,203,428
NULL,54646,2018-09-28T16:39:06Z,14,10,24
NULL,54650,2018-09-28T20:37:27Z,59,110,169
"A-rust-2018-preview;WG-epoch,A-rust-2018-preview;WG-epoch",54658,2018-09-29T00:32:35Z,369,79,448
"S-waiting-on-review,S-waiting-on-review,S-waiting-on-review,S-waiting-on-review,S-waiting-on-review,S-waiting-on-review,S-waiting-on-review",54660,2018-09-29T05:21:22Z,671,277,948
"S-waiting-on-review,S-waiting-on-review",54662,2018-09-29T08:10:24Z,1,0,1
NULL,54666,2018-09-29T11:37:34Z,665,653,1318
"S-waiting-on-review,S-waiting-on-review",54667,2018-09-29T12:54:28Z,181,14,195
"S-waiting-on-review,S-waiting-on-review",54668,2018-09-29T13:06:29Z,53,52,105
"S-waiting-on-review,S-waiting-on-bors,S-waiting-on-bors",54671,2018-09-29T14:13:56Z,33,31,64
NULL,54675,2018-09-29T18:06:54Z,12,6,18
B-RFC-approved,54676,2018-09-29T18:31:53Z,5,13,18
"A-sanitizers,A-sanitizers",54681,2018-09-29T21:29:40Z,37,4,41
"A-lifetimes,A-lifetimes",54687,2018-09-30T05:14:23Z,153,151,304
NULL,54693,2018-09-30T11:11:34Z,166,150,316
NULL,54694,2018-09-30T12:55:08Z,97,1,98
NULL,54700,2018-09-30T16:29:05Z,13,10,23
"C-bug;I-nominated;T-compiler;regression-from-stable-to-beta,C-bug;I-nominated;T-compiler;regression-from-stable-to-beta",54701,2018-09-30T17:11:59Z,172,57,229
"regression-from-stable-to-stable,regression-from-stable-to-stable",54702,2018-09-30T17:48:10Z,37,6,43
"A-diagnostics;T-compiler,A-diagnostics;T-compiler",54703,2018-09-30T19:45:58Z,216,12,228
T-rustdoc,54706,2018-09-30T22:56:40Z,0,0,0
NULL,54708,2018-10-01T01:13:05Z,5,0,5
"S-waiting-on-bors,S-waiting-on-review,S-waiting-on-review,S-waiting-on-review,S-waiting-on-review,S-waiting-on-bors,S-waiting-on-review,S-waiting-on-review,S-waiting-on-review,S-waiting-on-review,S-waiting-on-review",54711,2018-10-01T08:13:07Z,491,298,789
S-waiting-on-review,54713,2018-10-01T09:17:59Z,8,2,10
NULL,54718,2018-10-01T14:24:58Z,5,3,8
NULL,54720,2018-10-01T17:26:02Z,232,30,262
"A-macros;A-plugin;B-RFC-approved,A-macros;A-plugin;B-RFC-approved",54728,2018-10-01T17:59:39Z,38,38,76
T-rustdoc,54733,2018-10-01T22:43:48Z,0,0,0
"A-diagnostics,A-diagnostics",54734,2018-10-01T23:39:33Z,664,3,667
"A-impl-trait;regression-from-stable-to-beta;regression-from-stable-to-nightly,A-impl-trait;regression-from-stable-to-beta;regression-from-stable-to-nightly",54741,2018-10-02T08:55:31Z,152,181,333
A-testsuite,54743,2018-10-02T09:25:53Z,146,178,324
NULL,54745,2018-10-02T10:44:46Z,13,1,14
"S-waiting-on-review,S-waiting-on-review",54747,2018-10-02T11:10:21Z,122,7,129
S-waiting-on-review,54748,2018-10-02T11:20:49Z,0,0,0
"S-waiting-on-bors;beta-nominated,S-waiting-on-review,S-waiting-on-review;beta-nominated,S-waiting-on-bors;beta-nominated,S-waiting-on-review;beta-nominated",54750,2018-10-02T12:20:26Z,223,146,369
"E-easy;T-doc,E-easy;T-doc",54755,2018-10-02T16:39:30Z,25,0,25
A-testsuite,54756,2018-10-02T17:00:45Z,641,711,1352
"A-NLL;NLL-sound;T-compiler,A-NLL;NLL-sound;T-compiler",54757,2018-10-02T17:04:15Z,387,77,464
"S-waiting-on-review,S-waiting-on-review",54759,2018-10-02T19:09:00Z,0,0,0
"A-const-eval;E-mentor,A-const-eval;E-mentor",54762,2018-10-02T19:56:28Z,634,351,985
"S-waiting-on-review,S-waiting-on-review,S-waiting-on-review,S-waiting-on-review,S-waiting-on-review,S-waiting-on-review,S-waiting-on-review,S-waiting-on-review,S-waiting-on-review,A-diagnostics;E-mentor",54763,2018-10-02T19:58:19Z,0,0,0
"S-waiting-on-review,S-waiting-on-review",54764,2018-10-02T20:05:46Z,1405,702,2107
"S-waiting-on-review,S-waiting-on-review,S-waiting-on-review,S-waiting-on-review,A-diagnostics;E-mentor,S-waiting-on-review,S-waiting-on-review,S-waiting-on-review,S-waiting-on-review,S-waiting-on-review",54767,2018-10-02T20:54:39Z,937,538,1475
T-rustdoc,54770,2018-10-02T23:03:48Z,0,0,0
"S-waiting-on-review,S-waiting-on-review",54773,2018-10-03T02:12:14Z,1,1,2
NULL,54777,2018-10-03T06:06:00Z,10,0,10
"S-waiting-on-review,A-lifetimes,S-waiting-on-review,A-lifetimes",54778,2018-10-03T07:34:57Z,156,264,420
NULL,54780,2018-10-03T09:51:27Z,36,6,42
"A-NLL;NLL-diagnostics,A-NLL;NLL-diagnostics",54782,2018-10-03T11:40:49Z,958,141,1099
NULL,54787,2018-10-03T13:15:22Z,53,17,70
"S-waiting-on-review,S-waiting-on-bors,S-waiting-on-bors,S-waiting-on-review,S-waiting-on-review,S-waiting-on-bors,S-waiting-on-review,S-waiting-on-bors,S-waiting-on-review,S-waiting-on-review,S-waiting-on-review",54790,2018-10-03T15:44:31Z,0,0,0
"A-diagnostics;E-easy,A-diagnostics;E-easy",54795,2018-10-03T18:33:12Z,22,2,24
"S-waiting-on-review,S-waiting-on-bors,S-waiting-on-review,S-waiting-on-review,S-waiting-on-review,S-waiting-on-bors,S-waiting-on-review,S-waiting-on-bors,S-waiting-on-review,S-waiting-on-review,S-waiting-on-review",54796,2018-10-03T18:36:23Z,0,0,0
"A-const-fn;E-easy,S-waiting-on-review",54799,2018-10-03T22:18:41Z,0,0,0
"A-NLL,A-NLL",54802,2018-10-03T23:52:29Z,214,68,282
NULL,54804,2018-10-04T02:22:44Z,106,1,107
NULL,54806,2018-10-04T07:22:34Z,12,2,14
"S-waiting-on-bors;T-compiler;beta-nominated;stable-nominated,S-waiting-on-review;stable-accepted;stable-nominated,S-waiting-on-bors;T-compiler;beta-nominated;stable-nominated,S-waiting-on-review;stable-accepted;stable-nominated",54808,2018-10-04T10:01:15Z,140,92,232
"S-waiting-on-review,S-waiting-on-bors,S-waiting-on-review,S-waiting-on-review,S-waiting-on-review,S-waiting-on-review,S-waiting-on-bors,S-waiting-on-review,S-waiting-on-review,S-waiting-on-bors,S-waiting-on-review",54809,2018-10-04T10:20:18Z,304,76,380
NULL,54810,2018-10-04T10:40:26Z,24,7,31
NULL,54811,2018-10-04T10:44:01Z,29,10,39
"A-testsuite,A-testsuite",54813,2018-10-04T13:33:55Z,20,42,62
NULL,54816,2018-10-04T14:24:04Z,47,3,50
A-lint;E-mentor;T-compiler,54820,2018-10-04T16:50:51Z,150,42,192
"beta-nominated,S-waiting-on-review;beta-nominated,beta-nominated,S-waiting-on-bors",54821,2018-10-04T16:55:19Z,160,30,190
"A-lifetimes;A-traits;I-nominated,I-papercut,A-lifetimes;A-traits;I-nominated,I-papercut",54823,2018-10-04T19:52:17Z,68,0,68
NULL,54824,2018-10-04T20:31:47Z,16,13,29
NULL,54825,2018-10-04T20:48:26Z,21,6,27
C-tracking-issue;T-rustdoc,54827,2018-10-04T22:14:55Z,0,0,0
NULL,54831,2018-10-04T23:22:23Z,89,0,89
"B-RFC-approved;C-tracking-issue;T-lang;T-libs,B-RFC-approved;C-tracking-issue;T-lang;T-libs",54832,2018-10-05T00:27:26Z,0,0,0
NULL,54833,2018-10-05T01:32:23Z,40,16,56
NULL,54834,2018-10-05T04:34:22Z,0,1,1
"B-RFC-approved;B-RFC-implemented;C-tracking-issue;T-lang,B-RFC-approved;B-RFC-implemented;C-tracking-issue;T-lang",54835,2018-10-05T08:18:18Z,145,254,399
NULL,54848,2018-10-05T15:09:22Z,224,37,261
NULL,54850,2018-10-05T15:49:14Z,59,0,59
"C-bug;I-nominated;regression-from-stable-to-beta,S-waiting-on-review,C-bug;I-nominated;regression-from-stable-to-beta,C-bug;I-nominated;regression-from-stable-to-beta,S-waiting-on-review,C-bug;I-nominated;regression-from-stable-to-beta",54851,2018-10-05T16:17:37Z,5,47,52
NULL,54853,2018-10-05T16:39:25Z,11,28,39
"S-waiting-on-review,S-waiting-on-bors,S-waiting-on-review,S-waiting-on-review,S-waiting-on-review,S-waiting-on-review,S-waiting-on-review,S-waiting-on-review,S-waiting-on-bors,S-waiting-on-review,S-waiting-on-review,S-waiting-on-review,S-waiting-on-bors;beta-accepted;beta-nominated",54859,2018-10-05T20:33:24Z,796,503,1299
NULL,54860,2018-10-05T22:24:35Z,7,1,8
NULL,54861,2018-10-05T23:35:00Z,201,26,227
"C-cleanup;T-compiler;WG-compiler-traits,C-cleanup;T-compiler;WG-compiler-traits",54866,2018-10-06T11:53:20Z,0,0,0
"T-rustdoc,T-rustdoc",54869,2018-10-06T16:53:40Z,31,19,50
"A-attributes;C-tracking-issue;T-dev-tools,A-attributes;C-tracking-issue;T-dev-tools",54870,2018-10-06T16:57:41Z,11,117,128
"S-waiting-on-review;beta-nominated,C-bug;I-nominated;T-compiler;regression-from-stable-to-beta,S-waiting-on-review;beta-nominated,C-bug;I-nominated;T-compiler;regression-from-stable-to-beta",54877,2018-10-06T21:37:26Z,807,802,1609
NULL,54884,2018-10-07T05:03:45Z,0,0,0
A-lint,54885,2018-10-07T05:57:41Z,12,4,16
"B-unstable;C-tracking-issue;T-libs,S-waiting-on-review,B-unstable;C-tracking-issue;T-libs,S-waiting-on-review",54891,2018-10-07T10:01:47Z,1,1,2
NULL,54893,2018-10-07T11:23:07Z,48,0,48
"B-RFC-approved;C-tracking-issue;T-libs,B-RFC-approved;C-tracking-issue;T-libs",54904,2018-10-08T08:07:45Z,1,5,6
NULL,54906,2018-10-08T12:52:39Z,80,8,88
"S-waiting-on-bors;beta-accepted;beta-nominated,S-waiting-on-bors,S-waiting-on-review,S-waiting-on-review,S-waiting-on-bors;beta-accepted;beta-nominated,S-waiting-on-bors,S-waiting-on-review,S-waiting-on-review",54907,2018-10-08T13:03:21Z,102,49,151
"S-waiting-on-bors,C-cleanup;T-compiler;WG-compiler-traits",54909,2018-10-08T13:36:45Z,198,93,291
NULL,54916,2018-10-08T19:12:27Z,18,15,33
NULL,54920,2018-10-08T20:09:19Z,52,8,60
NULL,54921,2018-10-08T22:27:32Z,68,14,82
I-unsound%20%F0%9F%92%A5;P-high;T-libs,54922,2018-10-09T00:20:53Z,14,10,24
"S-waiting-on-review,S-waiting-on-review",54924,2018-10-09T06:59:33Z,33,27,60
"A-diagnostics;C-feature-request,A-diagnostics;C-feature-request",54929,2018-10-09T09:57:07Z,221,78,299
"S-waiting-on-review,S-waiting-on-review",54936,2018-10-09T16:53:38Z,2,23,25
"A-NLL;T-compiler,A-NLL;T-compiler",54938,2018-10-09T19:40:03Z,0,0,0
"C-bug;I-nominated;regression-from-stable-to-beta,C-bug;I-nominated;regression-from-stable-to-beta",54939,2018-10-09T21:07:23Z,2,3,5
A-NLL;NLL-diagnostics,54941,2018-10-09T21:33:23Z,1689,206,1895
"A-NLL;NLL-sound,A-NLL;NLL-sound",54942,2018-10-09T22:04:45Z,343,134,477
"S-waiting-on-review,S-waiting-on-review,S-waiting-on-review,S-waiting-on-review,S-waiting-on-review,S-waiting-on-review,S-waiting-on-review,S-waiting-on-review,E-easy;T-doc,S-waiting-on-review,S-waiting-on-bors,S-waiting-on-review,S-waiting-on-review,S-waiting-on-review,S-waiting-on-review,S-waiting-on-review,S-waiting-on-review,S-waiting-on-bors,S-waiting-on-review,S-waiting-on-review,S-waiting-on-review,S-waiting-on-review,S-waiting-on-review,E-easy;T-doc,S-waiting-on-review,S-waiting-on-review,S-waiting-on-review,S-waiting-on-bors,S-waiting-on-review,S-waiting-on-review,S-waiting-on-bors,S-waiting-on-review",54944,2018-10-09T22:38:42Z,0,0,0
NULL,54945,2018-10-09T22:55:23Z,49,41,90
"A-diagnostics;C-enhancement,A-diagnostics;C-enhancement,A-diagnostics",54946,2018-10-10T02:04:41Z,559,45,604
"S-waiting-on-bors,S-waiting-on-review,S-waiting-on-review,S-waiting-on-bors,S-waiting-on-review,S-waiting-on-review,S-waiting-on-review,S-waiting-on-review,S-waiting-on-review,S-waiting-on-review,S-waiting-on-review;relnotes,S-waiting-on-review,E-easy;T-doc,S-waiting-on-review",54953,2018-10-10T07:01:40Z,0,0,0
NULL,54956,2018-10-10T08:10:40Z,1,1,2
"A-debuginfo,A-debuginfo",54964,2018-10-10T14:28:35Z,183,62,245
NULL,54967,2018-10-10T17:42:02Z,5,3,8
"S-waiting-on-review,S-waiting-on-review,S-waiting-on-review,S-waiting-on-review;relnotes,S-waiting-on-review,S-waiting-on-review,S-waiting-on-review,S-waiting-on-review,S-waiting-on-review",54968,2018-10-10T19:17:49Z,0,0,0
"S-waiting-on-review,S-waiting-on-review,S-waiting-on-review,S-waiting-on-review,S-waiting-on-review,S-waiting-on-review,S-waiting-on-review,S-waiting-on-review,S-waiting-on-review,S-waiting-on-review;relnotes,S-waiting-on-review,S-waiting-on-review,S-waiting-on-review,S-waiting-on-review,S-waiting-on-review,S-waiting-on-review,S-waiting-on-review,S-waiting-on-review,S-waiting-on-review;relnotes,S-waiting-on-review",54969,2018-10-10T19:18:09Z,830,286,1116
NULL,54976,2018-10-10T23:30:10Z,343,202,545
NULL,54977,2018-10-10T23:56:30Z,18,1,19
"A-diagnostics,A-diagnostics",54979,2018-10-11T00:31:31Z,26,1,27
NULL,54980,2018-10-11T03:53:48Z,31,78,109
NULL,54983,2018-10-11T05:55:51Z,13,10,23
"S-waiting-on-bors,S-waiting-on-review,S-waiting-on-review,S-waiting-on-review,S-waiting-on-review,S-waiting-on-review,S-waiting-on-review,S-waiting-on-bors,S-waiting-on-review,S-waiting-on-review,S-waiting-on-review,S-waiting-on-review,S-waiting-on-review,S-waiting-on-review,E-easy;T-doc,S-waiting-on-review,S-waiting-on-review,S-waiting-on-bors,S-waiting-on-review,S-waiting-on-review,S-waiting-on-bors,S-waiting-on-review,S-waiting-on-review,S-waiting-on-review,S-waiting-on-review,S-waiting-on-review,S-waiting-on-review,S-waiting-on-review,S-waiting-on-review,S-waiting-on-review,S-waiting-on-review,S-waiting-on-review,S-waiting-on-review,E-easy;T-doc",54990,2018-10-11T14:32:32Z,0,0,0
NULL,54991,2018-10-11T15:34:19Z,24,0,24
S-waiting-on-review,54993,2018-10-11T15:52:37Z,28,5,33
NULL,54995,2018-10-11T17:06:32Z,0,0,0
NULL,54997,2018-10-11T17:40:47Z,295,162,457
"S-waiting-on-review;T-lang,S-waiting-on-review;T-lang,S-waiting-on-review;T-lang,S-waiting-on-review;T-lang",55003,2018-10-12T06:20:57Z,31,16,47
NULL,55004,2018-10-12T07:21:37Z,91,77,168
NULL,55007,2018-10-12T11:51:08Z,104,10,114
"A-debuginfo,A-debuginfo",55010,2018-10-12T13:36:48Z,115,18,133
NULL,55011,2018-10-12T13:56:54Z,45,5,50
"S-waiting-on-review,S-waiting-on-bors,S-waiting-on-review,S-waiting-on-review,S-waiting-on-review,S-waiting-on-review,S-waiting-on-review,S-waiting-on-review,S-waiting-on-review,S-waiting-on-review,S-waiting-on-review,S-waiting-on-review,S-waiting-on-review,S-waiting-on-review,E-easy;T-doc,S-waiting-on-review,S-waiting-on-bors,S-waiting-on-review",55012,2018-10-12T14:04:20Z,293,129,422
"B-RFC-approved;C-tracking-issue;T-lang,B-RFC-approved;C-tracking-issue;T-lang",55015,2018-10-12T14:20:52Z,100,1,101
NULL,55017,2018-10-12T16:45:18Z,49,0,49
NULL,55018,2018-10-12T17:09:52Z,20,1,21
NULL,55023,2018-10-12T21:36:17Z,30,4,34
"S-waiting-on-review,S-waiting-on-review",55031,2018-10-13T09:01:47Z,14,8,22
B-RFC-approved;C-tracking-issue;T-libs,55045,2018-10-13T17:12:45Z,271,4,275
NULL,55052,2018-10-13T22:02:21Z,1,1,2
"S-waiting-on-bors,S-waiting-on-review,S-waiting-on-bors,S-waiting-on-review",55053,2018-10-13T23:10:02Z,119,81,200
NULL,55062,2018-10-14T09:11:25Z,3,1,4
"A-diagnostics;T-compiler,A-NLL;NLL-diagnostics,A-diagnostics;T-compiler,A-NLL;NLL-diagnostics",55069,2018-10-14T14:18:26Z,1938,1836,3774
"A-const-eval;A-const-fn;I-ICE;T-compiler,A-const-eval;A-const-fn;I-ICE;T-compiler",55071,2018-10-14T15:42:53Z,79,3,82
NULL,55073,2018-10-14T19:35:12Z,332,9,341
NULL,55080,2018-10-15T00:28:10Z,20,2,22
NULL,55084,2018-10-15T04:58:37Z,1,1,2
NULL,55086,2018-10-15T08:07:52Z,0,0,0
NULL,55090,2018-10-15T12:09:14Z,34,0,34
A-NLL;NLL-sound;T-compiler,55093,2018-10-15T13:05:13Z,1260,848,2108
"S-waiting-on-review,S-waiting-on-review,S-waiting-on-review,S-waiting-on-review,S-waiting-on-review,S-waiting-on-review,S-waiting-on-review,S-waiting-on-review,S-waiting-on-review,S-waiting-on-review,A-lint;E-mentor;T-compiler,S-waiting-on-review",55095,2018-10-15T17:15:25Z,326,374,700
NULL,55101,2018-10-15T18:57:02Z,631,332,963
"A-traits;P-high;T-compiler,A-traits;P-high;T-compiler",55102,2018-10-15T20:46:20Z,30,4,34
NULL,55104,2018-10-15T21:18:35Z,16,0,16
NULL,55108,2018-10-16T02:32:16Z,0,0,0
NULL,55119,2018-10-16T13:58:15Z,64,54,118
NULL,55126,2018-10-16T17:10:53Z,14,23,37
NULL,55128,2018-10-16T17:20:11Z,3,3,6
"A-NLL,A-NLL",55134,2018-10-16T23:03:49Z,928,2966,3894
NULL,55136,2018-10-16T23:59:57Z,78,35,113
NULL,55138,2018-10-17T04:53:31Z,21,11,32
NULL,55139,2018-10-17T07:18:13Z,0,0,0
"T-libs;beta-accepted;beta-nominated,S-waiting-on-review,T-libs;beta-accepted;beta-nominated,S-waiting-on-review",55148,2018-10-17T13:55:28Z,11,0,11
NULL,55150,2018-10-17T14:35:25Z,91,14,105
"A-NLL;T-compiler,A-NLL;T-compiler,A-NLL;T-compiler",55152,2018-10-17T15:10:17Z,553,276,829
NULL,55162,2018-10-17T21:21:14Z,910,362,1272
"A-diagnostics,A-diagnostics",55166,2018-10-17T22:51:41Z,17,5,22
NULL,55169,2018-10-18T01:32:35Z,58,0,58
"S-waiting-on-review,S-waiting-on-review,S-waiting-on-review,A-NLL;S-waiting-on-review,S-waiting-on-review,S-waiting-on-bors,S-waiting-on-review,S-waiting-on-review,S-waiting-on-bors,S-waiting-on-review,S-waiting-on-review,S-waiting-on-review,S-waiting-on-review,S-waiting-on-review,S-waiting-on-review,S-waiting-on-review,S-waiting-on-review",55171,2018-10-18T02:47:39Z,740,547,1287
"A-diagnostics,A-diagnostics",55173,2018-10-18T04:08:42Z,103,45,148
B-unstable;C-tracking-issue;T-libs,55178,2018-10-18T08:15:19Z,51,69,120
"S-waiting-on-review,S-waiting-on-review;T-release,S-waiting-on-bors,A-NLL;S-waiting-on-review,S-waiting-on-review,S-waiting-on-review,S-waiting-on-review,S-waiting-on-review,S-waiting-on-review,S-waiting-on-review,S-waiting-on-review;T-release,S-waiting-on-review,S-waiting-on-review,S-waiting-on-bors,S-waiting-on-review,S-waiting-on-review,S-waiting-on-review,S-waiting-on-review",55181,2018-10-18T14:07:39Z,0,0,0
"S-waiting-on-review,S-waiting-on-review;T-release,S-waiting-on-review;beta-nominated,S-waiting-on-review",55184,2018-10-18T15:01:39Z,188,33,221
"A-diagnostics;I-nominated;T-compiler,A-diagnostics;I-nominated;T-compiler",55185,2018-10-18T17:14:03Z,63,29,92
NULL,55187,2018-10-18T20:30:48Z,0,6,6
NULL,55188,2018-10-18T20:43:03Z,0,0,0
C-cleanup,55190,2018-10-18T23:32:41Z,210,209,419
NULL,55191,2018-10-18T23:35:56Z,39,17,56
NULL,55192,2018-10-19T00:15:13Z,22,0,22
NULL,55193,2018-10-19T00:49:15Z,0,0,0
"S-waiting-on-review,S-waiting-on-review,S-waiting-on-review,S-waiting-on-review,S-waiting-on-review;T-release,A-NLL;S-waiting-on-review,S-waiting-on-review",55194,2018-10-19T03:03:38Z,504,239,743
NULL,55200,2018-10-19T10:55:34Z,88,0,88
NULL,55211,2018-10-19T19:10:02Z,38,10,48
A-allocators;I-enhancement;T-libs,55217,2018-10-20T03:03:55Z,0,0,0
"NLL-diagnostics,A-NLL;NLL-diagnostics,NLL-diagnostics,A-NLL;NLL-diagnostics",55221,2018-10-20T09:11:06Z,48,822,870
"A-NLL;NLL-sound,A-NLL;NLL-sound",55229,2018-10-20T17:19:21Z,321,101,422
"S-waiting-on-review,S-waiting-on-review,S-waiting-on-review,S-waiting-on-review,S-waiting-on-review",55230,2018-10-20T18:07:53Z,551,38,589
NULL,55233,2018-10-20T20:09:20Z,0,0,0
NULL,55236,2018-10-20T22:43:59Z,3262,150,3412
"A-allocators;I-enhancement;T-libs,A-allocators;I-enhancement;T-libs",55238,2018-10-21T02:21:07Z,165,473,638
"S-waiting-on-review,S-waiting-on-review",55244,2018-10-21T15:03:33Z,120,72,192
"A-libs;E-easy;I-completion,A-lint,A-libs;E-easy;I-completion,A-lint",55245,2018-10-21T16:08:11Z,2,1,3
"A-diagnostics,A-diagnostics",55253,2018-10-21T22:54:18Z,53,27,80
NULL,55257,2018-10-22T03:01:07Z,61,14,75
NULL,55258,2018-10-22T04:51:54Z,87,3,90
NULL,55260,2018-10-22T11:12:00Z,0,0,0
"A-build;A-rustbuild;T-release;WG-codegen,A-build;A-rustbuild;T-release;WG-codegen",55264,2018-10-22T15:06:48Z,30,5,35
"A-NLL;T-compiler;WG-compiler-nll,A-NLL;T-compiler,A-NLL;T-compiler;WG-compiler-nll,A-NLL;T-compiler",55274,2018-10-22T21:43:22Z,622,127,749
"S-waiting-on-review,A-rust-2018-preview;WG-epoch",55275,2018-10-22T22:33:40Z,89,10,99
NULL,55280,2018-10-23T04:53:35Z,1,0,1
"S-waiting-on-review,S-waiting-on-review",55289,2018-10-23T14:51:22Z,20,20,40
NULL,55291,2018-10-23T16:42:12Z,1,1,2
A-syntaxext,55292,2018-10-23T17:10:32Z,123,35,158
"S-waiting-on-review,S-waiting-on-review,S-waiting-on-bors,S-waiting-on-review,S-waiting-on-review,S-waiting-on-review,S-waiting-on-review,S-waiting-on-review,S-waiting-on-review,S-waiting-on-review,S-waiting-on-review,S-waiting-on-review,S-waiting-on-review,S-blocked,S-waiting-on-review,S-waiting-on-review,S-waiting-on-review,S-waiting-on-review,S-waiting-on-review,S-waiting-on-bors,S-waiting-on-review,S-waiting-on-review,S-waiting-on-review,S-waiting-on-review,S-waiting-on-review,S-waiting-on-review,S-waiting-on-review,S-waiting-on-review,S-waiting-on-review,S-waiting-on-review,S-waiting-on-review,S-waiting-on-review,S-waiting-on-review,S-waiting-on-review,S-blocked,S-waiting-on-review",55295,2018-10-23T21:25:21Z,0,0,0
NULL,55298,2018-10-24T00:18:40Z,152,50,202
NULL,55301,2018-10-24T04:40:46Z,385,141,526
NULL,55302,2018-10-24T07:45:09Z,40,76,116
"C-bug;I-nominated;regression-from-stable-to-beta,C-bug;I-nominated;regression-from-stable-to-beta",55306,2018-10-24T10:20:31Z,42,0,42
NULL,55316,2018-10-24T15:07:39Z,450,922,1372
NULL,55318,2018-10-24T15:51:12Z,152,17,169
NULL,55320,2018-10-24T17:27:27Z,0,0,0
NULL,55323,2018-10-24T18:37:02Z,367,126,493
"S-waiting-on-review,S-waiting-on-review",55327,2018-10-24T21:35:22Z,0,0,0
NULL,55328,2018-10-24T22:22:16Z,8,8,16
"S-waiting-on-review,S-waiting-on-review,S-waiting-on-review,S-waiting-on-review,S-waiting-on-review,S-waiting-on-review,S-waiting-on-review,S-waiting-on-review,S-waiting-on-review,S-waiting-on-review,S-waiting-on-review,S-waiting-on-review,S-waiting-on-review,S-waiting-on-review,C-bug;I-nominated;regression-from-stable-to-beta,S-waiting-on-bors,S-waiting-on-bors,S-waiting-on-review,S-waiting-on-review,S-waiting-on-review,S-waiting-on-review,S-waiting-on-review",55343,2018-10-25T08:32:22Z,1,1,2
"S-waiting-on-review,S-waiting-on-review,S-waiting-on-review,C-bug;I-nominated;regression-from-stable-to-beta,S-waiting-on-review,S-waiting-on-bors,S-waiting-on-review,S-waiting-on-review,S-waiting-on-review,S-waiting-on-review,S-waiting-on-review,S-waiting-on-review,S-waiting-on-review,S-waiting-on-review,S-waiting-on-review,S-waiting-on-review,S-waiting-on-review,S-waiting-on-review,S-waiting-on-review,S-waiting-on-review,S-waiting-on-review,S-waiting-on-review,S-waiting-on-review,S-waiting-on-review,S-waiting-on-review,S-waiting-on-review,S-waiting-on-bors,S-waiting-on-review,S-waiting-on-review,S-waiting-on-review,S-waiting-on-review,S-waiting-on-review,S-waiting-on-review,S-waiting-on-review,S-waiting-on-review,S-waiting-on-review,S-waiting-on-review,S-waiting-on-review,S-waiting-on-review,S-waiting-on-review,S-waiting-on-review,S-waiting-on-review,S-waiting-on-review,S-waiting-on-review,S-waiting-on-review,S-waiting-on-review,S-waiting-on-review",55347,2018-10-25T12:31:25Z,1159,282,1441
S-waiting-on-review,55349,2018-10-25T15:53:03Z,280,303,583
C-tracking-issue;T-libs,55355,2018-10-25T18:52:02Z,0,0,0
NULL,55356,2018-10-25T19:22:08Z,43,1,44
"S-waiting-on-review,S-waiting-on-review,S-waiting-on-review,S-waiting-on-review,S-waiting-on-review,S-waiting-on-review,S-waiting-on-review,S-waiting-on-review,S-waiting-on-review,S-waiting-on-review,S-waiting-on-review,S-waiting-on-review,S-waiting-on-review,S-waiting-on-review,S-waiting-on-review,S-waiting-on-review,S-waiting-on-review,S-waiting-on-review,S-waiting-on-review,S-waiting-on-review,S-waiting-on-review,S-waiting-on-review,S-waiting-on-review,S-waiting-on-review,S-waiting-on-review,S-waiting-on-review",55357,2018-10-25T19:32:51Z,0,0,0
"S-waiting-on-review,S-waiting-on-review",55362,2018-10-25T20:59:17Z,0,4,4
"S-waiting-on-review,B-RFC-approved;B-unstable;T-lang;T-libs",55366,2018-10-25T22:54:58Z,18,24,42
A-lint;C-feature-request;T-rustdoc,55367,2018-10-25T22:55:49Z,158,43,201
NULL,55368,2018-10-25T22:58:15Z,0,0,0
"S-waiting-on-review,S-waiting-on-review,S-waiting-on-review,S-waiting-on-review,S-waiting-on-review,S-waiting-on-review,S-waiting-on-review,S-waiting-on-review,S-waiting-on-review,S-waiting-on-review,S-waiting-on-review,S-waiting-on-review,S-waiting-on-review,S-waiting-on-review,S-waiting-on-review",55371,2018-10-26T02:55:58Z,0,0,0
NULL,55373,2018-10-26T04:50:11Z,0,0,0
"S-waiting-on-review,S-waiting-on-review,S-waiting-on-review,S-waiting-on-review,S-waiting-on-bors,S-waiting-on-review,S-waiting-on-review,S-waiting-on-review,S-waiting-on-review,S-waiting-on-review,S-waiting-on-review,S-waiting-on-review,S-waiting-on-review,S-waiting-on-review,S-waiting-on-review,S-waiting-on-review,S-waiting-on-review,S-waiting-on-review,S-waiting-on-review",55382,2018-10-26T10:25:19Z,1170,497,1667
NULL,55385,2018-10-26T11:29:30Z,356,194,550
"S-waiting-on-review,S-waiting-on-review,S-waiting-on-review,S-waiting-on-review",55389,2018-10-26T13:07:21Z,1,1,2
S-waiting-on-review,55392,2018-10-26T16:04:27Z,0,0,0
NULL,55402,2018-10-26T22:36:46Z,130,65,195
NULL,55405,2018-10-27T06:27:20Z,1292,812,2104
"S-waiting-on-review,S-waiting-on-review",55410,2018-10-27T10:50:18Z,169,20,189
NULL,55412,2018-10-27T11:36:09Z,26,2,28
NULL,55421,2018-10-27T19:06:52Z,20,0,20
S-waiting-on-review,55423,2018-10-27T22:11:12Z,3,44,47
"B-unstable;S-waiting-on-review;T-libs,S-waiting-on-review,S-waiting-on-review,S-waiting-on-review,S-waiting-on-review,S-waiting-on-review;T-libs;disposition-merge;proposed-final-comment-period,S-waiting-on-review,S-waiting-on-review,S-waiting-on-review,S-waiting-on-review,S-waiting-on-review,S-waiting-on-review,S-waiting-on-review,B-unstable;S-waiting-on-review;T-libs,S-waiting-on-review,S-waiting-on-review;T-libs;disposition-merge;proposed-final-comment-period,S-waiting-on-review,S-waiting-on-review,S-waiting-on-review,S-waiting-on-review,S-waiting-on-review,S-waiting-on-review",55425,2018-10-27T22:51:04Z,0,0,0
NULL,55431,2018-10-28T06:57:04Z,0,0,0
"B-unstable;S-waiting-on-review;T-libs,S-waiting-on-review;T-libs,S-waiting-on-review,S-waiting-on-review,S-waiting-on-review,S-waiting-on-review,S-waiting-on-review;T-libs;disposition-merge;proposed-final-comment-period,S-waiting-on-review,S-waiting-on-review,S-waiting-on-review",55433,2018-10-28T08:38:56Z,386,171,557
S-waiting-on-review,55447,2018-10-28T16:13:09Z,1,1,2
NULL,55448,2018-10-28T16:30:31Z,355,0,355
S-waiting-on-review,55450,2018-10-28T18:12:11Z,9,2,11
NULL,55451,2018-10-28T18:57:38Z,187,33,220
NULL,55453,2018-10-28T19:40:57Z,73,9,82
NULL,55455,2018-10-28T23:06:13Z,66,44,110
NULL,55459,2018-10-29T04:11:10Z,35,0,35
"S-waiting-on-review,S-waiting-on-review;beta-nominated,S-waiting-on-review,S-waiting-on-review,S-waiting-on-review,S-waiting-on-review,S-waiting-on-review,S-waiting-on-review",55462,2018-10-29T08:47:54Z,39,56,95
"S-waiting-on-review,C-bug;I-nominated;regression-from-stable-to-beta",55469,2018-10-29T10:47:48Z,25,0,25
NULL,55470,2018-10-29T11:21:25Z,54,0,54
NULL,55474,2018-10-29T14:24:20Z,25,2,27
"A-driver;E-easy;I-completion,A-libs;E-easy;I-completion",55484,2018-10-29T18:45:23Z,0,0,0
NULL,55487,2018-10-29T20:12:09Z,33,2,35
NULL,55490,2018-10-29T21:24:42Z,42,0,42
A-NLL;NLL-sound,55494,2018-10-29T23:44:12Z,269,66,335
"S-waiting-on-review,S-waiting-on-review,S-waiting-on-bors;beta-nominated,S-waiting-on-review,S-waiting-on-review,S-waiting-on-review,S-waiting-on-review,S-waiting-on-bors;beta-nominated,S-waiting-on-review,A-NLL;NLL-sound;S-waiting-on-review;beta-nominated,S-waiting-on-review,S-waiting-on-review",55502,2018-10-30T10:55:39Z,444,139,583
B-RFC-approved;B-unstable;T-lang,55510,2018-10-30T16:58:51Z,32,3,35
NULL,55517,2018-10-30T21:02:38Z,1563,1777,3340
NULL,55519,2018-10-30T22:32:21Z,6,0,6
NULL,55521,2018-10-30T23:50:01Z,33,31,64
A-testsuite;E-easy;T-compiler,55532,2018-10-31T12:09:19Z,449,1312,1761
S-waiting-on-review,55545,2018-10-31T16:25:47Z,0,0,0
S-waiting-on-review,55549,2018-10-31T18:55:19Z,786,439,1225
S-waiting-on-review,55550,2018-10-31T19:06:42Z,7,7,14
"S-waiting-on-review,A-NLL;NLL-sound;S-waiting-on-review;beta-nominated,S-waiting-on-review,S-waiting-on-review",55554,2018-10-31T22:02:39Z,303,76,379
S-waiting-on-review,55562,2018-11-01T01:20:57Z,88,23,111
T-rustdoc,55563,2018-11-01T01:22:40Z,22,6,28
NULL,55566,2018-11-01T01:49:36Z,0,0,0
NULL,55567,2018-11-01T03:27:03Z,41,0,41
NULL,55568,2018-11-01T03:27:46Z,256,0,256
A-lint;C-bug;regression-from-stable-to-stable,55569,2018-11-01T03:33:37Z,44,16,60
NULL,55573,2018-11-01T07:33:38Z,1,1,2
"S-waiting-on-review,S-waiting-on-review,C-bug;I-nominated;regression-from-stable-to-beta,S-waiting-on-review,S-waiting-on-review,S-waiting-on-bors,S-waiting-on-review,S-waiting-on-review,S-waiting-on-review,S-waiting-on-review,S-waiting-on-review,S-waiting-on-review",55579,2018-11-01T10:55:33Z,86,56,142
S-waiting-on-bors;beta-nominated,55581,2018-11-01T11:41:09Z,19,1,20
S-waiting-on-review,55590,2018-11-01T18:23:48Z,0,0,0
A-LLVM,55609,2018-11-02T12:46:59Z,30,2,32
S-waiting-on-review,55611,2018-11-02T14:11:11Z,222,132,354
A-diagnostics;A-edition-2018-lints;T-compiler,55613,2018-11-02T14:19:37Z,0,0,0
T-compiler,55617,2018-11-02T15:28:22Z,0,0,0
NULL,55624,2018-11-02T18:02:04Z,0,0,0
NULL,55626,2018-11-02T19:21:58Z,48,40,88
S-waiting-on-review,55627,2018-11-02T19:40:13Z,10107,7653,17760
S-waiting-on-bors,55632,2018-11-02T22:16:28Z,56,43,99
NULL,55633,2018-11-02T22:40:16Z,98,51,149
A-const-eval;A-const-fn;C-tracking-issue;T-lang,55635,2018-11-02T23:23:11Z,868,137,1005
T-release,55636,2018-11-03T00:26:02Z,0,0,0
NULL,55637,2018-11-03T01:05:43Z,93,22,115
NULL,55638,2018-11-03T01:33:37Z,34,0,34
"S-waiting-on-review,S-waiting-on-review,S-waiting-on-review,S-waiting-on-review,S-waiting-on-review",55646,2018-11-03T12:40:40Z,429,49,478
NULL,55650,2018-11-03T15:27:18Z,93,8,101
"A-NLL;NLL-diagnostics,A-NLL;NLL-diagnostics,A-NLL;NLL-diagnostics;NLL-sound",55657,2018-11-03T17:20:40Z,121,31,152
S-waiting-on-review,55662,2018-11-03T19:15:44Z,1,1,2
A-lint,55663,2018-11-03T20:27:28Z,79,16,95
"S-waiting-on-review,S-waiting-on-review",55665,2018-11-03T21:12:59Z,175,214,389
B-RFC-approved;T-lang,55672,2018-11-04T10:24:20Z,53,4,57
S-waiting-on-review,55674,2018-11-04T14:15:53Z,532,494,1026
NULL,55679,2018-11-04T17:56:23Z,0,0,0
S-waiting-on-review,55681,2018-11-04T22:56:38Z,1,1,2
A-rustdoc;T-dev-tools-rustdoc,55682,2018-11-05T00:07:00Z,80,30,110
NULL,55683,2018-11-05T01:21:36Z,0,0,0
NULL,55687,2018-11-05T03:37:49Z,302,199,501
A-NLL;NLL-diagnostics;NLL-sound,55696,2018-11-05T13:38:32Z,75,36,111
S-waiting-on-review,55698,2018-11-05T14:06:09Z,29,259,288
NULL,55700,2018-11-05T15:21:02Z,532,254,786
S-waiting-on-review,55701,2018-11-05T15:47:43Z,67,4,71
S-waiting-on-review,55702,2018-11-05T15:55:18Z,1,0,1
S-waiting-on-review,55703,2018-11-05T17:07:30Z,1,1,2
"S-waiting-on-review,S-waiting-on-review,S-waiting-on-review,S-waiting-on-review,S-waiting-on-review,S-waiting-on-bors,S-waiting-on-review,S-waiting-on-review,S-waiting-on-bors,S-waiting-on-review",55710,2018-11-06T07:21:14Z,775,410,1185
"S-waiting-on-review,S-waiting-on-review",55716,2018-11-06T12:04:49Z,267,163,430
NULL,55717,2018-11-06T12:07:10Z,3,2,5
A-linkage;T-compiler,55719,2018-11-06T13:23:17Z,38,13,51
NULL,55730,2018-11-06T19:25:12Z,30,1,31
A-diagnostics;C-bug,55736,2018-11-06T22:49:31Z,7,4,11
T-release,55738,2018-11-07T02:47:22Z,229,24,253
S-waiting-on-review,55740,2018-11-07T04:32:54Z,0,0,0
S-waiting-on-review,55742,2018-11-07T06:21:44Z,34,5,39
"S-waiting-on-review,S-waiting-on-review,S-waiting-on-review,S-waiting-on-review,S-waiting-on-review,S-waiting-on-review,S-waiting-on-review,S-waiting-on-review,S-waiting-on-review,S-waiting-on-review,S-waiting-on-review,S-waiting-on-review,S-waiting-on-review",55746,2018-11-07T10:02:07Z,505,268,773
NULL,55751,2018-11-07T12:23:08Z,0,0,0
NULL,55758,2018-11-07T15:12:02Z,136,28,164
S-waiting-on-review,55760,2018-11-07T16:05:11Z,5,5,10
NULL,55764,2018-11-07T18:02:51Z,25,4,29
S-waiting-on-review,55767,2018-11-07T19:38:04Z,34,27,61
NULL,55774,2018-11-08T01:56:59Z,4,1,5
A-NLL;NLL-diagnostics,55781,2018-11-08T11:58:56Z,194,34,228
B-unstable;T-libs,55783,2018-11-08T13:28:50Z,7,4,11
NULL,55785,2018-11-08T15:18:48Z,20,1,21
NULL,55788,2018-11-08T15:53:22Z,7,1,8
"S-waiting-on-review,S-waiting-on-review,S-waiting-on-review,S-waiting-on-review,S-waiting-on-review,S-waiting-on-bors,S-waiting-on-review,S-waiting-on-bors,S-waiting-on-review,S-waiting-on-review,S-waiting-on-review,S-waiting-on-review,S-waiting-on-review,S-waiting-on-review,S-waiting-on-review",55789,2018-11-08T17:50:23Z,0,0,0
I-ICE,55792,2018-11-08T19:16:22Z,36,8,44
NULL,55798,2018-11-08T23:01:41Z,79,33,112
NULL,55799,2018-11-08T23:04:08Z,52,202,254
NULL,55800,2018-11-08T23:20:05Z,87,1,88
T-compiler,55801,2018-11-08T23:29:15Z,103,86,189
"S-waiting-on-review,S-waiting-on-review,S-waiting-on-review,S-waiting-on-review,S-waiting-on-bors,S-waiting-on-review,S-waiting-on-bors,S-waiting-on-review,S-waiting-on-review,S-waiting-on-review,S-waiting-on-review,S-waiting-on-review,S-waiting-on-review,S-waiting-on-review,S-waiting-on-review,S-waiting-on-review",55803,2018-11-09T01:15:26Z,403,172,575
NULL,55804,2018-11-09T01:16:00Z,81,1,82
A-impl-trait;T-compiler,55807,2018-11-09T02:31:17Z,0,0,0
"A-associated-items;A-diagnostics;A-traits,S-waiting-on-review",55808,2018-11-09T02:59:39Z,222,94,316
T-libs;regression-from-stable-to-beta,55819,2018-11-09T11:33:35Z,27,4,31
NULL,55822,2018-11-09T14:41:45Z,55,16,71
NULL,55823,2018-11-09T15:26:18Z,1,1,2
I-nominated;T-compiler;regression-from-stable-to-beta,55828,2018-11-09T16:57:55Z,76,0,76
S-waiting-on-review,55834,2018-11-09T22:55:59Z,120,1,121
A-typesystem;T-lang,55837,2018-11-10T02:44:26Z,55,0,55
S-waiting-on-review,55840,2018-11-10T05:00:02Z,2,2,4
S-waiting-on-review,55845,2018-11-10T13:18:08Z,7,1,8
"S-waiting-on-review,S-waiting-on-review;beta-nominated,S-waiting-on-review,S-waiting-on-review",55849,2018-11-10T14:32:28Z,101,25,126
A-rust-2018-preview,55852,2018-11-10T18:09:19Z,71,20,91
"S-waiting-on-review,S-waiting-on-review,S-waiting-on-bors,S-waiting-on-review;beta-nominated,S-waiting-on-review;beta-nominated,S-waiting-on-review,S-waiting-on-review,S-waiting-on-review,S-waiting-on-review,S-waiting-on-review,S-waiting-on-bors,S-waiting-on-review,S-waiting-on-bors,S-waiting-on-review",55854,2018-11-10T20:04:50Z,0,0,0
"S-waiting-on-review,S-waiting-on-review,S-waiting-on-review,S-waiting-on-review,S-waiting-on-bors,S-waiting-on-review,S-waiting-on-bors,S-waiting-on-review,S-waiting-on-review,S-waiting-on-review,S-waiting-on-review,S-waiting-on-review;beta-nominated,S-waiting-on-review;beta-nominated,S-waiting-on-review",55859,2018-11-10T23:21:27Z,1117,666,1783
NULL,55860,2018-11-11T00:12:07Z,0,0,0
S-waiting-on-review,55862,2018-11-11T06:43:14Z,160,60,220
NULL,55867,2018-11-11T09:45:44Z,2,2,4
S-waiting-on-review,55871,2018-11-11T14:01:39Z,23,21,44
NULL,55874,2018-11-11T14:47:45Z,41,0,41
"T-lang;disposition-merge;proposed-final-comment-period,E-needs-mentor",55880,2018-11-11T21:16:18Z,0,0,0
"A-resolve,T-lang,B-RFC-approved;C-tracking-issue;T-lang",55884,2018-11-12T02:13:36Z,2224,1516,3740
"S-waiting-on-review;beta-nominated,T-libs;regression-from-stable-to-beta,I-nominated;T-compiler;regression-from-stable-to-beta",55893,2018-11-12T10:07:49Z,103,4,107
"S-waiting-on-review,S-waiting-on-bors,S-waiting-on-review,S-waiting-on-review,A-typesystem;S-waiting-on-review;T-lang;relnotes,S-waiting-on-review,S-waiting-on-review,S-waiting-on-review,S-waiting-on-review,S-waiting-on-review;T-rustdoc;beta-nominated,S-waiting-on-review,S-waiting-on-review,S-waiting-on-review,S-waiting-on-review,S-waiting-on-review,S-waiting-on-bors,S-waiting-on-review,S-waiting-on-review",55902,2018-11-12T20:58:46Z,0,0,0
"S-waiting-on-review,S-waiting-on-review,S-waiting-on-review,S-waiting-on-review;T-rustdoc;beta-nominated,S-waiting-on-review,S-waiting-on-review,S-waiting-on-bors,S-waiting-on-review,S-waiting-on-review,S-waiting-on-review,S-waiting-on-bors,S-waiting-on-bors,S-waiting-on-review,S-waiting-on-review,S-waiting-on-bors,A-typesystem;S-waiting-on-review;T-lang;relnotes,S-waiting-on-review,S-waiting-on-review,S-waiting-on-review",55912,2018-11-13T05:03:27Z,603,509,1112
S-waiting-on-review,55915,2018-11-13T09:20:34Z,613,493,1106
S-waiting-on-review,55916,2018-11-13T12:13:18Z,23,16,39
"A-traits;T-compiler;WG-compiler-traits;chalk-integration,A-traits;WG-compiler-traits",55921,2018-11-13T15:16:04Z,414,212,626
S-waiting-on-review,55922,2018-11-13T15:22:22Z,132,66,198
NULL,55923,2018-11-13T15:30:41Z,40,1,41
NULL,55933,2018-11-13T19:35:30Z,43,5,48
A-NLL;NLL-sound,55937,2018-11-13T21:59:27Z,804,500,1304
S-waiting-on-review,55939,2018-11-13T23:08:52Z,83,106,189
"S-waiting-on-review,S-waiting-on-review,S-waiting-on-bors,S-waiting-on-review,S-waiting-on-review,S-waiting-on-review,S-waiting-on-review,S-waiting-on-review,S-waiting-on-review,S-waiting-on-review,S-waiting-on-bors,S-waiting-on-review",55943,2018-11-14T04:08:42Z,0,0,0
NULL,55956,2018-11-14T17:43:05Z,35,0,35
A-edition-2018-lints;A-rust-2018-preview,55958,2018-11-14T20:58:16Z,1,1,2
NULL,55961,2018-11-14T23:23:34Z,22,3,25
NULL,55962,2018-11-15T00:26:52Z,38,1,39
NULL,55963,2018-11-15T00:44:16Z,172,0,172
NULL,55968,2018-11-15T04:03:17Z,45,165,210
NULL,55971,2018-11-15T08:38:02Z,141,6,147
S-waiting-on-review,55973,2018-11-15T09:31:59Z,0,0,0
"S-waiting-on-review,S-waiting-on-review,S-waiting-on-review,S-waiting-on-review,S-waiting-on-review,S-waiting-on-review,S-waiting-on-review,S-waiting-on-review,S-waiting-on-review,S-waiting-on-review,S-waiting-on-review,S-waiting-on-review,S-waiting-on-bors,S-waiting-on-bors,S-waiting-on-review,S-waiting-on-review,S-waiting-on-review",55974,2018-11-15T10:04:48Z,934,390,1324
NULL,55978,2018-11-15T13:43:05Z,83,106,189
NULL,55980,2018-11-15T14:21:10Z,45,11,56
I-unsound%20%F0%9F%92%A5;T-compiler;relnotes,55982,2018-11-15T15:07:42Z,61,46,107
NULL,55986,2018-11-15T17:39:53Z,309,145,454
NULL,55987,2018-11-15T18:00:25Z,95,1,96
NULL,55988,2018-11-15T19:10:55Z,0,0,0
"S-waiting-on-review,S-waiting-on-review;T-lang;beta-nominated,S-waiting-on-review,S-waiting-on-review",55989,2018-11-15T19:24:46Z,124,17,141
"S-waiting-on-review,S-waiting-on-review,B-RFC-approved;C-tracking-issue;T-lang,S-waiting-on-review,S-waiting-on-review,S-waiting-on-bors,S-waiting-on-review,S-waiting-on-review,S-waiting-on-review,S-waiting-on-review,S-waiting-on-review,S-waiting-on-review,S-waiting-on-review,S-waiting-on-bors,S-waiting-on-review,S-waiting-on-review,S-waiting-on-review,S-waiting-on-review",55990,2018-11-15T22:12:49Z,0,0,0
"T-libs,B-RFC-approved;C-tracking-issue;T-libs",55992,2018-11-15T23:50:50Z,32,22,54
S-waiting-on-review,56000,2018-11-16T11:24:06Z,77,0,77
C-bug;I-nominated;T-compiler;regression-from-stable-to-beta,56003,2018-11-16T14:27:41Z,66,10,76
T-rustdoc,56005,2018-11-16T15:35:16Z,688,612,1300
A-intra-doc-links;T-rustdoc,56010,2018-11-16T19:59:50Z,238,60,298
NULL,56014,2018-11-17T05:08:43Z,5,0,5
NULL,56016,2018-11-17T08:34:38Z,39,1,40
S-waiting-on-review,56023,2018-11-17T13:54:24Z,9,7,16
A-const-fn;I-ICE,56024,2018-11-17T14:37:07Z,52,33,85
"S-waiting-on-review,S-waiting-on-review,S-waiting-on-review,S-waiting-on-review,S-waiting-on-review,S-waiting-on-review,S-waiting-on-review,S-waiting-on-review,S-waiting-on-review,S-waiting-on-review,S-waiting-on-review,S-waiting-on-bors,S-waiting-on-review,S-waiting-on-review,S-waiting-on-bors,B-RFC-approved;C-tracking-issue;T-lang,S-waiting-on-review,S-waiting-on-review",56026,2018-11-17T16:12:04Z,0,0,0
NULL,56027,2018-11-17T16:42:54Z,1,1,2
A-rust-2018-preview;B-unstable;C-tracking-issue;T-lang,56032,2018-11-17T18:26:07Z,40,151,191
S-waiting-on-author;S-waiting-on-crater,56042,2018-11-18T12:59:24Z,2186,1520,3706
NULL,56043,2018-11-18T15:12:57Z,60,7,67
NULL,56045,2018-11-18T15:46:25Z,133,46,179
NULL,56047,2018-11-18T16:13:14Z,0,0,0
S-waiting-on-review,56048,2018-11-18T17:11:24Z,41,2,43
NULL,56049,2018-11-18T18:43:10Z,14,75,89
"A-io;B-unstable;T-libs,S-waiting-on-review",56050,2018-11-18T19:40:24Z,0,0,0
"S-waiting-on-review,S-waiting-on-review,S-waiting-on-review,S-waiting-on-review,S-waiting-on-review,S-waiting-on-review,S-waiting-on-review,B-RFC-approved;C-tracking-issue;T-lang,S-waiting-on-review;beta-nominated,S-waiting-on-bors,S-waiting-on-review,S-waiting-on-review,S-waiting-on-review,S-waiting-on-review,S-waiting-on-review,S-waiting-on-review,S-waiting-on-review,S-waiting-on-review,S-waiting-on-review,S-waiting-on-review,S-waiting-on-review,S-waiting-on-review,S-waiting-on-review,S-waiting-on-review",56051,2018-11-18T22:25:02Z,1251,591,1842
"S-waiting-on-author;S-waiting-on-crater,S-waiting-on-review",56053,2018-11-19T00:15:01Z,644,541,1185
A-spurious;C-tracking-issue;T-infra,56059,2018-11-19T03:10:45Z,1,1,2
NULL,56063,2018-11-19T07:07:28Z,11,11,22
NULL,56065,2018-11-19T09:41:05Z,16,5,21
S-waiting-on-review,56067,2018-11-19T11:16:29Z,93,0,93
A-const-eval;A-diagnostics;C-bug,56070,2018-11-19T12:49:35Z,382,43,425
B-RFC-approved;B-unstable;T-lang,56072,2018-11-19T14:47:42Z,15,73,88
"S-waiting-on-review;beta-nominated,S-waiting-on-review;T-rustdoc;beta-nominated,S-waiting-on-review,S-waiting-on-review;beta-nominated,S-waiting-on-review",56077,2018-11-19T20:17:10Z,0,0,0
A-rustbuild;T-dev-tools,56081,2018-11-19T22:23:49Z,2,0,2
S-waiting-on-review,56097,2018-11-20T11:21:54Z,20,3,23
NULL,56102,2018-11-20T14:39:20Z,1782,1399,3181
"A-rls;T-dev-tools,S-waiting-on-bors,T-dev-tools",56111,2018-11-20T19:25:16Z,89,68,157
A-NLL;NLL-diagnostics,56113,2018-11-20T19:51:04Z,361,194,555
T-compiler;regression-from-stable-to-beta,56117,2018-11-21T00:58:46Z,15,1,16
"S-waiting-on-review,S-waiting-on-review",56120,2018-11-21T05:14:32Z,228,1,229
S-waiting-on-review,56126,2018-11-21T10:49:56Z,105,0,105
NULL,56129,2018-11-21T11:58:27Z,0,0,0
S-waiting-on-review,56136,2018-11-21T14:11:55Z,1,1,2
"S-waiting-on-bors;beta-nominated,S-waiting-on-review",56139,2018-11-21T16:48:19Z,0,0,0
I-ICE;regression-from-stable-to-beta,56143,2018-11-21T19:23:30Z,123,41,164
A-debuginfo,56144,2018-11-21T19:32:28Z,50,63,113
A-traits;B-RFC-approved;C-tracking-issue;T-lang;WG-compiler-traits,56145,2018-11-21T21:47:15Z,1648,267,1915
"S-waiting-on-review,S-waiting-on-review,S-waiting-on-review,S-waiting-on-bors,S-waiting-on-review,S-waiting-on-review,S-waiting-on-review,S-waiting-on-review,S-waiting-on-review,S-waiting-on-review,S-waiting-on-review",56155,2018-11-22T09:37:57Z,507,97,604
S-waiting-on-review,56156,2018-11-22T09:49:17Z,0,0,0
"B-RFC-implemented;C-tracking-issue;T-lang,S-waiting-on-review,S-waiting-on-review",56160,2018-11-22T13:44:28Z,1085,132,1217
NULL,56163,2018-11-22T14:40:26Z,8,0,8
I-ICE,56170,2018-11-22T18:12:48Z,19,4,23
"S-waiting-on-review;beta-nominated,S-waiting-on-review,S-waiting-on-review;beta-nominated,S-waiting-on-bors;T-release;beta-accepted;beta-nominated,S-waiting-on-review,S-waiting-on-review",56174,2018-11-22T22:20:59Z,285,112,397
NULL,56176,2018-11-22T23:13:27Z,5,5,10
S-waiting-on-review,56177,2018-11-23T00:08:40Z,0,0,0
S-waiting-on-review,56184,2018-11-23T12:07:16Z,12,2,14
"S-waiting-on-bors;T-release;beta-accepted;beta-nominated,S-waiting-on-review,S-waiting-on-review,I-nominated;S-waiting-on-review;T-compiler,S-waiting-on-bors,S-waiting-on-review,S-waiting-on-review,S-waiting-on-review,S-waiting-on-review,S-waiting-on-review,A-iterators;S-waiting-on-review;T-libs,S-waiting-on-review,S-waiting-on-review,S-waiting-on-review",56186,2018-11-23T17:32:04Z,606,96,702
A-diagnostics,56188,2018-11-23T21:05:02Z,133,58,191
NULL,56189,2018-11-23T22:49:02Z,73,8,81
NULL,56198,2018-11-24T15:06:08Z,536,525,1061
"S-waiting-on-review,S-waiting-on-review,S-waiting-on-review",56201,2018-11-24T16:27:49Z,1,4,5
NULL,56203,2018-11-24T20:46:08Z,89,15,104
NULL,56204,2018-11-25T00:24:47Z,68,7,75
NULL,56205,2018-11-25T01:14:12Z,0,0,0
NULL,56206,2018-11-25T02:02:07Z,88,34,122
"C-tracking-issue;T-libs,C-tracking-issue;T-libs",56207,2018-11-25T07:29:58Z,14,38,52
"S-waiting-on-bors,S-waiting-on-author;S-waiting-on-crater",56211,2018-11-25T13:58:05Z,129,35,164
A-traits;T-compiler;WG-compiler-traits,56214,2018-11-25T15:48:29Z,985,151,1136
"S-waiting-on-bors,S-waiting-on-review,S-waiting-on-review,S-waiting-on-review,S-waiting-on-bors,S-waiting-on-review,S-waiting-on-review,S-waiting-on-review,S-waiting-on-review,S-waiting-on-review,S-waiting-on-bors,S-waiting-on-bors,S-waiting-on-review,S-waiting-on-review",56215,2018-11-25T16:05:14Z,686,374,1060
NULL,56217,2018-11-25T16:40:45Z,25,1,26
T-lang;T-libs;regression-from-stable-to-beta,56219,2018-11-25T17:48:34Z,172,65,237
"S-waiting-on-review,S-waiting-on-review,S-waiting-on-review,S-waiting-on-review",56231,2018-11-26T10:31:30Z,0,0,0
A-const-eval;E-easy;E-mentor,56233,2018-11-26T12:22:35Z,6,4,10
S-waiting-on-review,56234,2018-11-26T12:48:51Z,0,0,0
"beta-nominated,S-waiting-on-review",56240,2018-11-26T15:48:12Z,678,546,1224
A-diagnostics,56248,2018-11-26T18:14:01Z,124,31,155
beta-nominated,56262,2018-11-26T23:02:47Z,645,539,1184
NULL,56264,2018-11-27T00:31:19Z,11,1,12
"S-waiting-on-review,S-waiting-on-review,S-waiting-on-review,S-waiting-on-review,S-waiting-on-review,S-waiting-on-bors;T-libs,S-waiting-on-bors,S-waiting-on-review",56276,2018-11-27T11:17:35Z,0,0,0
S-waiting-on-review,56278,2018-11-27T12:09:09Z,318,254,572
S-waiting-on-review,56282,2018-11-27T14:43:59Z,26,2,28
A-incr-comp,56287,2018-11-27T16:57:27Z,0,0,0
NULL,56300,2018-11-27T23:31:57Z,33,5,38
B-RFC-approved;C-tracking-issue;T-lang,56303,2018-11-28T00:00:30Z,11,69,80
NULL,56310,2018-11-28T13:24:03Z,0,0,0
NULL,56313,2018-11-28T15:18:43Z,2,2,4
NULL,56315,2018-11-28T16:13:45Z,39,3,42
NULL,56322,2018-11-28T20:00:40Z,22,1,23
A-compiler;I-cleanup,56323,2018-11-28T20:09:14Z,0,0,0
NULL,56324,2018-11-28T20:43:45Z,158,111,269
"S-waiting-on-review,S-waiting-on-review,S-waiting-on-review,S-waiting-on-review,S-waiting-on-review,S-waiting-on-review,S-waiting-on-review,S-waiting-on-review,S-waiting-on-review,S-waiting-on-review,S-waiting-on-bors,S-waiting-on-review,S-waiting-on-bors;T-libs,S-waiting-on-review,S-waiting-on-review,S-waiting-on-review,S-waiting-on-review,S-waiting-on-review,S-waiting-on-review,S-waiting-on-review,S-waiting-on-bors,S-waiting-on-bors,S-waiting-on-review,S-waiting-on-review,S-waiting-on-review,S-waiting-on-review,S-waiting-on-review,S-waiting-on-bors,S-waiting-on-bors;beta-nominated,S-waiting-on-review,S-waiting-on-review",56325,2018-11-28T21:03:01Z,0,0,0
S-waiting-on-bors;beta-nominated,56329,2018-11-28T22:39:26Z,27,3,30
"T-rustdoc,S-waiting-on-review",56332,2018-11-29T00:32:20Z,164,26,190
NULL,56337,2018-11-29T08:10:39Z,165,122,287
"S-waiting-on-review,S-waiting-on-review,S-waiting-on-review,S-waiting-on-bors,S-waiting-on-review,S-waiting-on-review,S-waiting-on-review,S-waiting-on-review,S-waiting-on-bors,S-waiting-on-review,S-waiting-on-review,S-waiting-on-review,S-waiting-on-review,S-waiting-on-review,S-waiting-on-review,S-waiting-on-review,S-waiting-on-review,S-waiting-on-review;beta-nominated,S-waiting-on-review,S-waiting-on-bors,S-waiting-on-review",56340,2018-11-29T12:10:56Z,418,316,734
NULL,56349,2018-11-29T19:48:23Z,5,1,6
NULL,56351,2018-11-29T21:02:05Z,12,98,110
"S-waiting-on-bors;beta-nominated,S-waiting-on-review;beta-nominated,S-waiting-on-review;beta-nominated,S-waiting-on-review;beta-nominated",56352,2018-11-29T21:02:29Z,105,21,126
"S-waiting-on-review,S-waiting-on-review,S-waiting-on-review,S-waiting-on-review,S-waiting-on-review,S-waiting-on-review,S-waiting-on-review,S-waiting-on-review,S-waiting-on-bors,S-waiting-on-review,S-waiting-on-review,S-waiting-on-bors;T-libs",56353,2018-11-29T21:03:04Z,0,0,0
S-waiting-on-review,56357,2018-11-29T22:26:45Z,0,0,0
NULL,56358,2018-11-29T22:39:23Z,26,10,36
"C-tracking-issue;T-rustdoc,S-waiting-on-review",56359,2018-11-29T23:02:11Z,0,0,0
NULL,56362,2018-11-30T00:46:23Z,0,0,0
NULL,56364,2018-11-30T02:18:30Z,1,1,2
B-RFC-approved;C-tracking-issue;T-lang,56365,2018-11-30T03:10:58Z,29,141,170
B-RFC-approved;C-tracking-issue;T-lang,56366,2018-11-30T03:56:46Z,25,82,107
A-NLL;NLL-diagnostics,56372,2018-11-30T14:00:29Z,30,11,41
"S-waiting-on-review,S-waiting-on-bors;beta-accepted;beta-nominated,S-waiting-on-review,S-waiting-on-bors,S-waiting-on-review,S-waiting-on-review,S-waiting-on-bors;T-libs,S-waiting-on-bors,S-waiting-on-review,S-waiting-on-review,S-waiting-on-review,S-waiting-on-review,S-waiting-on-review,S-waiting-on-review,S-waiting-on-bors,S-waiting-on-review",56376,2018-11-30T15:39:02Z,0,0,0
S-waiting-on-bors;beta-accepted;beta-nominated,56380,2018-11-30T16:53:02Z,6,2,8
"S-waiting-on-bors,S-waiting-on-review,S-waiting-on-review,S-waiting-on-review,S-waiting-on-review,S-waiting-on-review,S-waiting-on-bors;beta-accepted;beta-nominated,S-waiting-on-review,S-waiting-on-bors,S-waiting-on-review,S-waiting-on-review,S-waiting-on-review,S-waiting-on-review,S-waiting-on-review,S-waiting-on-review,S-waiting-on-bors,S-waiting-on-review,S-waiting-on-bors;T-libs",56381,2018-11-30T17:06:11Z,1908,856,2764
"S-waiting-on-review,B-RFC-approved;T-lang",56384,2018-11-30T18:52:04Z,1311,293,1604
S-waiting-on-review;beta-nominated,56392,2018-11-30T23:06:28Z,212,70,282
T-libs,56395,2018-12-01T01:57:57Z,14,44,58
"S-waiting-on-review,S-waiting-on-review",56623,2018-12-08T07:43:52Z,195,85,280
NULL,56628,2018-12-08T11:30:04Z,0,0,0
NULL,56642,2018-12-09T10:34:32Z,16,95,111
NULL,56645,2018-12-09T14:54:59Z,228,51,279
A-macros,56647,2018-12-09T16:38:43Z,487,189,676
I-unsound%20%F0%9F%92%A5;P-medium;T-libs,56648,2018-12-09T18:10:01Z,117,57,174
T-compiler;WG-compiler-nll,56649,2018-12-09T18:23:22Z,300,184,484
NULL,56661,2018-12-10T02:58:12Z,39,0,39
S-waiting-on-review,56666,2018-12-10T08:09:46Z,88,119,207
A-lint,56677,2018-12-10T14:49:38Z,52,0,52
A-attributes;A-rustdoc;C-tracking-issue;T-dev-tools;T-doc;WG-docs-rustdoc,56679,2018-12-10T17:16:06Z,119,18,137
A-rustbuild;A-testsuite;C-bug,56680,2018-12-10T18:57:52Z,17,10,27
T-libs;disposition-merge;proposed-final-comment-period,56682,2018-12-10T20:06:57Z,1,1,2
"S-waiting-on-bors,S-waiting-on-bors,S-waiting-on-bors,S-waiting-on-bors",56688,2018-12-10T21:02:04Z,130,13,143
NULL,56691,2018-12-10T22:29:52Z,1,1,2
A-mir;I-ICE,56695,2018-12-10T23:29:27Z,41,1,42
NULL,56698,2018-12-11T00:05:40Z,0,0,0
S-waiting-on-review,56703,2018-12-11T03:35:36Z,3,2,5
A-const-eval;A-const-fn;C-tracking-issue;T-lang,56706,2018-12-11T09:28:56Z,33,131,164
S-waiting-on-review,56713,2018-12-11T14:09:37Z,5,0,5
I-crash;T-rustdoc,56722,2018-12-11T19:43:35Z,117,38,155
NULL,56725,2018-12-11T20:16:14Z,2,2,4
"S-waiting-on-review,S-waiting-on-review,S-waiting-on-review,S-waiting-on-bors,S-waiting-on-review,S-waiting-on-bors,S-waiting-on-bors,S-waiting-on-review,S-waiting-on-review",56728,2018-12-11T20:40:05Z,0,0,0
NULL,56739,2018-12-12T06:25:57Z,0,0,0
"S-waiting-on-bors,S-waiting-on-review,S-waiting-on-bors,S-waiting-on-bors,S-waiting-on-bors,S-waiting-on-review,S-waiting-on-review,S-waiting-on-review,S-waiting-on-review,S-waiting-on-review,S-waiting-on-review,S-waiting-on-bors,S-waiting-on-author,S-waiting-on-bors,S-waiting-on-review,S-waiting-on-review,S-waiting-on-review",56743,2018-12-12T14:06:05Z,0,0,0
A-diagnostics,56748,2018-12-12T16:05:31Z,7,5,12
S-waiting-on-review,56751,2018-12-12T17:43:43Z,1,1,2
NULL,56755,2018-12-12T21:59:04Z,75,11,86
NULL,56756,2018-12-12T22:21:38Z,18,3,21
"S-waiting-on-review,S-waiting-on-review,S-waiting-on-review,S-waiting-on-review,S-waiting-on-bors,S-waiting-on-author,S-waiting-on-review,S-waiting-on-review,S-waiting-on-crater,S-waiting-on-review,S-waiting-on-review,S-waiting-on-bors,A-NLL;A-closures;A-lifetimes;S-waiting-on-review,S-waiting-on-bors",56757,2018-12-12T22:34:41Z,0,0,0
beta-nominated,56759,2018-12-12T23:48:04Z,229,263,492
NULL,56760,2018-12-12T23:59:29Z,30,5,35
NULL,56761,2018-12-13T00:55:19Z,28,2,30
A-linkage;T-compiler,56771,2018-12-13T11:04:17Z,0,0,0
A-linkage;T-compiler,56772,2018-12-13T11:06:31Z,5,0,5
"S-waiting-on-crater,S-waiting-on-review,S-waiting-on-review,S-waiting-on-bors,S-waiting-on-review,A-NLL;A-closures;A-lifetimes;S-waiting-on-review,S-waiting-on-bors,S-waiting-on-review,S-waiting-on-review,S-waiting-on-review,S-waiting-on-review,S-waiting-on-review,S-waiting-on-bors,S-waiting-on-author,S-waiting-on-review,S-waiting-on-review",56773,2018-12-13T11:59:44Z,0,0,0
"S-waiting-on-bors,S-waiting-on-review,S-waiting-on-review,S-waiting-on-review,S-waiting-on-review,S-waiting-on-review,S-waiting-on-review,S-waiting-on-review,S-waiting-on-review,S-waiting-on-review,S-waiting-on-review,S-waiting-on-bors,S-waiting-on-author,S-waiting-on-review,S-waiting-on-review,S-waiting-on-crater,S-waiting-on-review,S-waiting-on-review,S-waiting-on-review,S-waiting-on-review,S-waiting-on-bors,S-waiting-on-review,S-waiting-on-review,S-waiting-on-bors,S-waiting-on-bors,A-NLL;A-closures;A-lifetimes;S-waiting-on-review",56775,2018-12-13T12:54:42Z,0,0,0
S-waiting-on-review,56778,2018-12-13T14:23:22Z,1,1,2
NULL,56779,2018-12-13T14:41:00Z,78,28,106
NULL,56781,2018-12-13T15:39:00Z,2,2,4
NULL,56787,2018-12-13T18:56:20Z,0,0,0
A-borrow-checker;I-unsound,56790,2018-12-13T21:03:36Z,73,24,97
NULL,56792,2018-12-13T21:13:09Z,40,0,40
NULL,56793,2018-12-13T21:30:07Z,88,16,104
B-RFC-approved;T-libs,56796,2018-12-13T21:57:19Z,40,3,43
NULL,56802,2018-12-14T04:28:26Z,107,6,113
"S-waiting-on-review,S-waiting-on-review,S-waiting-on-review,S-waiting-on-review,S-waiting-on-crater,S-waiting-on-review,S-waiting-on-review,S-waiting-on-review,S-waiting-on-review,S-waiting-on-bors,S-waiting-on-review,S-waiting-on-review,S-waiting-on-review,S-waiting-on-bors,S-waiting-on-review,A-NLL;A-closures;A-lifetimes;S-waiting-on-review,S-waiting-on-review,S-waiting-on-review,S-waiting-on-bors,S-waiting-on-review,S-waiting-on-review,S-waiting-on-review,S-waiting-on-review,S-waiting-on-review,S-waiting-on-review,S-waiting-on-review,S-waiting-on-review,S-waiting-on-review,S-waiting-on-review,S-waiting-on-bors,S-waiting-on-author",56803,2018-12-14T04:30:43Z,0,0,0
"S-waiting-on-review,T-lang;disposition-merge;proposed-final-comment-period",56805,2018-12-14T06:05:24Z,244,100,344
A-mir;I-enhancement,56810,2018-12-14T10:11:11Z,339,69,408
A-NLL;E-mentor;NLL-diagnostics,56811,2018-12-14T10:49:50Z,0,0,0
"S-waiting-on-bors,S-waiting-on-review,S-waiting-on-review,S-waiting-on-review,S-waiting-on-review,S-waiting-on-review,S-waiting-on-review,S-waiting-on-review,S-waiting-on-bors,S-waiting-on-review,S-waiting-on-review,S-waiting-on-review,S-waiting-on-review,S-waiting-on-review",56816,2018-12-14T14:10:22Z,0,0,0
"A-NLL;A-closures;A-lifetimes;S-waiting-on-review,S-waiting-on-review,S-waiting-on-bors,S-waiting-on-review,S-waiting-on-review,S-waiting-on-review,S-waiting-on-review,S-waiting-on-review,S-waiting-on-review,S-waiting-on-review,S-waiting-on-review,S-waiting-on-review,S-waiting-on-bors,S-waiting-on-author,S-waiting-on-review,S-waiting-on-review,S-waiting-on-review,S-waiting-on-crater,S-waiting-on-review,S-waiting-on-review,S-waiting-on-review,S-waiting-on-bors,S-waiting-on-review",56817,2018-12-14T14:13:13Z,0,0,0
"S-waiting-on-bors,S-waiting-on-review,S-waiting-on-review,S-waiting-on-review,S-waiting-on-review,S-waiting-on-bors,S-waiting-on-review,S-waiting-on-review,S-waiting-on-review,S-waiting-on-review,S-waiting-on-review,S-waiting-on-review,S-waiting-on-review",56818,2018-12-14T14:15:32Z,335,100,435
NULL,56819,2018-12-14T14:57:57Z,3,3,6
S-waiting-on-review,56825,2018-12-14T17:06:39Z,6,1,7
NULL,56827,2018-12-14T21:37:11Z,30,6,36
"S-waiting-on-review,S-waiting-on-review,S-waiting-on-bors,S-waiting-on-author,S-waiting-on-review,S-waiting-on-review,S-waiting-on-review,S-waiting-on-crater,S-waiting-on-review,S-waiting-on-review,S-waiting-on-bors,S-waiting-on-review,A-NLL;A-closures;A-lifetimes;S-waiting-on-review,S-waiting-on-review,S-waiting-on-bors,S-waiting-on-review,S-waiting-on-review,S-waiting-on-review,S-waiting-on-review,S-waiting-on-review,S-waiting-on-review,S-waiting-on-review,S-waiting-on-review",56830,2018-12-14T22:18:55Z,0,0,0
A-amusing,56837,2018-12-15T01:22:42Z,815,453,1268
I-ICE;T-rustdoc,56838,2018-12-15T02:33:52Z,36,2,38
"S-waiting-on-bors,S-waiting-on-review,A-NLL;A-closures;A-lifetimes;S-waiting-on-review,S-waiting-on-review,S-waiting-on-review,S-waiting-on-review,S-waiting-on-review,S-waiting-on-review,S-waiting-on-review,S-waiting-on-review,S-waiting-on-author,S-waiting-on-review,S-waiting-on-review,S-waiting-on-review",56840,2018-12-15T09:17:44Z,419,96,515
S-waiting-on-review,56841,2018-12-15T10:02:54Z,94,0,94
NULL,56842,2018-12-15T10:38:11Z,248,1,249
A-NLL;E-mentor;NLL-diagnostics,56843,2018-12-15T11:02:30Z,94,95,189
S-waiting-on-review,56844,2018-12-15T11:42:39Z,1,1,2
S-waiting-on-review,56845,2018-12-15T12:28:15Z,53,4,57
"S-waiting-on-bors,S-waiting-on-review,S-waiting-on-review,S-waiting-on-review,S-waiting-on-bors,S-waiting-on-crater,S-waiting-on-review",56846,2018-12-15T13:47:42Z,233,20,253
S-waiting-on-review,56847,2018-12-15T13:59:22Z,7,25,32
S-waiting-on-author,56851,2018-12-15T15:28:22Z,0,0,0
I-nominated;T-infra,56852,2018-12-15T15:46:17Z,14,0,14
"A-diagnostics;A-tools;I-wrong;P-low,S-waiting-on-review,A-diagnostics;A-tools;I-wrong;P-low",56853,2018-12-15T16:32:52Z,1,1,2
NULL,56855,2018-12-15T16:37:40Z,1,14,15
S-waiting-on-author,56856,2018-12-15T17:41:09Z,0,0,0
T-doc,56858,2018-12-15T17:52:55Z,1,1,2
S-waiting-on-author,56859,2018-12-15T17:57:48Z,0,0,0
NULL,56863,2018-12-15T22:02:52Z,193,3,196
S-waiting-on-review,56864,2018-12-15T23:07:45Z,366,2624,2990
"S-waiting-on-review,S-waiting-on-review,NLL-sound;S-waiting-on-author;beta-nominated,S-waiting-on-review,S-waiting-on-review,S-waiting-on-review,S-waiting-on-review,S-waiting-on-review,S-waiting-on-review,S-waiting-on-review,S-waiting-on-review,S-waiting-on-bors,S-waiting-on-review,S-waiting-on-review,S-waiting-on-review,S-waiting-on-review,S-waiting-on-bors,S-waiting-on-author,S-waiting-on-review,S-waiting-on-bors;T-compiler;beta-nominated,S-waiting-on-review",56873,2018-12-16T10:57:24Z,0,0,0
"S-waiting-on-review,S-waiting-on-review,S-waiting-on-review,S-waiting-on-bors,S-waiting-on-review,S-waiting-on-review,S-waiting-on-review,S-waiting-on-review,S-waiting-on-author,S-waiting-on-review,S-waiting-on-bors;T-compiler;beta-nominated,S-waiting-on-review,S-waiting-on-review,S-waiting-on-review,S-waiting-on-review,NLL-sound;S-waiting-on-author;beta-nominated,S-waiting-on-review,S-waiting-on-review,S-waiting-on-review,S-waiting-on-review",56875,2018-12-16T13:08:42Z,649,836,1485
NULL,56884,2018-12-16T18:26:08Z,562,131,693
NULL,56886,2018-12-16T19:06:55Z,0,0,0
NULL,56890,2018-12-16T20:14:01Z,0,0,0
NULL,56892,2018-12-16T21:28:54Z,14,17,31
NULL,56893,2018-12-16T21:34:01Z,4,4,8
NULL,56896,2018-12-16T22:43:18Z,0,0,0
NULL,56904,2018-12-17T00:38:38Z,2,13,15
NULL,56909,2018-12-17T04:06:20Z,30,4,34
A-diagnostics;A-parser,56910,2018-12-17T04:21:38Z,28,1,29
NULL,56919,2018-12-17T15:48:12Z,16,2,18
"S-waiting-on-bors;T-compiler;beta-nominated,S-waiting-on-review,S-waiting-on-review,S-waiting-on-review",56930,2018-12-17T21:52:30Z,92,57,149
NULL,56932,2018-12-17T22:12:00Z,4032,3862,7894
B-RFC-approved;T-libs,56936,2018-12-18T00:45:02Z,143,121,264
T-libs,56939,2018-12-18T02:17:48Z,70,74,144
NULL,56941,2018-12-18T02:48:12Z,24,3,27
S-waiting-on-review,56944,2018-12-18T05:13:45Z,18,240,258
S-waiting-on-review,56947,2018-12-18T08:34:32Z,114,2,116
NULL,56953,2018-12-18T14:53:02Z,51,43,94
NULL,56955,2018-12-18T19:28:34Z,0,0,0
"S-waiting-on-bors,S-waiting-on-bors,S-waiting-on-bors",56960,2018-12-18T22:03:34Z,5,2,7
"S-waiting-on-bors,S-waiting-on-bors,S-waiting-on-bors",56961,2018-12-18T22:07:24Z,5,2,7
NULL,56962,2018-12-18T22:11:28Z,54,94,148
A-diagnostics,56966,2018-12-18T23:44:12Z,49,7,56
T-rustdoc,56967,2018-12-18T23:52:04Z,2,2,4
NULL,56968,2018-12-19T01:20:16Z,0,0,0
"S-waiting-on-bors,S-waiting-on-review,S-waiting-on-review,S-waiting-on-review,S-waiting-on-review,S-waiting-on-review,S-waiting-on-review,S-waiting-on-review,S-waiting-on-review,S-waiting-on-review,S-waiting-on-bors;T-release;beta-accepted,S-waiting-on-review,S-waiting-on-review,S-waiting-on-review,S-waiting-on-review,S-waiting-on-bors",56977,2018-12-19T10:47:24Z,471,255,726
S-waiting-on-review,56978,2018-12-19T11:59:52Z,360,77,437
NULL,56986,2018-12-19T16:28:34Z,15,15,30
I-ICE,56988,2018-12-19T18:32:46Z,103,28,131
NULL,56990,2018-12-19T19:08:33Z,0,0,0
NULL,56992,2018-12-19T20:07:00Z,69,47,116
NULL,56996,2018-12-19T21:44:29Z,27,9,36
NULL,56998,2018-12-19T23:22:39Z,0,0,0
NULL,57002,2018-12-20T06:01:52Z,2,7,9
S-waiting-on-review,57004,2018-12-20T09:12:34Z,148,341,489
"S-waiting-on-review,S-waiting-on-review,S-waiting-on-review,S-waiting-on-review,S-waiting-on-review,S-waiting-on-review,S-waiting-on-bors,S-waiting-on-review,S-waiting-on-review;T-libs,S-waiting-on-review,S-waiting-on-review;beta-nominated,S-waiting-on-review,S-waiting-on-review,S-waiting-on-review,S-waiting-on-review,S-waiting-on-review,S-waiting-on-bors,S-waiting-on-review",57005,2018-12-20T11:09:17Z,0,0,0
NULL,57008,2018-12-20T14:06:10Z,60,7,67
S-waiting-on-review,57010,2018-12-20T15:06:52Z,2,1,3
T-rustdoc;regression-from-stable-to-beta,57019,2018-12-20T21:24:39Z,48,3,51
NULL,57021,2018-12-20T23:37:39Z,20,24,44
"S-waiting-on-review,S-waiting-on-review;beta-nominated,S-waiting-on-review,S-waiting-on-review,S-waiting-on-review,S-waiting-on-review,S-waiting-on-review,S-waiting-on-review,S-waiting-on-review,S-waiting-on-bors,S-waiting-on-review,S-waiting-on-review,S-waiting-on-review,S-waiting-on-review,S-waiting-on-review;relnotes,S-waiting-on-review,S-waiting-on-bors,S-waiting-on-review,S-waiting-on-review",57022,2018-12-21T00:18:42Z,0,0,0
"S-waiting-on-review,S-waiting-on-review,S-waiting-on-review,S-waiting-on-review,S-waiting-on-review,S-waiting-on-review,S-waiting-on-review,S-waiting-on-review,S-waiting-on-bors,S-waiting-on-review,S-waiting-on-review,S-waiting-on-review;beta-nominated,S-waiting-on-review,S-waiting-on-review,S-waiting-on-review,S-waiting-on-review,S-waiting-on-review,S-waiting-on-review,S-waiting-on-review;T-libs",57025,2018-12-21T08:24:14Z,0,0,0
NULL,57033,2018-12-21T10:48:42Z,10,44,54
S-waiting-on-review;T-libs;disposition-merge;proposed-final-comment-period,57040,2018-12-21T13:38:53Z,1,1,2
I-ICE;T-compiler,57042,2018-12-21T14:10:41Z,5,1,6
NULL,57044,2018-12-21T14:26:28Z,149,123,272
NULL,57048,2018-12-21T17:07:43Z,0,0,0
B-RFC-approved;B-unstable;T-lang,57049,2018-12-21T18:19:57Z,18,91,109
S-waiting-on-review,57052,2018-12-21T20:30:16Z,3,3,6
NULL,57053,2018-12-21T22:18:07Z,93,3,96
"S-waiting-on-bors,S-waiting-on-bors,S-waiting-on-review,S-waiting-on-review,S-waiting-on-review,S-waiting-on-review;beta-nominated,S-waiting-on-review,S-waiting-on-review,S-waiting-on-review,S-waiting-on-review,S-waiting-on-review;relnotes,S-waiting-on-bors,S-waiting-on-review,S-waiting-on-review,S-waiting-on-bors,S-waiting-on-review,S-waiting-on-review,S-waiting-on-review;T-libs,S-waiting-on-review,S-waiting-on-bors,S-waiting-on-review,S-waiting-on-review,S-waiting-on-review,S-waiting-on-review,S-waiting-on-review,S-waiting-on-review,S-waiting-on-bors,S-waiting-on-review,S-waiting-on-bors,S-waiting-on-review,S-waiting-on-bors,S-waiting-on-review,S-waiting-on-review,S-waiting-on-review,S-waiting-on-review,S-waiting-on-review,S-waiting-on-bors;T-compiler;beta-nominated",57058,2018-12-22T03:09:37Z,0,0,0
NULL,57060,2018-12-22T11:45:02Z,12,1,13
"S-waiting-on-review,S-waiting-on-review,S-waiting-on-review,S-waiting-on-bors,S-waiting-on-review,S-waiting-on-review,S-waiting-on-review,S-waiting-on-bors,S-waiting-on-review,S-waiting-on-bors,S-waiting-on-review,S-waiting-on-bors,S-waiting-on-review,S-waiting-on-review,S-waiting-on-review,S-waiting-on-review,S-waiting-on-bors,S-waiting-on-review,S-waiting-on-review,S-waiting-on-review;beta-nominated,S-waiting-on-review,S-waiting-on-review,S-waiting-on-review,S-waiting-on-review",57063,2018-12-22T16:08:04Z,869,450,1319
S-waiting-on-review,57065,2018-12-22T17:04:49Z,117,113,230
A-const-eval;A-const-fn;C-tracking-issue;T-lang,57067,2018-12-22T18:08:02Z,79,184,263
S-waiting-on-review,57070,2018-12-23T01:03:04Z,0,0,0
A-diagnostics,57073,2018-12-23T05:21:26Z,0,0,0
"S-waiting-on-review,S-waiting-on-review,S-waiting-on-review,S-waiting-on-bors,S-waiting-on-review,S-waiting-on-review,S-waiting-on-bors;T-compiler;beta-nominated,S-waiting-on-review,S-waiting-on-bors",57075,2018-12-23T10:07:58Z,0,0,0
"A-runtime;I-crash;I-wrong,S-waiting-on-review,A-codegen;I-ICE",57079,2018-12-23T13:03:44Z,1,1,2
NULL,57082,2018-12-23T13:19:43Z,1,1,2
"S-waiting-on-review,S-waiting-on-bors;T-compiler;beta-nominated,S-waiting-on-review,S-waiting-on-bors,S-waiting-on-review,S-waiting-on-review,S-waiting-on-review,S-waiting-on-review,S-waiting-on-bors,S-waiting-on-review",57083,2018-12-23T13:47:16Z,0,0,0
"S-waiting-on-bors,S-waiting-on-review,S-waiting-on-review,S-waiting-on-review,S-waiting-on-review,S-waiting-on-review,S-waiting-on-bors,S-waiting-on-review,S-waiting-on-review,S-waiting-on-review,S-waiting-on-bors;T-compiler;beta-nominated,S-waiting-on-review,S-waiting-on-review,S-waiting-on-review;relnotes",57087,2018-12-23T22:09:17Z,721,489,1210
"S-waiting-on-bors,S-waiting-on-review,S-waiting-on-review,S-waiting-on-review,S-waiting-on-review,S-waiting-on-review,S-waiting-on-review,S-waiting-on-review,S-waiting-on-bors",57091,2018-12-24T10:16:36Z,0,0,0
"S-waiting-on-review,S-waiting-on-review,S-waiting-on-review,S-waiting-on-review,S-waiting-on-review,S-waiting-on-bors,S-waiting-on-review,S-waiting-on-review,S-waiting-on-review",57092,2018-12-24T10:36:01Z,0,0,0
"S-waiting-on-bors,S-waiting-on-review,S-waiting-on-review,S-waiting-on-review,S-waiting-on-review,S-waiting-on-review,S-waiting-on-review,S-waiting-on-review,S-waiting-on-review,S-waiting-on-review",57094,2018-12-24T12:29:39Z,515,379,894
NULL,57099,2018-12-24T14:30:31Z,49,39,88
NULL,57101,2018-12-24T15:57:49Z,26,21,47
A-NLL;NLL-diagnostics;P-low,57102,2018-12-24T16:13:24Z,366,153,519
NULL,57105,2018-12-24T18:50:48Z,0,0,0
NULL,57107,2018-12-24T23:12:24Z,36,0,36
S-waiting-on-review,57116,2018-12-25T05:29:42Z,240,18,258
NULL,57121,2018-12-25T12:02:13Z,59,95,154
S-waiting-on-bors,57124,2018-12-25T21:27:49Z,5,8,13
NULL,57125,2018-12-26T05:27:07Z,20,9,29
S-waiting-on-review,57130,2018-12-26T12:48:18Z,134,20,154
NULL,57132,2018-12-26T17:25:36Z,1,1,2
S-waiting-on-review,57138,2018-12-26T20:51:31Z,1,1,2
NULL,57139,2018-12-26T22:35:55Z,0,0,0
A-diagnostics;E-easy;T-dev-tools,57140,2018-12-27T04:43:23Z,61,37,98
E-medium;E-mentor,57150,2018-12-27T16:25:30Z,0,0,0
A-macros;C-bug,57155,2018-12-27T22:27:25Z,154,13,167
NULL,57158,2018-12-28T01:06:36Z,172,61,233
T-lang,57159,2018-12-28T01:25:40Z,23,23,46
"S-waiting-on-review,A-const-fn;E-easy",57167,2018-12-28T12:14:59Z,10,1,11
S-waiting-on-review,57173,2018-12-28T16:43:30Z,0,0,0
NULL,57184,2018-12-28T23:53:44Z,1,2,3
A-resolve;I-ICE,57185,2018-12-29T00:12:00Z,33,26,59
NULL,57192,2018-12-29T07:12:38Z,7,7,14
T-doc,57195,2018-12-29T07:58:21Z,9,0,9
"S-waiting-on-review,S-waiting-on-review,S-waiting-on-review,S-waiting-on-review,S-waiting-on-review,S-waiting-on-review,S-waiting-on-review",57197,2018-12-29T10:50:33Z,29,30,59
I-unsound%20%F0%9F%92%A5;T-compiler,57202,2018-12-29T17:52:37Z,229,37,266
NULL,57204,2018-12-29T22:49:33Z,5,3,8
NULL,57205,2018-12-29T23:04:07Z,74,47,121
NULL,57208,2018-12-30T01:21:05Z,30,2,32
S-waiting-on-review,57213,2018-12-30T11:39:24Z,1,1,2
NULL,57222,2018-12-30T21:46:46Z,0,0,0
NULL,57228,2018-12-31T03:34:21Z,0,0,0
NULL,57229,2018-12-31T05:03:30Z,37,5,42
A-diagnostics;C-enhancement,57230,2018-12-31T06:03:48Z,199,156,355
NULL,57233,2018-12-31T12:02:24Z,12,13,25
S-waiting-on-review;T-lang;T-libs;relnotes,57234,2018-12-31T15:44:06Z,669,198,867
"S-waiting-on-review;beta-nominated,S-waiting-on-review;T-compiler;beta-nominated,S-waiting-on-author",57236,2018-12-31T17:43:56Z,446,66,512
S-waiting-on-review,57238,2018-12-31T21:08:50Z,10,1,11
NULL,57243,2019-01-01T00:35:29Z,19,12,31
S-waiting-on-review,57244,2019-01-01T01:11:02Z,0,0,0
NULL,57249,2019-01-01T17:55:15Z,149,149,298
NULL,57250,2019-01-01T19:35:39Z,105,105,210
NULL,57251,2019-01-01T21:01:23Z,15,2,17
S-waiting-on-review,57253,2019-01-02T00:46:38Z,123,18,141
NULL,57263,2019-01-02T10:07:09Z,15,15,30
NULL,57268,2019-01-02T15:31:59Z,117,8,125
S-waiting-on-review,57278,2019-01-02T19:07:11Z,1,1,2
NULL,57282,2019-01-02T20:03:32Z,40,2,42
"A-NLL;P-high;T-compiler;regression-from-stable-to-nightly,S-waiting-on-review",57285,2019-01-02T21:06:31Z,0,0,0
"S-waiting-on-bors,S-waiting-on-review,S-waiting-on-review",57286,2019-01-02T21:10:14Z,30,204,234
"S-waiting-on-review,regression-from-stable-to-nightly",57287,2019-01-02T21:27:17Z,32,10,42
A-incr-comp,57290,2019-01-02T22:11:41Z,0,3,3
NULL,57292,2019-01-02T23:51:47Z,1,1,2
S-waiting-on-review,57293,2019-01-02T23:57:06Z,168,55,223
A-diagnostics,57294,2019-01-03T00:45:26Z,668,226,894
S-waiting-on-review,57297,2019-01-03T06:23:59Z,0,0,0
T-dev-tools;stable-nominated,57300,2019-01-03T10:32:23Z,1,1,2
NULL,57302,2019-01-03T14:26:24Z,15,23,38
"S-waiting-on-review,A-typesystem;I-papercut",57303,2019-01-03T14:32:59Z,40,39,79
A-NLL;P-high;T-compiler;regression-from-stable-to-nightly,57304,2019-01-03T14:44:27Z,106,4,110
"S-waiting-on-review;beta-nominated,S-waiting-on-review,S-waiting-on-bors;T-compiler;beta-nominated,S-waiting-on-review;beta-nominated,S-waiting-on-review,S-waiting-on-review",57305,2019-01-03T16:10:43Z,375,57,432
"S-waiting-on-review,S-waiting-on-review,S-waiting-on-review,S-waiting-on-review,S-waiting-on-review,S-waiting-on-review,S-waiting-on-review,S-waiting-on-review,S-waiting-on-review,S-waiting-on-bors,S-waiting-on-review,S-waiting-on-review,S-waiting-on-review,S-waiting-on-review,S-waiting-on-review,S-waiting-on-review,S-waiting-on-review,S-waiting-on-review,S-waiting-on-review,S-waiting-on-review",57309,2019-01-03T18:40:36Z,0,0,0
NULL,57313,2019-01-03T20:08:40Z,15,5,20
S-waiting-on-review,57314,2019-01-03T20:37:47Z,32,32,64
B-RFC-approved;C-tracking-issue;T-libs,57322,2019-01-04T00:52:13Z,1,6,7
"S-waiting-on-review,S-waiting-on-review",57324,2019-01-04T02:47:43Z,0,0,0
B-RFC-approved;C-tracking-issue;T-lang,57332,2019-01-04T07:16:42Z,16,110,126
NULL,57333,2019-01-04T14:03:59Z,0,0,0
NULL,57335,2019-01-04T14:28:17Z,0,0,0
"S-waiting-on-bors,S-waiting-on-bors,S-waiting-on-bors,S-waiting-on-review,S-waiting-on-bors,S-waiting-on-bors",57336,2019-01-04T15:32:09Z,1,1,2
NULL,57338,2019-01-04T16:03:04Z,9,2,11
NULL,57340,2019-01-04T17:18:21Z,12,12,24
NULL,57344,2019-01-04T20:49:55Z,78,11,89
NULL,57346,2019-01-04T21:59:05Z,0,0,0
NULL,57350,2019-01-05T04:42:10Z,34,0,34
NULL,57351,2019-01-05T12:05:47Z,36,14,50
A-traits,57352,2019-01-05T14:27:00Z,145,4,149
"S-waiting-on-review,S-waiting-on-review,S-waiting-on-bors,S-waiting-on-review,S-waiting-on-author,S-waiting-on-review,S-waiting-on-review,S-waiting-on-review,S-waiting-on-review,S-waiting-on-review,S-waiting-on-review,S-waiting-on-bors,S-waiting-on-review,S-waiting-on-bors,S-waiting-on-review,S-waiting-on-review,S-waiting-on-review",57354,2019-01-05T15:57:07Z,296,339,635
NULL,57355,2019-01-05T17:19:47Z,47,9,56
NULL,57357,2019-01-05T17:43:13Z,22,16,38
S-waiting-on-review,57359,2019-01-05T21:06:14Z,0,0,0
"S-waiting-on-review,S-waiting-on-review",57360,2019-01-05T23:12:40Z,0,0,0
NULL,57364,2019-01-06T00:32:01Z,131,21,152
A-diagnostics,57366,2019-01-06T01:09:42Z,194,80,274
"S-waiting-on-crater;S-waiting-on-team;T-lang,B-unstable;C-tracking-issue;T-lang",57367,2019-01-06T01:52:50Z,108,87,195
A-rustdoc,57371,2019-01-06T07:06:36Z,0,0,0
"S-waiting-on-review,A-spurious;C-tracking-issue;T-infra",57380,2019-01-06T19:05:45Z,83,44,127
A-diagnostics,57381,2019-01-06T21:39:05Z,331,28,359
A-diagnostics,57387,2019-01-06T22:10:35Z,372,373,745
NULL,57388,2019-01-06T22:12:57Z,127,297,424
NULL,57395,2019-01-07T05:36:44Z,0,0,0
NULL,57397,2019-01-07T10:32:22Z,0,0,0
NULL,57400,2019-01-07T13:16:18Z,18,141,159
"S-waiting-on-bors,S-waiting-on-review,S-waiting-on-review,S-waiting-on-review,S-waiting-on-bors,S-waiting-on-review,S-waiting-on-review,S-waiting-on-review",57405,2019-01-07T15:25:43Z,72,26,98
NULL,57408,2019-01-07T16:12:39Z,0,0,0
S-waiting-on-review,57412,2019-01-07T17:37:09Z,46,46,92
S-waiting-on-review,57416,2019-01-07T19:27:09Z,4,15991,15995
"A-doctests;C-feature-request;T-rustdoc,T-rustdoc;regression-from-stable-to-beta",57417,2019-01-07T19:29:06Z,48,3,51
C-cleanup;I-compiletime;T-compiler,57418,2019-01-07T19:36:29Z,3,14,17
NULL,57419,2019-01-07T19:47:54Z,2,2,4
"B-RFC-approved;T-libs,B-unstable;T-libs;disposition-merge;proposed-final-comment-period",57425,2019-01-07T20:46:25Z,96,55,151
S-waiting-on-review,57429,2019-01-07T21:50:28Z,8,8,16
S-waiting-on-bors,57435,2019-01-08T06:15:54Z,16,16,32
S-waiting-on-bors,57436,2019-01-08T09:01:28Z,14,3,17
S-waiting-on-review,57441,2019-01-08T13:15:18Z,82,11,93
NULL,57442,2019-01-08T13:21:09Z,71,80,151
NULL,57449,2019-01-08T19:38:18Z,0,0,0
NULL,57450,2019-01-08T19:59:29Z,2,3,5
NULL,57465,2019-01-09T08:34:38Z,8,56,64
NULL,57467,2019-01-09T11:58:43Z,58,21,79
NULL,57474,2019-01-09T17:48:03Z,5,3,8
B-RFC-approved;C-tracking-issue;T-libs,57475,2019-01-09T18:48:38Z,42,24,66
"S-waiting-on-review,S-waiting-on-bors",57476,2019-01-09T18:58:18Z,30,65,95
A-diagnostics,57477,2019-01-09T19:12:49Z,249,125,374
"S-waiting-on-review;beta-nominated,S-waiting-on-review",57483,2019-01-10T00:12:35Z,299,337,636
NULL,57494,2019-01-10T19:15:39Z,23,8,31
S-waiting-on-review,57495,2019-01-10T19:39:25Z,270,25,295
A-docs,57496,2019-01-10T20:21:32Z,15,20,35
NULL,57498,2019-01-10T20:31:02Z,2,0,2
T-doc,57499,2019-01-10T20:40:30Z,6,2,8
S-waiting-on-review,57501,2019-01-10T22:00:24Z,225,103,328
"S-waiting-on-review,S-waiting-on-review,S-waiting-on-review,S-waiting-on-review,S-waiting-on-review,S-waiting-on-review,S-waiting-on-review,S-waiting-on-review,S-waiting-on-review,S-waiting-on-review,S-waiting-on-review,S-waiting-on-review,S-waiting-on-review,S-waiting-on-review,S-waiting-on-review,S-waiting-on-review,S-waiting-on-review,S-waiting-on-review",57503,2019-01-10T22:41:30Z,0,0,0
NULL,57504,2019-01-10T23:02:39Z,1,2,3
NULL,57506,2019-01-11T01:58:08Z,0,0,0
NULL,57508,2019-01-11T02:25:16Z,37,5,42
"S-waiting-on-review;T-lang,S-waiting-on-review;T-lang;T-libs;disposition-merge;proposed-final-comment-period",57513,2019-01-11T12:04:44Z,0,0,0
A-build;A-linkage;A-rustbuild;E-help-wanted;T-compiler;T-infra,57514,2019-01-11T13:01:23Z,175,21,196
"S-waiting-on-review;T-release;beta-accepted;beta-nominated,S-waiting-on-review;beta-nominated,S-waiting-on-crater,S-waiting-on-review;beta-nominated",57516,2019-01-11T15:59:20Z,620,346,966
NULL,57522,2019-01-11T18:01:30Z,12,5,17
C-tracking-issue;T-lang;disposition-merge;proposed-final-comment-period,57532,2019-01-11T23:05:19Z,18,44,62
"S-waiting-on-review,B-RFC-approved;T-lang",57535,2019-01-12T03:11:46Z,176,239,415
I-slow,57537,2019-01-12T04:58:01Z,130,5,135
NULL,57538,2019-01-12T06:13:50Z,63,1,64
A-diagnostics;A-parser;C-enhancement,57540,2019-01-12T07:20:58Z,344,141,485
"S-waiting-on-review,S-waiting-on-review,S-waiting-on-review,S-waiting-on-bors;T-lang;relnotes,S-waiting-on-review,S-waiting-on-review,S-waiting-on-review,S-waiting-on-review,S-waiting-on-review,S-waiting-on-review,S-waiting-on-bors,S-waiting-on-review,S-waiting-on-review,S-waiting-on-review,S-waiting-on-review;T-lang,S-waiting-on-review,S-waiting-on-review,S-waiting-on-review,S-waiting-on-review,S-waiting-on-review,S-waiting-on-bors,S-waiting-on-review,S-waiting-on-review,S-waiting-on-review",57542,2019-01-12T09:55:26Z,999,1485,2484
NULL,57545,2019-01-12T14:16:52Z,0,0,0
NULL,57546,2019-01-12T14:24:37Z,0,0,0
S-waiting-on-crater,57549,2019-01-12T18:21:12Z,25,25,50
NULL,57551,2019-01-12T21:16:36Z,26,0,26
"S-waiting-on-review,S-waiting-on-review,S-waiting-on-review,S-waiting-on-review,S-waiting-on-bors,S-waiting-on-review,S-waiting-on-review,S-waiting-on-review,S-waiting-on-review,S-waiting-on-review,S-waiting-on-review,S-waiting-on-review,S-waiting-on-review,S-waiting-on-review",57554,2019-01-12T21:33:48Z,0,0,0
NULL,57556,2019-01-12T21:49:49Z,23,3,26
NULL,57557,2019-01-12T22:51:40Z,69,0,69
C-bug;T-compiler,57560,2019-01-12T23:35:28Z,28,9,37
"S-waiting-on-review,S-waiting-on-bors,S-waiting-on-review,S-waiting-on-review,S-waiting-on-review,S-waiting-on-review,S-waiting-on-review,S-waiting-on-review,S-waiting-on-review,S-waiting-on-review,S-waiting-on-review,S-waiting-on-review,S-waiting-on-review,S-waiting-on-review",57561,2019-01-13T01:07:22Z,0,0,0
NULL,57564,2019-01-13T01:56:59Z,14,15,29
NULL,57565,2019-01-13T02:09:06Z,20,79,99
T-lang;T-libs;disposition-merge;proposed-final-comment-period,57566,2019-01-13T03:06:17Z,58,30,88
NULL,57567,2019-01-13T03:39:12Z,2,9,11
"S-waiting-on-review,S-waiting-on-review,S-waiting-on-review,S-waiting-on-bors,S-waiting-on-review,S-waiting-on-review,S-waiting-on-bors,S-waiting-on-review,S-waiting-on-review,S-waiting-on-review,S-waiting-on-review,S-waiting-on-review,S-waiting-on-review,S-waiting-on-review,S-waiting-on-review",57568,2019-01-13T04:27:03Z,353,186,539
NULL,57572,2019-01-13T13:23:05Z,62,233,295
"S-waiting-on-review,S-waiting-on-review",57573,2019-01-13T14:27:10Z,117,110,227
"S-waiting-on-review,S-waiting-on-review,S-waiting-on-review,S-waiting-on-review,S-waiting-on-review,S-waiting-on-review,S-waiting-on-review,S-waiting-on-review",57574,2019-01-13T15:04:27Z,0,0,0
"S-waiting-on-review,S-waiting-on-review,S-waiting-on-review,S-waiting-on-review,S-waiting-on-review,S-waiting-on-review,S-waiting-on-review",57575,2019-01-13T15:06:36Z,0,0,0
"S-waiting-on-review,S-waiting-on-review,S-waiting-on-review,S-waiting-on-review,S-waiting-on-review,S-waiting-on-review",57576,2019-01-13T15:09:52Z,0,0,0
"S-waiting-on-review,S-waiting-on-review,S-waiting-on-review,S-waiting-on-review",57577,2019-01-13T16:21:44Z,601,579,1180
NULL,57578,2019-01-13T16:27:14Z,0,0,0
"S-waiting-on-review,S-waiting-on-review,S-waiting-on-review,S-waiting-on-review,S-waiting-on-review",57580,2019-01-13T20:18:15Z,419,220,639
NULL,57584,2019-01-13T22:26:42Z,0,11,11
B-RFC-approved;C-tracking-issue;T-cargo,57586,2019-01-14T03:43:17Z,183,2,185
S-waiting-on-review,57589,2019-01-14T06:45:12Z,2,0,2
"S-waiting-on-review,S-waiting-on-review,S-waiting-on-review,S-waiting-on-review,S-waiting-on-review",57590,2019-01-14T06:57:04Z,0,0,0
"S-waiting-on-review,S-waiting-on-review,S-waiting-on-review;T-lang,S-waiting-on-review,S-waiting-on-review,S-waiting-on-review",57592,2019-01-14T10:31:56Z,340,253,593
"S-waiting-on-review,S-waiting-on-review,S-waiting-on-review,S-waiting-on-review,S-waiting-on-review",57599,2019-01-14T15:53:06Z,0,0,0
S-waiting-on-review,57600,2019-01-14T16:26:21Z,29,5,34
NULL,57604,2019-01-14T18:03:47Z,239,235,474
I-ICE,57606,2019-01-14T18:55:47Z,93,103,196
"S-waiting-on-review,S-waiting-on-review,S-waiting-on-review,S-waiting-on-review,S-waiting-on-bors,S-waiting-on-review,S-waiting-on-review,S-waiting-on-review",57607,2019-01-14T19:32:01Z,715,496,1211
A-NLL;P-high;T-compiler,57609,2019-01-14T22:06:10Z,1198,1178,2376
NULL,57610,2019-01-14T22:06:11Z,253,24,277
NULL,57617,2019-01-15T01:16:50Z,171,38,209
"S-waiting-on-review,S-waiting-on-review,S-waiting-on-review,S-waiting-on-review,S-waiting-on-bors,S-waiting-on-review,S-waiting-on-review,S-waiting-on-review,S-waiting-on-review",57624,2019-01-15T07:06:35Z,0,0,0
NULL,57625,2019-01-15T08:34:35Z,2,4,6
"S-waiting-on-bors,S-waiting-on-review,S-waiting-on-review,S-waiting-on-review,S-waiting-on-review,S-waiting-on-review,S-waiting-on-review,S-waiting-on-review",57627,2019-01-15T09:02:26Z,0,0,0
"S-waiting-on-review,S-waiting-on-review,S-waiting-on-review,S-waiting-on-review,S-waiting-on-review,S-waiting-on-bors,S-waiting-on-review,S-waiting-on-review,S-waiting-on-review",57630,2019-01-15T11:42:16Z,417,35,452
NULL,57636,2019-01-15T16:59:20Z,1,3,4
"S-waiting-on-review,S-waiting-on-review,S-waiting-on-review,S-waiting-on-review,S-waiting-on-review,S-waiting-on-review",57637,2019-01-15T17:10:27Z,0,0,0
NULL,57643,2019-01-15T21:15:50Z,0,0,0
NULL,57645,2019-01-15T22:14:02Z,492,20,512
NULL,57646,2019-01-15T23:10:03Z,2,14,16
NULL,57649,2019-01-15T23:31:26Z,59,23,82
"E-easy;E-mentor;I-ICE,A-tools;B-RFC-approved",57650,2019-01-16T00:38:16Z,14,1,15
A-diagnostics;A-parser;A-typesystem,57651,2019-01-16T00:39:18Z,165,58,223
NULL,57652,2019-01-16T01:47:33Z,93,864,957
A-io,57655,2019-01-16T04:31:43Z,45,24,69
NULL,57656,2019-01-16T04:54:21Z,4,0,4
NULL,57680,2019-01-16T21:31:20Z,12,0,12
"S-waiting-on-review,S-waiting-on-review,S-waiting-on-review,S-waiting-on-review,S-waiting-on-bors,S-waiting-on-review,S-waiting-on-review,S-waiting-on-review,S-waiting-on-review,S-waiting-on-review,S-waiting-on-review,S-waiting-on-crater,S-waiting-on-review,S-waiting-on-review,S-waiting-on-review,S-waiting-on-bors,S-waiting-on-review",57687,2019-01-17T02:48:53Z,0,0,0
"S-waiting-on-review,S-waiting-on-review,S-waiting-on-crater,S-waiting-on-review,S-waiting-on-review,S-waiting-on-review,S-waiting-on-bors,S-waiting-on-review,S-waiting-on-review,S-waiting-on-review,S-waiting-on-review,S-waiting-on-bors,S-waiting-on-review,S-waiting-on-review,S-waiting-on-review,S-waiting-on-review,S-waiting-on-review",57688,2019-01-17T03:25:27Z,0,0,0
"S-waiting-on-bors,S-waiting-on-review,S-waiting-on-review,S-waiting-on-review,S-waiting-on-review,S-waiting-on-bors,S-waiting-on-review,S-waiting-on-review,S-waiting-on-review,S-waiting-on-review,S-waiting-on-review,S-waiting-on-review,S-waiting-on-review,S-waiting-on-crater,S-waiting-on-review,S-waiting-on-review,S-waiting-on-review",57690,2019-01-17T04:46:59Z,0,0,0
NULL,57698,2019-01-17T14:35:23Z,18,1,19
NULL,57699,2019-01-17T15:22:27Z,86,40,126
NULL,57703,2019-01-17T18:01:15Z,1,3,4
S-waiting-on-review,57708,2019-01-17T19:18:00Z,2,0,2
NULL,57710,2019-01-17T20:29:59Z,0,4,4
"A-NLL;T-compiler,A-NLL;I-ICE,A-NLL;NLL-sound;P-medium,A-NLL;NLL-sound",57714,2019-01-17T21:41:36Z,849,291,1140
S-waiting-on-review,57721,2019-01-18T01:38:49Z,1,1,2
NULL,57723,2019-01-18T04:49:33Z,201,19,220
"S-waiting-on-review,S-waiting-on-review,S-waiting-on-review,S-waiting-on-crater,S-waiting-on-review,S-waiting-on-review,S-waiting-on-review,S-waiting-on-review,S-waiting-on-review,S-waiting-on-review;T-libs;disposition-merge;proposed-final-comment-period,S-waiting-on-review,S-waiting-on-bors,S-waiting-on-review,S-waiting-on-review,S-waiting-on-review,S-waiting-on-review,S-waiting-on-review,S-waiting-on-review,S-waiting-on-bors,S-waiting-on-bors,S-waiting-on-review",57727,2019-01-18T09:24:28Z,0,0,0
"S-waiting-on-review,S-waiting-on-bors,S-waiting-on-review,S-waiting-on-review,S-waiting-on-review,S-waiting-on-review,S-waiting-on-review,S-waiting-on-review,S-waiting-on-review,S-waiting-on-bors,S-waiting-on-bors,S-waiting-on-review,S-waiting-on-review,S-waiting-on-review,S-waiting-on-review,S-waiting-on-crater,S-waiting-on-review,S-waiting-on-review,S-waiting-on-review,S-waiting-on-review",57732,2019-01-18T11:39:46Z,0,0,0
"S-waiting-on-bors,S-waiting-on-review,S-waiting-on-review,S-waiting-on-review,S-waiting-on-review,S-waiting-on-review,S-waiting-on-review,S-waiting-on-review,S-waiting-on-review,S-waiting-on-review,S-waiting-on-bors,S-waiting-on-review,S-waiting-on-review,S-waiting-on-review,S-waiting-on-review,S-waiting-on-bors",57733,2019-01-18T12:25:54Z,0,0,0
"S-waiting-on-review,S-waiting-on-review,S-waiting-on-review,S-waiting-on-bors,S-waiting-on-review,S-waiting-on-review,S-waiting-on-bors,S-waiting-on-review,S-waiting-on-review",57737,2019-01-18T17:06:41Z,138,66,204
beta-nominated,57745,2019-01-18T21:01:11Z,0,0,0
"S-waiting-on-review,S-waiting-on-review,S-waiting-on-review,S-waiting-on-review,S-waiting-on-review,S-waiting-on-review,S-waiting-on-bors,S-waiting-on-review,S-waiting-on-review,S-waiting-on-review,S-waiting-on-review",57747,2019-01-18T21:56:49Z,302,90,392
"S-waiting-on-review,S-waiting-on-bors,S-waiting-on-crater,S-waiting-on-review,S-waiting-on-review,S-waiting-on-review,S-waiting-on-review,S-waiting-on-review,S-waiting-on-review",57752,2019-01-19T08:03:36Z,793,620,1413
"S-waiting-on-review,S-waiting-on-review,S-waiting-on-review,S-waiting-on-review,S-waiting-on-review,S-waiting-on-review,S-waiting-on-review",57755,2019-01-19T13:21:26Z,477,308,785
S-waiting-on-bors,57756,2019-01-19T13:30:09Z,1,1,2
NULL,57758,2019-01-19T15:51:09Z,0,0,0
"S-waiting-on-bors,S-waiting-on-review,S-waiting-on-review,S-waiting-on-bors,S-waiting-on-review",57761,2019-01-19T18:41:25Z,437,369,806
NULL,57769,2019-01-20T04:21:14Z,132,12,144
NULL,57779,2019-01-20T09:53:04Z,225,44,269
A-diagnostics;A-suggestion-diagnostics,57783,2019-01-20T19:29:24Z,183,2,185
A-diagnostics;E-easy,57784,2019-01-20T19:56:27Z,11,7,18
NULL,57786,2019-01-20T21:29:50Z,0,0,0
I-crash;T-infra,57789,2019-01-20T23:32:44Z,1,1,2
NULL,57791,2019-01-21T01:15:29Z,16,0,16
"S-waiting-on-bors,S-waiting-on-review,S-waiting-on-review,S-waiting-on-review,S-waiting-on-bors",57792,2019-01-21T01:22:00Z,484,88,572
A-diagnostics;E-easy,57793,2019-01-21T02:43:02Z,78,58,136
E-easy,57798,2019-01-21T07:14:34Z,16,16,32
"S-waiting-on-review,A-diagnostics;A-resolve;T-compiler",57802,2019-01-21T12:28:06Z,37,14,51
NULL,57803,2019-01-21T13:22:46Z,16,1,17
NULL,57805,2019-01-21T15:40:46Z,428,23,451
"S-waiting-on-review,S-waiting-on-review,S-waiting-on-review,S-waiting-on-review,S-waiting-on-review",57816,2019-01-21T20:03:20Z,0,0,0
NULL,57817,2019-01-21T20:28:55Z,303,1,304
"S-waiting-on-review,S-waiting-on-review,S-waiting-on-review,S-waiting-on-review,S-waiting-on-review,S-waiting-on-review,S-waiting-on-review,S-waiting-on-review",57823,2019-01-21T23:14:12Z,0,0,0
B-RFC-approved;C-tracking-issue;T-lang;T-libs,57825,2019-01-22T08:33:09Z,0,1,1
NULL,57827,2019-01-22T10:32:57Z,1,0,1
"S-waiting-on-review,S-waiting-on-review,S-waiting-on-review,S-waiting-on-review,S-waiting-on-review,S-waiting-on-review,S-waiting-on-review,S-waiting-on-review,S-waiting-on-review",57830,2019-01-22T11:20:37Z,494,283,777
NULL,57833,2019-01-22T13:24:46Z,1,1,2
B-unstable;T-libs,57834,2019-01-22T13:26:44Z,7,12,19
NULL,57835,2019-01-22T13:50:22Z,28,9,37
NULL,57836,2019-01-22T14:09:57Z,66,2,68
NULL,57840,2019-01-22T18:17:33Z,4,1,5
NULL,57846,2019-01-22T22:10:34Z,11,2,13
NULL,57847,2019-01-22T22:52:55Z,15,4,19
"S-waiting-on-review,S-waiting-on-review,S-waiting-on-review,S-waiting-on-review,S-waiting-on-review,S-waiting-on-review,S-waiting-on-review,S-waiting-on-review",57850,2019-01-23T00:34:24Z,0,0,0
NULL,57851,2019-01-23T00:58:50Z,37,15,52
A-diagnostics;A-parser;A-suggestion-diagnostics,57852,2019-01-23T01:38:31Z,328,8,336
NULL,57859,2019-01-23T11:05:43Z,0,8,8
S-waiting-on-review,57861,2019-01-23T14:14:12Z,0,3,3
NULL,57862,2019-01-23T15:09:53Z,6,2,8
NULL,57863,2019-01-23T16:01:33Z,109,1,110
"S-waiting-on-review,S-waiting-on-review,S-waiting-on-review,S-waiting-on-bors,S-waiting-on-review,S-waiting-on-review,S-waiting-on-review,S-waiting-on-review,S-waiting-on-review,S-waiting-on-review,S-waiting-on-review",57869,2019-01-23T23:20:04Z,840,310,1150
S-waiting-on-review,57870,2019-01-24T00:27:15Z,0,0,0
NULL,57871,2019-01-24T00:39:05Z,47,24,71
NULL,57873,2019-01-24T04:49:33Z,8,16,24
"S-waiting-on-review,S-waiting-on-review,S-waiting-on-review,S-waiting-on-review,S-waiting-on-review,S-waiting-on-review,S-waiting-on-review,S-waiting-on-review,S-waiting-on-review",57874,2019-01-24T06:59:51Z,0,0,0
"S-waiting-on-review,S-waiting-on-review,S-waiting-on-review",57878,2019-01-24T16:10:40Z,23,3,26
"S-waiting-on-review,S-waiting-on-review,S-waiting-on-review,S-waiting-on-review,S-waiting-on-review,S-waiting-on-review,S-waiting-on-review,S-waiting-on-review,S-waiting-on-review",57879,2019-01-24T17:25:53Z,432,172,604
T-rustdoc,57884,2019-01-24T23:09:03Z,7,6,13
S-waiting-on-review,57885,2019-01-24T23:14:08Z,402,7,409
A-diagnostics,57886,2019-01-24T23:40:29Z,303,27,330
NULL,57887,2019-01-25T00:04:24Z,0,0,0
"S-waiting-on-review,S-waiting-on-review,S-waiting-on-review,S-waiting-on-review",57888,2019-01-25T00:37:04Z,867,1135,2002
NULL,57896,2019-01-25T15:15:48Z,548,79,627
"S-waiting-on-author,S-waiting-on-review,S-waiting-on-review,S-waiting-on-review",57898,2019-01-25T15:59:32Z,870,82,952
A-lint,57899,2019-01-25T16:00:37Z,179,59,238
NULL,57901,2019-01-25T18:45:57Z,427,216,643
NULL,57904,2019-01-25T19:32:21Z,108,8,116
S-waiting-on-review,57908,2019-01-25T23:02:58Z,98,46,144
S-waiting-on-review,57910,2019-01-26T01:51:12Z,2,4,6
"S-waiting-on-review,S-waiting-on-review,S-waiting-on-review,S-waiting-on-review,S-waiting-on-bors,S-waiting-on-review,S-waiting-on-review,S-waiting-on-review,S-waiting-on-review,S-waiting-on-review",57911,2019-01-26T02:44:31Z,0,0,0
"S-waiting-on-review,S-waiting-on-review,S-waiting-on-review,S-waiting-on-review,S-waiting-on-review,S-waiting-on-review,S-waiting-on-review,S-waiting-on-review,S-waiting-on-bors",57912,2019-01-26T03:15:34Z,0,0,0
"E-mentor;T-compiler;WG-compiler-front,B-RFC-approved;C-tracking-issue;T-lang",57913,2019-01-26T06:52:00Z,2,2,4
S-waiting-on-bors,57915,2019-01-26T14:45:34Z,36,27,63
"S-waiting-on-review,S-waiting-on-review,S-waiting-on-bors,S-waiting-on-review,S-waiting-on-review,S-waiting-on-review,S-waiting-on-review",57918,2019-01-26T17:21:50Z,156,84,240
NULL,57920,2019-01-26T17:56:16Z,14,2,16
B-unstable;T-lang,57921,2019-01-26T18:36:51Z,0,0,0
A-suggestion-diagnostics,57922,2019-01-26T19:34:55Z,107,9,116
B-RFC-approved;T-libs,57926,2019-01-26T21:48:53Z,4,1,5
"S-waiting-on-review,S-waiting-on-review,S-waiting-on-review",57930,2019-01-27T02:38:45Z,0,0,0
S-waiting-on-review,57932,2019-01-27T13:40:32Z,21,8,29
"A-NVPTX,metabug,A-NVPTX",57937,2019-01-27T20:21:27Z,483,61,544
"S-waiting-on-review,S-waiting-on-review,S-waiting-on-review",57938,2019-01-27T21:03:30Z,0,0,0
"S-waiting-on-review,S-waiting-on-review",57944,2019-01-28T05:09:09Z,332,157,489
I-slow,57949,2019-01-28T14:56:20Z,0,0,0
S-waiting-on-review,57950,2019-01-28T15:32:27Z,33,0,33
NULL,57953,2019-01-28T17:57:15Z,4,9,13
"S-waiting-on-review,S-waiting-on-review,S-waiting-on-review,S-waiting-on-review,S-waiting-on-review",57955,2019-01-28T18:13:21Z,0,0,0
"S-waiting-on-review,S-waiting-on-review,S-waiting-on-review,S-waiting-on-review,S-waiting-on-review,S-waiting-on-review,S-waiting-on-review",57957,2019-01-28T21:25:51Z,269,92,361
NULL,57978,2019-01-29T22:22:29Z,21,7,28
A-impl-trait;I-nominated;T-compiler;regression-from-stable-to-nightly,57981,2019-01-30T00:02:08Z,60,1,61
"S-waiting-on-review,S-waiting-on-review,S-waiting-on-review,S-waiting-on-review",57982,2019-01-30T00:30:42Z,0,0,0
NULL,57990,2019-01-30T08:47:56Z,2,2,4
"S-waiting-on-review,S-waiting-on-review,S-waiting-on-review,S-waiting-on-review",57991,2019-01-30T09:37:18Z,0,0,0
"S-waiting-on-review,S-waiting-on-review,S-waiting-on-review,S-waiting-on-review,S-waiting-on-review,S-waiting-on-review",57995,2019-01-30T11:39:53Z,0,0,0
E-medium,57997,2019-01-30T13:23:00Z,249,215,464
S-waiting-on-review,58000,2019-01-30T14:45:24Z,77,45,122
NULL,58003,2019-01-30T17:21:13Z,101,3,104
NULL,58005,2019-01-30T18:13:43Z,8,8,16
NULL,58007,2019-01-30T19:40:53Z,26,1,27
NULL,58008,2019-01-30T19:53:01Z,37,1,38
"S-waiting-on-review,S-waiting-on-review",58013,2019-01-30T20:54:28Z,392,87,479
"S-waiting-on-review,S-waiting-on-review,S-waiting-on-review,S-waiting-on-review,S-waiting-on-review,S-waiting-on-review,S-waiting-on-review,S-waiting-on-review,S-waiting-on-review,S-waiting-on-bors;beta-nominated,S-waiting-on-review,S-waiting-on-review",58014,2019-01-30T23:11:30Z,0,0,0
B-RFC-approved;T-libs,58015,2019-01-31T00:48:32Z,72,6,78
"S-waiting-on-review,S-waiting-on-review,S-waiting-on-review,S-waiting-on-review,S-waiting-on-bors;beta-nominated,S-waiting-on-review,S-waiting-on-review,S-waiting-on-review,S-waiting-on-review,S-waiting-on-review,S-waiting-on-review,S-waiting-on-review",58016,2019-01-31T01:10:55Z,319,89,408
S-waiting-on-review,58019,2019-01-31T03:41:41Z,382,273,655
NULL,58028,2019-01-31T14:43:20Z,35,15,50
NULL,58034,2019-01-31T21:09:23Z,8,8,16
S-waiting-on-review,58036,2019-01-31T22:58:48Z,0,0,0
NULL,58047,2019-02-01T10:26:43Z,6,8,14
"B-unstable;T-libs,S-waiting-on-review",58048,2019-02-01T10:39:50Z,1,3,4
B-unstable;E-easy;T-libs,58051,2019-02-01T12:36:04Z,326,199,525
NULL,58056,2019-02-01T15:52:05Z,150,50,200
NULL,58057,2019-02-01T16:31:13Z,172,61,233
I-ICE;T-rustdoc,58058,2019-02-01T17:20:29Z,18,6,24
NULL,58059,2019-02-01T18:54:35Z,171,95,266
A-iterators;B-unstable;C-tracking-issue;T-libs,58062,2019-02-01T23:00:08Z,25,32,57
A-lint;C-feature-request,58070,2019-02-02T04:47:59Z,0,0,0
NULL,58074,2019-02-02T09:11:14Z,9,14,23
A-diagnostics,58075,2019-02-02T11:06:57Z,14,8,22
S-waiting-on-review,58090,2019-02-03T08:57:50Z,125,17,142
"A-frontend;I-cleanup,A-runtime;A-testsuite;I-cleanup;P-low,S-waiting-on-review,A-frontend;I-cleanup,A-libs;A-syntaxext;I-enhancement,S-waiting-on-review,A-rustdoc;A-testsuite;I-completion,A-runtime;A-testsuite;I-cleanup;P-low",58093,2019-02-03T10:16:03Z,1,1,2
C-tracking-issue;T-compiler;WG-epoch,58100,2019-02-03T13:51:46Z,455,424,879
NULL,58103,2019-02-03T14:13:31Z,173,130,303
C-tracking-issue;T-compiler;WG-epoch,58105,2019-02-03T14:28:48Z,11,10,21
C-tracking-issue;T-compiler;WG-epoch,58106,2019-02-03T14:35:02Z,8,6,14
C-tracking-issue;T-compiler;WG-epoch,58107,2019-02-03T14:40:48Z,7,5,12
C-tracking-issue;T-compiler;WG-epoch,58109,2019-02-03T14:57:53Z,6,8,14
C-tracking-issue;T-compiler;WG-epoch,58110,2019-02-03T14:58:34Z,20,21,41
C-tracking-issue;T-compiler;WG-epoch,58111,2019-02-03T14:59:14Z,42,39,81
C-tracking-issue;T-compiler;WG-epoch,58112,2019-02-03T15:03:29Z,3,2,5
C-tracking-issue;T-compiler;WG-epoch,58113,2019-02-03T15:06:33Z,7,5,12
C-tracking-issue;T-compiler;WG-epoch,58114,2019-02-03T15:35:48Z,5,2,7
C-tracking-issue;T-compiler;WG-epoch,58115,2019-02-03T15:40:39Z,3,2,5
B-RFC-approved,58116,2019-02-03T15:42:47Z,8,0,8
C-tracking-issue;T-compiler;WG-epoch,58117,2019-02-03T15:46:16Z,3,0,3
C-tracking-issue;T-compiler;WG-epoch,58118,2019-02-03T15:57:16Z,104,71,175
C-tracking-issue;T-compiler;WG-epoch,58119,2019-02-03T15:58:27Z,100,90,190
C-tracking-issue;T-compiler;WG-epoch,58120,2019-02-03T16:06:16Z,3,0,3
NULL,58123,2019-02-03T16:25:45Z,8,3,11
C-tracking-issue;T-compiler;WG-epoch,58124,2019-02-03T16:48:42Z,51,60,111
C-tracking-issue;T-compiler;WG-epoch,58125,2019-02-03T19:42:13Z,617,574,1191
C-tracking-issue;T-compiler;WG-epoch,58128,2019-02-03T21:03:51Z,8,7,15
C-tracking-issue;T-compiler;WG-epoch,58133,2019-02-04T00:11:17Z,269,268,537
A-io,58136,2019-02-04T06:41:25Z,48,1,49
S-waiting-on-review,58140,2019-02-04T10:20:32Z,3407,2933,6340
NULL,58146,2019-02-04T14:00:34Z,20,2,22
T-rustdoc,58150,2019-02-04T14:51:26Z,9,8,17
"S-waiting-on-review,S-waiting-on-review",58151,2019-02-04T15:30:37Z,30,33,63
"S-waiting-on-review,S-waiting-on-review",58152,2019-02-04T15:38:03Z,20,23,43
"S-waiting-on-review,S-waiting-on-review",58153,2019-02-04T15:46:32Z,49,47,96
C-tracking-issue;T-compiler;WG-epoch,58156,2019-02-04T16:23:55Z,1,1,2
C-tracking-issue;T-compiler;WG-epoch,58157,2019-02-04T16:34:17Z,2,0,2
"S-waiting-on-review,S-waiting-on-review,S-waiting-on-review,S-waiting-on-review,S-waiting-on-bors;beta-nominated",58159,2019-02-04T17:41:56Z,91,11,102
S-waiting-on-review,58161,2019-02-04T18:18:05Z,68,4,72
A-spurious;C-bug;T-infra,58162,2019-02-04T18:29:06Z,11,2,13
S-waiting-on-review,58166,2019-02-04T18:50:32Z,117,67,184
"S-waiting-on-review,S-waiting-on-review",58167,2019-02-04T19:02:52Z,175,147,322
A-diagnostics,58173,2019-02-05T00:11:54Z,0,0,0
NULL,58180,2019-02-05T08:08:06Z,39,2,41
"S-waiting-on-bors,S-waiting-on-bors,S-waiting-on-bors,S-waiting-on-review,S-waiting-on-review,S-waiting-on-review,S-waiting-on-bors,S-waiting-on-bors,S-waiting-on-review,S-waiting-on-bors,S-waiting-on-bors,S-waiting-on-review,S-waiting-on-review,S-waiting-on-review,S-waiting-on-review,S-waiting-on-review,S-waiting-on-review,S-waiting-on-review,S-waiting-on-review,S-waiting-on-bors,S-waiting-on-review,S-waiting-on-review,S-waiting-on-bors;T-infra",58189,2019-02-05T15:29:23Z,188,62,250
S-waiting-on-review,58191,2019-02-05T16:02:46Z,1085,709,1794
NULL,58192,2019-02-05T16:55:43Z,48,1,49
C-tracking-issue;T-compiler;WG-epoch,58193,2019-02-05T17:29:07Z,1234,1243,2477
A-const-fn;A-diagnostics,58196,2019-02-05T20:29:05Z,352,103,455
NULL,58197,2019-02-05T20:38:05Z,0,0,0
A-diagnostics;E-easy,58198,2019-02-05T20:59:55Z,19,6,25
A-NLL;E-mentor;NLL-diagnostics,58199,2019-02-05T21:01:10Z,18,12,30
NULL,58202,2019-02-05T21:53:34Z,134,92,226
NULL,58203,2019-02-05T22:34:12Z,88,17,105
NULL,58204,2019-02-05T23:19:33Z,72,12,84
NULL,58207,2019-02-06T01:52:21Z,40,38,78
C-tracking-issue;T-compiler;WG-epoch,58208,2019-02-06T04:02:18Z,2030,2060,4090
NULL,58216,2019-02-06T13:27:47Z,25,8,33
C-tracking-issue;T-compiler;WG-epoch,58217,2019-02-06T13:30:49Z,3,4,7
C-tracking-issue;T-compiler;WG-epoch,58218,2019-02-06T13:37:30Z,3,4,7
C-tracking-issue;T-compiler;WG-epoch,58219,2019-02-06T13:41:10Z,3,4,7
C-tracking-issue;T-compiler;WG-epoch,58220,2019-02-06T13:47:43Z,2,3,5
NULL,58221,2019-02-06T14:03:44Z,0,0,0
C-tracking-issue;T-compiler;WG-epoch,58222,2019-02-06T14:09:47Z,7,15,22
C-tracking-issue;T-compiler;WG-epoch,58223,2019-02-06T14:14:09Z,3,4,7
C-tracking-issue;T-compiler;WG-epoch,58225,2019-02-06T14:20:39Z,3,0,3
C-tracking-issue;T-compiler;WG-epoch,58228,2019-02-06T14:58:43Z,8,10,18
"S-waiting-on-review,S-waiting-on-review,S-waiting-on-review",58232,2019-02-06T15:43:00Z,254,254,508
C-tracking-issue;T-compiler;WG-epoch,58233,2019-02-06T16:05:26Z,79,82,161
C-tracking-issue;T-compiler;WG-epoch,58236,2019-02-06T17:16:52Z,96,89,185
S-waiting-on-review,58237,2019-02-06T17:25:36Z,2,4,6
NULL,58238,2019-02-06T17:45:30Z,23,24,47
C-tracking-issue;T-compiler;WG-epoch,58239,2019-02-06T18:06:44Z,11,18,29
C-tracking-issue;T-compiler;WG-epoch,58240,2019-02-06T18:38:55Z,37,45,82
C-tracking-issue;T-compiler;WG-epoch,58241,2019-02-06T18:55:38Z,2,4,6
NULL,58243,2019-02-06T19:33:42Z,153,47,200
C-tracking-issue;T-compiler;WG-epoch,58245,2019-02-06T20:26:13Z,108,100,208
A-const-eval;E-mentor,58246,2019-02-06T21:24:53Z,177,21,198
C-tracking-issue;T-compiler;WG-epoch,58247,2019-02-06T21:48:23Z,23,22,45
S-waiting-on-review,58250,2019-02-06T23:18:37Z,1334,1055,2389
C-tracking-issue;T-compiler;WG-epoch,58251,2019-02-07T01:18:37Z,20,23,43
C-tracking-issue;T-compiler;WG-epoch,58252,2019-02-07T03:05:02Z,0,0,0
C-tracking-issue;T-compiler;WG-epoch,58253,2019-02-07T05:22:33Z,23,45,68
"S-waiting-on-review,S-waiting-on-bors,S-waiting-on-bors,S-waiting-on-bors,S-waiting-on-bors,S-waiting-on-bors,S-waiting-on-bors,S-waiting-on-review,S-waiting-on-review,S-waiting-on-bors,S-waiting-on-bors,S-waiting-on-bors,S-waiting-on-review,S-waiting-on-bors,S-waiting-on-review,S-waiting-on-bors,S-waiting-on-review,S-waiting-on-bors,S-waiting-on-bors,S-waiting-on-bors,S-waiting-on-bors,S-waiting-on-review,S-waiting-on-bors,S-waiting-on-bors",58254,2019-02-07T05:58:04Z,2038,1928,3966
C-tracking-issue;T-compiler;WG-epoch,58255,2019-02-07T06:10:33Z,67,66,133
C-tracking-issue;T-compiler;WG-epoch,58256,2019-02-07T06:55:44Z,3,0,3
C-tracking-issue;T-compiler;WG-epoch,58257,2019-02-07T07:47:18Z,221,220,441
C-tracking-issue;T-compiler;WG-epoch,58259,2019-02-07T08:31:47Z,18,23,41
C-tracking-issue;T-compiler;WG-epoch,58260,2019-02-07T09:19:20Z,71,69,140
C-tracking-issue;T-compiler;WG-epoch,58261,2019-02-07T09:42:47Z,29,32,61
S-waiting-on-review,58262,2019-02-07T10:47:38Z,3,3,6
C-tracking-issue;T-compiler;WG-epoch,58265,2019-02-07T12:24:40Z,520,519,1039
"S-waiting-on-review,S-waiting-on-review,S-waiting-on-review,S-waiting-on-review,S-waiting-on-review,S-waiting-on-review,S-waiting-on-bors,S-waiting-on-bors,S-waiting-on-review,S-waiting-on-review,S-waiting-on-review",58266,2019-02-07T13:28:43Z,240,244,484
NULL,58267,2019-02-07T13:54:29Z,206,62,268
NULL,58269,2019-02-07T14:08:22Z,2,0,2
C-tracking-issue;T-compiler;WG-epoch,58273,2019-02-07T16:40:39Z,114,121,235
"S-waiting-on-bors,S-waiting-on-review,S-waiting-on-review,S-waiting-on-review,S-waiting-on-review,S-waiting-on-bors;merged-by-bors,S-waiting-on-bors,S-waiting-on-bors,S-waiting-on-review,S-waiting-on-review,S-waiting-on-review,S-waiting-on-review,S-waiting-on-bors,S-waiting-on-bors,S-waiting-on-review",58282,2019-02-08T04:34:22Z,0,0,0
C-tracking-issue;T-compiler;WG-epoch,58285,2019-02-08T05:55:24Z,3,1,4
C-tracking-issue;T-compiler;WG-epoch,58287,2019-02-08T06:06:58Z,2,2,4
C-tracking-issue;T-compiler;WG-epoch,58288,2019-02-08T06:23:59Z,1,0,1
C-bug;T-rustdoc;regression-from-stable-to-nightly,58294,2019-02-08T09:48:31Z,1,1,2
C-tracking-issue;T-compiler;WG-epoch,58300,2019-02-08T13:34:00Z,98,100,198
B-RFC-approved;T-libs,58302,2019-02-08T14:08:30Z,163,79,242
T-rustdoc,58306,2019-02-08T15:07:15Z,1,1,2
C-tracking-issue;T-compiler;WG-epoch,58312,2019-02-08T16:39:38Z,86,107,193
"S-waiting-on-review,S-waiting-on-bors,S-waiting-on-bors,S-waiting-on-bors,S-waiting-on-bors,S-waiting-on-bors,S-waiting-on-bors,S-waiting-on-bors,S-waiting-on-bors,S-waiting-on-bors,S-waiting-on-bors,S-waiting-on-bors,S-waiting-on-review,S-waiting-on-review,S-waiting-on-bors,S-waiting-on-bors,S-waiting-on-bors,S-waiting-on-bors",58316,2019-02-08T23:16:08Z,1381,1328,2709
"S-waiting-on-review,C-tracking-issue;T-compiler;WG-epoch",58318,2019-02-09T08:37:07Z,1607,1609,3216
E-mentor;I-compiletime;T-compiler,58321,2019-02-09T14:14:00Z,385,379,764
C-tracking-issue;T-compiler;WG-epoch,58322,2019-02-09T14:43:08Z,75,91,166
C-bug;T-compiler;T-libs,58324,2019-02-09T14:49:52Z,23,8,31
NULL,58327,2019-02-09T19:11:26Z,0,0,0
"S-waiting-on-bors,S-waiting-on-review,S-waiting-on-bors,S-waiting-on-review,S-waiting-on-bors,S-waiting-on-review,S-waiting-on-review,S-waiting-on-review,S-waiting-on-review,S-waiting-on-review,S-waiting-on-bors,S-waiting-on-bors,S-waiting-on-bors,S-waiting-on-review,S-waiting-on-bors,S-waiting-on-bors,S-waiting-on-bors,S-waiting-on-review",58338,2019-02-10T02:39:24Z,0,0,0
S-waiting-on-review,58341,2019-02-10T05:10:05Z,2850,2822,5672
"S-waiting-on-bors,C-tracking-issue;T-compiler;WG-epoch",58342,2019-02-10T07:57:15Z,21,0,21
A-NLL;I-nominated;NLL-performant,58347,2019-02-10T12:09:20Z,234,112,346
"S-waiting-on-bors,S-waiting-on-bors,S-waiting-on-bors,S-waiting-on-bors,S-waiting-on-review,S-waiting-on-bors,S-waiting-on-review,S-waiting-on-bors,S-waiting-on-review,S-waiting-on-bors,S-waiting-on-review,S-waiting-on-bors,S-waiting-on-review,S-waiting-on-review,S-waiting-on-review,S-waiting-on-bors,S-waiting-on-bors,S-waiting-on-review,S-waiting-on-bors",58348,2019-02-10T13:17:42Z,0,0,0
"beta-nominated,S-waiting-on-crater;T-lang",58349,2019-02-10T13:18:35Z,11,111,122
C-tracking-issue;T-compiler;WG-epoch,58356,2019-02-10T16:30:01Z,0,0,0
"S-waiting-on-bors,S-waiting-on-review,S-waiting-on-bors,S-waiting-on-bors,S-waiting-on-review,S-waiting-on-bors,S-waiting-on-review,S-waiting-on-bors,S-waiting-on-review,S-waiting-on-bors,S-waiting-on-bors,S-waiting-on-bors,S-waiting-on-bors,S-waiting-on-bors,S-waiting-on-bors,S-waiting-on-bors",58361,2019-02-10T20:45:28Z,306,102,408
T-rustdoc,58364,2019-02-10T23:01:12Z,0,0,0
"I-nominated;S-waiting-on-bors;T-compiler;beta-nominated;merged-by-bors,A-NLL;A-associated-items;A-lifetimes;I-unsound%20%F0%9F%92%A5;NLL-sound;T-compiler",58371,2019-02-11T11:24:29Z,176,85,261
A-incr-comp;C-tracking-issue;I-compiletime;T-cargo;T-compiler;T-core;WG-compiler-performance,58378,2019-02-11T17:41:04Z,246,83,329
NULL,58380,2019-02-11T17:57:39Z,401,96,497
NULL,58381,2019-02-11T18:31:06Z,63,17,80
NULL,58384,2019-02-11T23:19:25Z,6,25,31
NULL,58387,2019-02-12T01:51:43Z,28,1,29
"S-waiting-on-bors,S-waiting-on-review,S-waiting-on-bors,S-waiting-on-review,S-waiting-on-bors,S-waiting-on-bors,S-waiting-on-review,S-waiting-on-bors,S-waiting-on-review,S-waiting-on-review",58389,2019-02-12T03:42:30Z,2104,2145,4249
S-waiting-on-review,58392,2019-02-12T07:01:31Z,58,25,83
S-waiting-on-review,58404,2019-02-12T14:40:25Z,4,5,9
S-waiting-on-review,58406,2019-02-12T17:27:27Z,69,1,70
NULL,58407,2019-02-12T17:41:15Z,139,126,265
T-rustdoc,58409,2019-02-12T20:25:18Z,43,30,73
"S-waiting-on-bors,S-waiting-on-review,S-waiting-on-review,S-waiting-on-author,S-waiting-on-review,S-waiting-on-review,S-waiting-on-review,S-waiting-on-bors,S-waiting-on-review,S-waiting-on-review,S-waiting-on-review;T-compiler;disposition-merge;proposed-final-comment-period,S-waiting-on-bors,S-waiting-on-bors",58412,2019-02-13T01:08:45Z,0,0,0
"S-waiting-on-bors,S-waiting-on-review,S-waiting-on-review,S-waiting-on-bors,S-waiting-on-review;T-compiler;disposition-merge;proposed-final-comment-period,S-waiting-on-bors,S-waiting-on-bors,S-waiting-on-bors,S-waiting-on-review,S-waiting-on-review,S-waiting-on-author,S-waiting-on-review,S-waiting-on-review",58413,2019-02-13T01:24:26Z,0,0,0
"S-waiting-on-bors,S-waiting-on-review,S-waiting-on-review,S-waiting-on-author,S-waiting-on-review,S-waiting-on-review,S-waiting-on-review,S-waiting-on-bors,S-waiting-on-review,S-waiting-on-bors,S-waiting-on-review;T-compiler;disposition-merge;proposed-final-comment-period,S-waiting-on-bors",58415,2019-02-13T03:37:11Z,687,350,1037
"S-waiting-on-review,C-enhancement;I-compiletime;T-compiler",58425,2019-02-13T13:16:24Z,343,372,715
"S-waiting-on-bors,S-waiting-on-bors,S-waiting-on-bors,S-waiting-on-bors,S-waiting-on-bors,S-waiting-on-review,S-waiting-on-bors,S-waiting-on-bors,S-waiting-on-bors,S-waiting-on-review,S-waiting-on-bors",58426,2019-02-13T14:09:53Z,0,0,0
"S-waiting-on-review,S-waiting-on-bors,S-waiting-on-bors,S-waiting-on-bors,S-waiting-on-review,S-waiting-on-bors,S-waiting-on-bors,S-waiting-on-review,S-waiting-on-bors,S-waiting-on-bors,S-waiting-on-bors",58428,2019-02-13T14:50:14Z,0,0,0
"S-waiting-on-review,S-waiting-on-bors,S-waiting-on-bors,S-waiting-on-review,S-waiting-on-bors,S-waiting-on-bors,S-waiting-on-bors,S-waiting-on-review,S-waiting-on-bors,S-waiting-on-bors,S-waiting-on-bors",58432,2019-02-13T17:12:40Z,753,445,1198
A-spurious;C-bug;T-infra,58434,2019-02-13T18:57:25Z,0,0,0
"S-waiting-on-bors,S-waiting-on-review,S-waiting-on-bors,S-waiting-on-review,S-waiting-on-bors,S-waiting-on-review,S-waiting-on-bors,S-waiting-on-review",58445,2019-02-14T01:40:33Z,0,0,0
"S-waiting-on-review,S-waiting-on-bors,S-waiting-on-review,S-waiting-on-bors,S-waiting-on-review,S-waiting-on-review,S-waiting-on-review,S-waiting-on-bors",58446,2019-02-14T01:41:25Z,959,816,1775
NULL,58448,2019-02-14T02:16:43Z,6,1,7
A-io,58454,2019-02-14T07:18:28Z,273,241,514
"S-waiting-on-bors,S-waiting-on-review,S-waiting-on-review,S-waiting-on-review,S-waiting-on-bors,S-waiting-on-review,S-waiting-on-review",58455,2019-02-14T07:24:19Z,885,427,1312
S-waiting-on-review,58461,2019-02-14T10:50:51Z,0,0,0
S-waiting-on-review,58466,2019-02-14T17:28:18Z,0,0,0
"I-nominated;S-waiting-on-review;S-waiting-on-team;T-lang;needs-fcp,S-waiting-on-review,S-waiting-on-review,S-waiting-on-bors,S-waiting-on-review,S-waiting-on-review,S-waiting-on-review,S-waiting-on-review,S-waiting-on-review,S-waiting-on-review",58470,2019-02-14T21:08:05Z,0,0,0
NULL,58476,2019-02-15T03:47:06Z,168,226,394
"S-waiting-on-review,S-waiting-on-review,S-waiting-on-review,S-waiting-on-review,A-NLL,S-waiting-on-review,S-waiting-on-review,S-waiting-on-review,S-waiting-on-review;T-libs;needs-fcp,S-waiting-on-review,S-waiting-on-review,I-nominated;S-waiting-on-review;S-waiting-on-team;T-lang;needs-fcp,S-waiting-on-review,S-waiting-on-review,S-waiting-on-bors,S-waiting-on-review,S-waiting-on-review,S-waiting-on-review",58495,2019-02-15T16:56:06Z,819,300,1119
NULL,58496,2019-02-15T17:21:55Z,1,2,3
S-waiting-on-review,58503,2019-02-15T22:29:51Z,390,191,581
S-waiting-on-review,58505,2019-02-16T01:22:22Z,179,267,446
S-waiting-on-review,58508,2019-02-16T08:04:01Z,0,0,0
S-waiting-on-review,58511,2019-02-16T12:45:18Z,117,126,243
A-spurious;C-tracking-issue;T-infra,58512,2019-02-16T16:30:55Z,0,0,0
T-rustdoc,58513,2019-02-16T16:42:58Z,0,0,0
S-waiting-on-review,58524,2019-02-16T22:22:49Z,0,0,0
A-suggestion-diagnostics;C-enhancement,58526,2019-02-17T02:05:41Z,63,9,72
"S-waiting-on-bors,S-waiting-on-bors;merged-by-bors,I-nominated;S-waiting-on-bors;T-compiler;beta-nominated;merged-by-bors,S-waiting-on-review,S-waiting-on-bors,S-waiting-on-review",58537,2019-02-17T14:55:51Z,632,112,744
beta-nominated,58543,2019-02-17T17:17:16Z,1,1,2
NULL,58544,2019-02-17T18:15:51Z,2,2,4
NULL,58545,2019-02-17T18:44:11Z,62,0,62
C-tracking-issue;T-compiler;WG-epoch,58546,2019-02-17T19:12:02Z,190,199,389
"S-waiting-on-bors,S-waiting-on-bors",58549,2019-02-17T21:38:00Z,3,3,6
"S-waiting-on-review,S-waiting-on-review,C-feature-accepted;E-easy;T-libs,S-waiting-on-review,S-waiting-on-bors;T-libs,S-waiting-on-review,S-waiting-on-review",58550,2019-02-17T23:07:02Z,0,0,0
NULL,58551,2019-02-17T23:48:19Z,6,2,8
NULL,58555,2019-02-18T08:01:48Z,6,0,6
NULL,58556,2019-02-18T09:56:52Z,165,39,204
"S-waiting-on-review,S-waiting-on-bors;T-libs,S-waiting-on-review,S-waiting-on-review,S-waiting-on-review,S-waiting-on-review,S-waiting-on-bors,A-diagnostics;S-waiting-on-review,S-waiting-on-review,S-waiting-on-review,S-waiting-on-review,S-waiting-on-author,S-waiting-on-review,S-waiting-on-review,S-waiting-on-review,S-waiting-on-review",58559,2019-02-18T12:50:59Z,0,0,0
"S-waiting-on-review,S-waiting-on-review",58561,2019-02-18T15:40:32Z,642,673,1315
"A-diagnostics;S-waiting-on-review,S-waiting-on-review,S-waiting-on-review,S-waiting-on-review,S-waiting-on-review,S-waiting-on-review,S-waiting-on-review,S-waiting-on-review,S-waiting-on-review,S-waiting-on-review,S-waiting-on-review,S-waiting-on-bors;T-libs,C-feature-accepted;E-easy;T-libs,S-waiting-on-review,S-waiting-on-review,S-waiting-on-review",58566,2019-02-18T23:59:49Z,0,0,0
"A-const-eval;E-easy;E-mentor,A-const-eval;E-easy;E-mentor",58569,2019-02-19T07:30:34Z,4,6,10
S-waiting-on-review,58571,2019-02-19T08:30:12Z,145,99,244
NULL,58574,2019-02-19T12:24:29Z,310,49,359
"S-waiting-on-review,S-waiting-on-review,S-waiting-on-review",58575,2019-02-19T12:40:59Z,99,11,110
"A-iterators;B-unstable;C-tracking-issue;T-libs,A-iterators;B-unstable;C-tracking-issue;T-libs;disposition-merge;proposed-final-comment-period",58576,2019-02-19T13:03:57Z,13,14,27
"S-waiting-on-review,S-waiting-on-review,S-waiting-on-review,S-waiting-on-bors,S-waiting-on-review,S-waiting-on-review,S-waiting-on-review,S-waiting-on-bors;T-libs,S-waiting-on-review,C-feature-accepted;E-easy;T-libs,S-waiting-on-review,S-waiting-on-review,S-waiting-on-review,S-waiting-on-review,S-waiting-on-review,S-waiting-on-review,S-waiting-on-review,S-waiting-on-review,S-waiting-on-review,S-waiting-on-review;T-libs;relnotes,S-waiting-on-review,S-waiting-on-review,S-waiting-on-review,S-waiting-on-review,S-waiting-on-review",58578,2019-02-19T17:13:50Z,1177,633,1810
S-waiting-on-review,58581,2019-02-19T21:22:13Z,39,42,81
S-waiting-on-review,58583,2019-02-20T01:24:26Z,1201,412,1613
S-waiting-on-review,58592,2019-02-20T11:44:19Z,1280,372,1652
"S-waiting-on-review,S-waiting-on-review,S-waiting-on-review,S-waiting-on-review,S-waiting-on-review,S-waiting-on-review,S-waiting-on-review;T-libs,S-waiting-on-review,A-diagnostics;S-waiting-on-review,S-waiting-on-review,S-waiting-on-review,S-waiting-on-perf",58594,2019-02-20T13:23:55Z,0,0,0
B-unstable;C-tracking-issue;T-libs,58595,2019-02-20T13:23:56Z,52,19,71
S-waiting-on-review,58596,2019-02-20T14:02:43Z,0,0,0
T-doc,58603,2019-02-20T19:18:27Z,0,0,0
C-bug;I-ICE;T-compiler,58605,2019-02-20T20:33:29Z,35,18,53
A-impl-trait;I-nominated;T-compiler;regression-from-stable-to-nightly,58608,2019-02-20T21:43:38Z,345,73,418
I-unsound%20%F0%9F%92%A5;P-medium,58611,2019-02-21T00:56:52Z,0,0,0
"S-waiting-on-review,T-libs",58616,2019-02-21T13:03:12Z,14,1,15
S-waiting-on-review,58620,2019-02-21T17:17:34Z,89,0,89
S-waiting-on-review,58623,2019-02-21T21:04:32Z,521,2398,2919
NULL,58627,2019-02-21T23:30:43Z,106,152,258
NULL,58629,2019-02-22T01:26:24Z,37,0,37
A-NLL;A-mir;NLL-performant;T-compiler;WG-compiler-nll,58631,2019-02-22T04:29:03Z,441,352,793
"A-libs,A-libs",58636,2019-02-22T10:33:07Z,0,0,0
"S-waiting-on-review,S-waiting-on-review,S-waiting-on-review;T-libs,S-waiting-on-bors,A-diagnostics;S-waiting-on-review,S-waiting-on-review,S-waiting-on-review,S-waiting-on-review,S-waiting-on-review,S-waiting-on-review,S-waiting-on-review,S-waiting-on-review,S-waiting-on-review,S-waiting-on-bors,S-waiting-on-review,S-waiting-on-review,S-waiting-on-review,S-waiting-on-review",58637,2019-02-22T11:50:01Z,0,0,0
"S-waiting-on-review,S-waiting-on-review",58641,2019-02-22T12:43:21Z,0,0,0
NULL,58642,2019-02-22T12:47:35Z,42,2,44
"S-waiting-on-review,S-waiting-on-review,S-waiting-on-review,S-waiting-on-bors,S-waiting-on-review,S-waiting-on-review,S-waiting-on-review,S-waiting-on-review,S-waiting-on-review,S-waiting-on-review,S-waiting-on-review;T-libs,S-waiting-on-bors,A-diagnostics;S-waiting-on-review,S-waiting-on-review,S-waiting-on-review,S-waiting-on-review,S-waiting-on-review",58644,2019-02-22T13:58:18Z,542,210,752
NULL,58648,2019-02-22T15:08:54Z,24,12,36
NULL,58649,2019-02-22T15:22:34Z,10,1,11
"S-waiting-on-review,S-waiting-on-review,S-waiting-on-review",58651,2019-02-22T16:04:23Z,0,0,0
S-waiting-on-review,58653,2019-02-22T17:37:41Z,0,0,0
I-ICE,58654,2019-02-22T19:18:45Z,8,4,12
"S-waiting-on-review,A-spurious;C-tracking-issue;T-infra",58655,2019-02-22T19:29:00Z,1,1,2
"S-waiting-on-review,S-waiting-on-review,S-waiting-on-review,S-waiting-on-review;T-release;beta-accepted;beta-nominated,S-waiting-on-review,S-waiting-on-review,S-waiting-on-review,S-waiting-on-review",58656,2019-02-22T19:46:15Z,1839,447,2286
NULL,58658,2019-02-22T20:52:19Z,12,8,20
"S-waiting-on-review,S-waiting-on-review,S-waiting-on-review,S-waiting-on-bors,S-waiting-on-review,S-waiting-on-review,S-waiting-on-review,S-waiting-on-perf,S-waiting-on-review,S-waiting-on-review,S-waiting-on-review,S-waiting-on-review,S-waiting-on-review,S-waiting-on-review,S-waiting-on-review,S-waiting-on-review",58664,2019-02-23T00:44:30Z,0,0,0
"S-waiting-on-review,S-waiting-on-perf,S-waiting-on-review,S-waiting-on-review,S-waiting-on-review,S-waiting-on-review,S-waiting-on-review,S-waiting-on-review,S-waiting-on-review,S-waiting-on-review,S-waiting-on-review,S-waiting-on-review,S-waiting-on-bors,S-waiting-on-review,S-waiting-on-review;T-release;beta-accepted;beta-nominated,S-waiting-on-review",58665,2019-02-23T01:18:46Z,0,0,0
"S-waiting-on-review,S-waiting-on-review,S-waiting-on-review,S-waiting-on-review,S-waiting-on-bors,S-waiting-on-review,S-waiting-on-review;T-release;beta-accepted;beta-nominated,S-waiting-on-review,S-waiting-on-perf,S-waiting-on-review,S-waiting-on-review,S-waiting-on-review,S-waiting-on-review,S-waiting-on-review,S-waiting-on-review",58666,2019-02-23T04:12:50Z,0,0,0
"A-const-eval;E-easy;E-mentor,A-const-eval;E-easy;E-mentor",58667,2019-02-23T05:47:43Z,2,2,4
"S-waiting-on-review;T-release;beta-accepted;beta-nominated,S-waiting-on-review,S-waiting-on-review,S-waiting-on-perf,S-waiting-on-review,S-waiting-on-review,S-waiting-on-review,S-waiting-on-review,S-waiting-on-review,S-waiting-on-review,S-waiting-on-review,S-waiting-on-review,S-waiting-on-review,S-waiting-on-review,S-waiting-on-bors,S-waiting-on-review",58668,2019-02-23T07:47:55Z,0,0,0
"S-waiting-on-review,S-waiting-on-review,S-waiting-on-review,S-waiting-on-review,S-waiting-on-review,S-waiting-on-bors,S-waiting-on-review,S-waiting-on-review;T-release;beta-accepted;beta-nominated,S-waiting-on-review,S-waiting-on-review,S-waiting-on-perf,S-waiting-on-review,S-waiting-on-review,S-waiting-on-review,S-waiting-on-review,S-waiting-on-review",58669,2019-02-23T08:25:41Z,1125,765,1890
A-async-await;T-compiler,58678,2019-02-23T18:47:04Z,215,62,277
"S-waiting-on-bors,S-waiting-on-review",58679,2019-02-23T18:54:35Z,305,197,502
NULL,58680,2019-02-23T18:57:54Z,1,1,2
NULL,58683,2019-02-23T20:17:34Z,0,0,0
"A-const-eval;E-easy;E-mentor,A-const-eval;E-easy;E-mentor",58687,2019-02-24T00:04:47Z,1,2,3
"S-waiting-on-review,S-waiting-on-review,S-waiting-on-review,S-waiting-on-review,S-waiting-on-review,S-waiting-on-review;T-libs;disposition-merge;proposed-final-comment-period",58688,2019-02-24T01:45:11Z,0,0,0
"A-const-eval;E-easy;E-mentor,A-const-eval;E-easy;E-mentor",58690,2019-02-24T04:01:12Z,2,3,5
"S-waiting-on-review,S-waiting-on-review,S-waiting-on-review,S-waiting-on-review,S-waiting-on-review;T-libs;disposition-merge;proposed-final-comment-period,S-waiting-on-review",58691,2019-02-24T04:56:04Z,583,398,981
"S-waiting-on-review,S-waiting-on-review",58698,2019-02-24T13:19:03Z,0,0,0
T-compiler,58701,2019-02-24T14:29:22Z,0,0,0
C-tracking-issue;T-compiler;WG-epoch,58702,2019-02-24T14:41:29Z,343,333,676
C-tracking-issue;T-compiler;WG-epoch,58704,2019-02-24T15:45:11Z,0,25,25
S-waiting-on-review,58706,2019-02-24T16:47:26Z,1,1,2
"S-waiting-on-bors,S-waiting-on-review,S-waiting-on-review,S-waiting-on-review;T-libs;disposition-merge;needs-fcp;proposed-final-comment-period;relnotes,S-waiting-on-review",58714,2019-02-25T02:18:07Z,634,669,1303
NULL,58717,2019-02-25T06:13:48Z,50,4,54
"S-waiting-on-review,S-waiting-on-review,S-waiting-on-bors,S-waiting-on-bors,S-waiting-on-review,S-waiting-on-review,S-waiting-on-bors",58724,2019-02-25T08:40:21Z,0,0,0
"S-waiting-on-bors,S-waiting-on-review,S-waiting-on-review,S-waiting-on-bors,S-waiting-on-review,S-waiting-on-review,A-lang,S-waiting-on-bors,S-waiting-on-bors,S-waiting-on-review",58726,2019-02-25T08:55:40Z,0,0,0
"S-waiting-on-review,S-waiting-on-bors,S-waiting-on-bors,S-waiting-on-review,S-waiting-on-review,A-lang,S-waiting-on-bors,S-waiting-on-bors,S-waiting-on-review,S-waiting-on-bors,S-waiting-on-review",58728,2019-02-25T10:42:33Z,625,524,1149
"S-waiting-on-review,S-waiting-on-review,S-waiting-on-review,S-waiting-on-review,S-waiting-on-review,S-waiting-on-review",58738,2019-02-25T20:18:45Z,0,0,0
A-NLL;P-high;T-compiler,58739,2019-02-25T20:45:00Z,455,207,662
NULL,58741,2019-02-25T22:16:48Z,8,4,12
"A-inline-assembly,I-wrong,A-diagnostics",58743,2019-02-25T23:57:52Z,305,0,305
"A-const-eval;E-easy;E-mentor,A-const-eval;E-easy;E-mentor",58749,2019-02-26T09:01:51Z,8,7,15
NULL,58753,2019-02-26T11:22:11Z,0,0,0
S-waiting-on-review,58754,2019-02-26T15:01:10Z,368,429,797
NULL,58756,2019-02-26T15:49:48Z,0,0,0
A-const-eval;C-bug;I-ICE;T-compiler,58757,2019-02-26T16:01:34Z,15,1,16
C-tracking-issue;I-nominated;T-lang,58761,2019-02-26T19:22:54Z,3,3,6
C-tracking-issue;I-nominated;T-lang,58762,2019-02-26T20:13:42Z,74,34,108
"S-waiting-on-review,S-waiting-on-review,S-waiting-on-review,A-diagnostics,S-waiting-on-review,S-waiting-on-review,S-waiting-on-review,S-waiting-on-review,S-waiting-on-review,S-waiting-on-review,S-waiting-on-review,S-waiting-on-review,S-waiting-on-review,S-waiting-on-bors,S-waiting-on-review,S-waiting-on-review,S-waiting-on-review,S-waiting-on-review,S-waiting-on-review",58763,2019-02-27T00:00:54Z,0,0,0
"S-waiting-on-review,S-waiting-on-review,S-waiting-on-review,S-waiting-on-review,S-waiting-on-bors,S-waiting-on-review,S-waiting-on-review,S-waiting-on-review,S-waiting-on-review,S-waiting-on-review,S-waiting-on-review,S-waiting-on-review,S-waiting-on-review,A-diagnostics,S-waiting-on-review,S-waiting-on-review,S-waiting-on-review,S-waiting-on-review",58764,2019-02-27T01:43:54Z,0,0,0
"S-waiting-on-review,S-waiting-on-review,S-waiting-on-review,S-waiting-on-review,S-waiting-on-review,S-waiting-on-review,A-diagnostics,S-waiting-on-review,S-waiting-on-review,S-waiting-on-review,S-waiting-on-review,S-waiting-on-review,S-waiting-on-review,S-waiting-on-review,S-waiting-on-review,S-waiting-on-review,S-waiting-on-review",58766,2019-02-27T05:24:55Z,0,0,0
"S-waiting-on-review,S-waiting-on-review,S-waiting-on-review,S-waiting-on-review,S-waiting-on-review,S-waiting-on-review,S-waiting-on-review,S-waiting-on-review,S-waiting-on-review,S-waiting-on-review,S-waiting-on-review,S-waiting-on-review,A-diagnostics,S-waiting-on-review,S-waiting-on-review,S-waiting-on-review",58770,2019-02-27T08:01:32Z,0,0,0
"S-waiting-on-review,S-waiting-on-review,S-waiting-on-review,S-waiting-on-review,S-waiting-on-review,S-waiting-on-review,S-waiting-on-review,S-waiting-on-review,A-diagnostics,S-waiting-on-review,S-waiting-on-review,S-waiting-on-review,S-waiting-on-review,S-waiting-on-review,S-waiting-on-review",58777,2019-02-27T12:32:39Z,409,283,692
S-waiting-on-review,58782,2019-02-27T16:09:15Z,3,3,6
"S-waiting-on-review,E-medium",58783,2019-02-27T16:15:12Z,0,0,0
S-waiting-on-review,58785,2019-02-27T18:03:23Z,19,7,26
A-NLL;I-unsound%20%F0%9F%92%A5;NLL-sound;P-high;T-compiler,58788,2019-02-27T21:06:06Z,129,25,154
S-waiting-on-review,58791,2019-02-27T22:58:01Z,327,140,467
"S-waiting-on-review,S-waiting-on-bors,S-waiting-on-bors,S-waiting-on-review,S-waiting-on-review,S-waiting-on-review,S-waiting-on-bors,S-waiting-on-review",58798,2019-02-28T02:43:02Z,0,0,0
"S-waiting-on-bors,S-waiting-on-review,S-waiting-on-review,S-waiting-on-review,S-waiting-on-bors,S-waiting-on-review,S-waiting-on-review",58799,2019-02-28T04:20:53Z,0,0,0
"S-waiting-on-bors,S-waiting-on-review,S-waiting-on-review,S-waiting-on-bors,S-waiting-on-review,S-waiting-on-review",58801,2019-02-28T06:06:13Z,0,0,0
"A-libs,A-libs",58803,2019-02-28T09:29:42Z,83,59,142
"A-resolve,A-resolve",58805,2019-02-28T10:48:07Z,198,42,240
S-waiting-on-review,58807,2019-02-28T12:35:41Z,8,8,16
S-waiting-on-review,58810,2019-02-28T14:52:56Z,0,0,0
"S-waiting-on-bors,S-waiting-on-review,S-waiting-on-review,S-waiting-on-bors,S-waiting-on-bors;merged-by-bors,S-waiting-on-bors",58820,2019-02-28T21:31:23Z,0,0,0
NULL,58824,2019-02-28T22:35:40Z,296,153,449
S-waiting-on-review,58829,2019-03-01T09:19:53Z,2,2,4
"S-waiting-on-bors,S-waiting-on-bors;T-compiler;beta-accepted;beta-nominated,S-waiting-on-bors,S-waiting-on-bors,S-waiting-on-review,S-waiting-on-review,S-waiting-on-review,S-waiting-on-review,S-waiting-on-bors,S-waiting-on-review,S-waiting-on-bors",58831,2019-03-01T09:38:48Z,0,0,0
S-waiting-on-review,58836,2019-03-01T10:30:53Z,528,558,1086
NULL,58839,2019-03-01T12:40:37Z,0,0,0
A-build,58842,2019-03-01T14:29:22Z,1,1,2
S-waiting-on-review,58846,2019-03-01T14:54:02Z,693,759,1452
C-bug;T-rustdoc,58848,2019-03-01T16:04:04Z,31,16,47
"S-waiting-on-review,S-waiting-on-review",58852,2019-03-01T18:35:47Z,8,24,32
"S-waiting-on-review,S-waiting-on-review,S-waiting-on-review,S-waiting-on-review",58854,2019-03-01T19:29:18Z,4,2,6
C-bug;I-ICE;T-compiler;regression-from-stable-to-beta,58861,2019-03-01T22:43:32Z,43,24,67
A-parser;C-bug;I-ICE;I-nominated;T-compiler;regression-from-stable-to-beta,58863,2019-03-02T00:52:52Z,0,0,0
regression-from-stable-to-nightly,58865,2019-03-02T01:08:29Z,15,3,18
"S-waiting-on-bors,S-waiting-on-bors,S-waiting-on-bors,S-waiting-on-review,S-waiting-on-bors,S-waiting-on-bors,S-waiting-on-bors,S-waiting-on-bors,S-waiting-on-bors,S-waiting-on-bors,S-waiting-on-bors,S-waiting-on-bors,S-waiting-on-bors,S-waiting-on-bors",58866,2019-03-02T06:55:27Z,125,101,226
NULL,58872,2019-03-02T14:33:18Z,25,3,28
C-bug;T-rustdoc,58873,2019-03-02T16:17:52Z,37,32,69
A-diagnostics;A-lifetimes;A-parser;A-suggestion-diagnostics,58876,2019-03-02T18:39:30Z,47,3,50
A-suggestion-diagnostics,58877,2019-03-02T19:26:42Z,54,3,57
"S-waiting-on-review,S-waiting-on-bors,S-waiting-on-bors,S-waiting-on-review,S-waiting-on-bors,S-waiting-on-bors,S-waiting-on-bors,S-waiting-on-review,S-waiting-on-bors,S-waiting-on-bors,S-waiting-on-bors,S-waiting-on-bors,S-waiting-on-bors,S-waiting-on-review,S-waiting-on-bors",58878,2019-03-02T19:54:31Z,0,0,0
I-nominated;T-compiler,58879,2019-03-02T20:01:47Z,23,1,24
I-nominated;T-compiler,58880,2019-03-02T20:03:48Z,0,0,0
NULL,58894,2019-03-03T15:04:51Z,27,11,38
S-waiting-on-review,58899,2019-03-03T17:41:18Z,565,511,1076
A-spurious;C-tracking-issue;O-android;T-infra,58900,2019-03-03T17:41:29Z,0,0,0
C-enhancement;O-macos;T-libs,58901,2019-03-03T19:53:38Z,108,2,110
A-mir;T-compiler,58902,2019-03-03T20:00:53Z,129,60,189
A-parser;C-bug;P-high;regression-from-stable-to-beta,58903,2019-03-03T20:15:26Z,181,70,251
A-async-await;C-bug;I-ICE;T-compiler,58906,2019-03-03T23:06:44Z,28,0,28
E-easy,58908,2019-03-04T07:25:22Z,2,2,4
"S-waiting-on-bors,S-waiting-on-bors",58909,2019-03-04T07:47:47Z,0,0,0
NULL,58911,2019-03-04T12:17:37Z,17,0,17
A-traits;I-ICE,58912,2019-03-04T12:56:13Z,14,0,14
S-waiting-on-review,58915,2019-03-04T14:46:14Z,438,488,926
NULL,58917,2019-03-04T18:11:34Z,0,0,0
NULL,58918,2019-03-04T18:56:26Z,28,0,28
A-diagnostics;A-impl-trait;T-compiler,58919,2019-03-04T19:52:49Z,48,19,67
NULL,58921,2019-03-04T21:32:43Z,15,0,15
A-specialization;C-bug;T-rustdoc,58927,2019-03-05T01:29:47Z,51,7,58
NULL,58929,2019-03-05T03:27:00Z,74,21,95
NULL,58931,2019-03-05T05:30:52Z,33,1,34
S-waiting-on-review,58933,2019-03-05T09:02:57Z,27,19,46
NULL,58938,2019-03-05T13:59:30Z,7,7,14
A-spurious;C-bug;T-infra,58946,2019-03-05T18:19:40Z,0,0,0
S-waiting-on-review,58947,2019-03-05T19:14:42Z,0,0,0
C-bug;T-compiler,58948,2019-03-05T20:14:28Z,36,1,37
S-waiting-on-review,58953,2019-03-05T23:08:32Z,186,809,995
NULL,58959,2019-03-06T01:04:02Z,3,0,3
A-attributes;A-diagnostics;T-compiler,58961,2019-03-06T03:05:28Z,6,6,12
S-waiting-on-review,58966,2019-03-06T07:36:18Z,0,0,0
NULL,58970,2019-03-06T13:29:54Z,47,4,51
S-waiting-on-review,58972,2019-03-06T16:54:08Z,28,0,28
S-waiting-on-review,58974,2019-03-06T18:23:15Z,0,0,0
T-libs,58975,2019-03-06T18:24:50Z,126,0,126
S-waiting-on-review,58976,2019-03-06T19:00:05Z,1,1,2
NULL,58981,2019-03-07T02:32:13Z,135,3,138
B-unstable;C-feature-request;T-compiler,58984,2019-03-07T03:52:51Z,56,27,83
NULL,58985,2019-03-07T04:10:00Z,27,9,36
NULL,58986,2019-03-07T04:14:59Z,21,1,22
NULL,58991,2019-03-07T11:26:23Z,0,0,0
"S-waiting-on-bors,S-waiting-on-review",58992,2019-03-07T12:00:21Z,0,0,0
S-waiting-on-review,58995,2019-03-07T17:15:21Z,197,204,401
A-macros;B-unstable;T-lang;T-libs,59002,2019-03-07T21:10:21Z,0,0,0
T-rustdoc,59004,2019-03-07T22:49:53Z,308,40,348
C-bug;I-ICE;T-compiler,59007,2019-03-07T23:39:24Z,12,0,12
S-waiting-on-review,59008,2019-03-08T01:24:21Z,1414,213,1627
"S-waiting-on-bors,S-waiting-on-bors,S-waiting-on-bors,S-waiting-on-review,S-waiting-on-bors,S-waiting-on-author,S-waiting-on-review,S-waiting-on-review,S-waiting-on-bors;T-compiler,S-waiting-on-review,S-waiting-on-bors,S-waiting-on-review,S-waiting-on-bors,S-waiting-on-bors,S-waiting-on-review,S-waiting-on-review,S-waiting-on-bors,S-waiting-on-bors,A-traits;I-ICE,S-waiting-on-bors;beta-nominated,S-waiting-on-author,S-waiting-on-bors,S-waiting-on-review,S-waiting-on-review,S-waiting-on-bors,S-waiting-on-review;beta-accepted;beta-nominated;stable-accepted;stable-nominated,S-waiting-on-bors",59012,2019-03-08T08:42:16Z,588,106,694
A-spurious;C-bug;O-windows;T-infra,59018,2019-03-08T15:42:25Z,0,15,15
NULL,59025,2019-03-08T19:10:10Z,69,59,128
T-rustdoc,59026,2019-03-08T19:12:56Z,1,1,2
C-bug;T-rustdoc,59033,2019-03-09T01:28:21Z,11,11,22
NULL,59035,2019-03-09T03:09:20Z,53,1,54
S-waiting-on-review,59042,2019-03-09T08:42:15Z,184,205,389
"S-waiting-on-review,S-waiting-on-review,S-waiting-on-review,S-waiting-on-review,S-waiting-on-bors,S-waiting-on-review,S-waiting-on-review,S-waiting-on-review,S-waiting-on-review,E-easy;E-mentor,S-waiting-on-bors,S-waiting-on-bors,S-waiting-on-review,S-waiting-on-bors,S-waiting-on-review",59043,2019-03-09T09:09:29Z,0,0,0
S-waiting-on-review,59044,2019-03-09T11:56:18Z,7506,7548,15054
"E-easy;E-mentor,S-waiting-on-bors,S-waiting-on-review,S-waiting-on-bors,S-waiting-on-review,S-waiting-on-review,S-waiting-on-review,S-waiting-on-review,S-waiting-on-review,S-waiting-on-bors,S-waiting-on-review,S-waiting-on-review,S-waiting-on-review,S-waiting-on-review",59046,2019-03-09T13:08:52Z,0,0,0
S-waiting-on-review,59047,2019-03-09T13:17:24Z,49,11,60
"S-waiting-on-review,S-waiting-on-review,S-waiting-on-review,S-waiting-on-review,S-waiting-on-bors,S-waiting-on-review,S-waiting-on-review,S-waiting-on-review,S-waiting-on-review,E-easy;E-mentor,S-waiting-on-bors,S-waiting-on-review,S-waiting-on-bors,S-waiting-on-review",59050,2019-03-09T16:18:30Z,1394,390,1784
NULL,59058,2019-03-10T09:20:11Z,217,92,309
"S-waiting-on-review,S-waiting-on-review,S-waiting-on-review,S-waiting-on-review,S-waiting-on-review,S-waiting-on-review,S-waiting-on-review,S-waiting-on-bors;T-libs,S-waiting-on-review,S-waiting-on-author,S-waiting-on-bors;T-compiler;beta-accepted;beta-nominated,S-waiting-on-bors,S-waiting-on-review,S-waiting-on-crater,S-waiting-on-review,S-waiting-on-bors,S-waiting-on-review",59066,2019-03-10T12:10:04Z,0,0,0
"S-waiting-on-author,S-waiting-on-review,S-waiting-on-bors;T-compiler;beta-accepted;beta-nominated,S-waiting-on-bors,S-waiting-on-review,S-waiting-on-review,S-waiting-on-bors,S-waiting-on-review,S-waiting-on-review,S-waiting-on-review,S-waiting-on-review,S-waiting-on-review,S-waiting-on-review,S-waiting-on-review,S-waiting-on-review,S-waiting-on-review,S-waiting-on-bors;T-libs,S-waiting-on-review",59067,2019-03-10T12:29:22Z,0,0,0
"S-waiting-on-bors,S-waiting-on-review,S-waiting-on-review,S-waiting-on-review,S-waiting-on-review,S-waiting-on-review,S-waiting-on-review,S-waiting-on-review,S-waiting-on-review,S-waiting-on-review,S-waiting-on-bors;T-libs,S-waiting-on-review,S-waiting-on-author,S-waiting-on-review,S-waiting-on-bors,S-waiting-on-review,S-waiting-on-review",59069,2019-03-10T16:09:47Z,0,0,0
NULL,59070,2019-03-10T16:30:28Z,0,0,0
I-nominated;T-compiler,59073,2019-03-10T16:59:16Z,12,9,21
"S-waiting-on-bors;T-libs,S-waiting-on-review,S-waiting-on-author,S-waiting-on-review,S-waiting-on-bors,S-waiting-on-review,S-waiting-on-bors,S-waiting-on-review,S-waiting-on-review,S-waiting-on-review,S-waiting-on-review,S-waiting-on-bors;T-compiler;beta-accepted;beta-nominated,S-waiting-on-review,S-waiting-on-review,S-waiting-on-review,S-waiting-on-review,S-waiting-on-review,S-waiting-on-review",59075,2019-03-10T21:09:34Z,0,0,0
"S-waiting-on-review,S-waiting-on-review",59078,2019-03-10T23:54:36Z,0,0,0
"S-waiting-on-review,S-waiting-on-review,S-waiting-on-review,S-waiting-on-review,S-waiting-on-bors;T-compiler;beta-accepted;beta-nominated,S-waiting-on-review,S-waiting-on-review,S-waiting-on-review,S-waiting-on-review,S-waiting-on-review,S-waiting-on-review,S-waiting-on-bors;T-libs,S-waiting-on-review,S-waiting-on-author,S-waiting-on-review,S-waiting-on-bors",59081,2019-03-11T02:03:04Z,0,0,0
NULL,59083,2019-03-11T02:46:52Z,41,36,77
S-waiting-on-review,59092,2019-03-11T08:48:04Z,0,0,0
S-waiting-on-review,59096,2019-03-11T10:07:01Z,55,52,107
NULL,59102,2019-03-11T14:56:47Z,129,11,140
NULL,59106,2019-03-11T16:14:14Z,69,2,71
"S-waiting-on-review,S-waiting-on-review,S-waiting-on-review,S-waiting-on-bors,S-waiting-on-bors;T-libs,S-waiting-on-review,S-waiting-on-review,S-waiting-on-review,S-waiting-on-review,S-waiting-on-review,S-waiting-on-bors,S-waiting-on-review,S-waiting-on-review,S-waiting-on-review,S-waiting-on-review,S-waiting-on-review,S-waiting-on-review,S-waiting-on-review,S-waiting-on-review,S-waiting-on-review,S-waiting-on-review,S-waiting-on-review,S-waiting-on-review",59108,2019-03-11T17:25:01Z,0,0,0
"S-waiting-on-review,A-NLL,A-lifetimes,T-compiler,A-borrow-checker",59114,2019-03-11T20:07:16Z,6035,22244,28279
A-diagnostics;A-macros;C-enhancement,59116,2019-03-11T22:08:02Z,27,9,36
A-traits;C-bug;I-ICE;T-compiler,59118,2019-03-11T23:40:51Z,29,2,31
A-async-await;B-RFC-approved;B-RFC-implemented;B-unstable;C-tracking-issue;T-lang;T-libs,59119,2019-03-11T23:57:47Z,176,70,246
NULL,59129,2019-03-12T12:38:03Z,44,1,45
NULL,59132,2019-03-12T15:00:47Z,62,2,64
NULL,59135,2019-03-12T16:38:07Z,0,0,0
S-waiting-on-review,59136,2019-03-12T18:05:22Z,236,94,330
"S-waiting-on-review,S-waiting-on-bors,S-waiting-on-review,S-waiting-on-author,S-waiting-on-review,S-waiting-on-review,S-waiting-on-bors,S-waiting-on-review,S-waiting-on-review,S-waiting-on-review,S-waiting-on-bors,S-waiting-on-bors;T-libs,S-waiting-on-review,S-waiting-on-review",59141,2019-03-12T19:11:59Z,0,0,0
NULL,59146,2019-03-12T21:57:39Z,76,5,81
NULL,59150,2019-03-13T02:30:29Z,302,22,324
"S-waiting-on-bors,S-waiting-on-review,S-waiting-on-review,S-waiting-on-review,S-waiting-on-review,S-waiting-on-review,S-waiting-on-bors;T-libs,S-waiting-on-review,S-waiting-on-review,S-waiting-on-bors,S-waiting-on-review,S-waiting-on-review,S-waiting-on-review,S-waiting-on-review,S-waiting-on-review,S-waiting-on-bors",59151,2019-03-13T02:33:59Z,526,367,893
NULL,59155,2019-03-13T07:57:44Z,0,0,0
NULL,59156,2019-03-13T11:40:44Z,30,0,30
"S-waiting-on-review,S-waiting-on-review,T-rustdoc",59158,2019-03-13T14:41:09Z,1,5,6
"S-waiting-on-review,S-waiting-on-review,S-waiting-on-review,S-waiting-on-review,S-waiting-on-review,S-waiting-on-review,S-waiting-on-review,S-waiting-on-review,S-waiting-on-review,S-waiting-on-review,S-waiting-on-review,S-waiting-on-review,S-waiting-on-review,S-waiting-on-review,S-waiting-on-bors,S-waiting-on-review,S-waiting-on-review,S-waiting-on-review",59161,2019-03-13T15:56:16Z,0,0,0
"S-waiting-on-review,S-waiting-on-review,S-waiting-on-crater,S-waiting-on-review,S-waiting-on-review,S-waiting-on-review,S-waiting-on-review,S-waiting-on-author,S-waiting-on-review",59165,2019-03-13T20:50:22Z,0,0,0
S-waiting-on-review,59170,2019-03-13T23:42:16Z,156,117,273
A-LLVM;A-build;O-linux;T-compiler;regression-from-stable-to-nightly,59173,2019-03-14T01:27:40Z,27,1,28
I-nominated;T-compiler,59181,2019-03-14T14:25:43Z,1,1,2
"S-waiting-on-review,S-waiting-on-review,S-waiting-on-review,S-waiting-on-review,S-waiting-on-review,S-waiting-on-review,S-waiting-on-review,S-waiting-on-review,S-waiting-on-review,S-waiting-on-review,S-waiting-on-review,S-waiting-on-review,S-waiting-on-review,S-waiting-on-review,S-waiting-on-review,S-waiting-on-review",59183,2019-03-14T15:05:07Z,0,0,0
"S-waiting-on-review,S-waiting-on-review",59186,2019-03-14T16:46:34Z,351,122,473
NULL,59195,2019-03-14T23:12:07Z,74,1,75
A-diagnostics,59198,2019-03-15T01:29:34Z,5,28,33
A-diagnostics;A-typesystem;T-compiler,59199,2019-03-15T02:40:21Z,45,50,95
S-waiting-on-review,59205,2019-03-15T10:38:56Z,0,0,0
NULL,59213,2019-03-15T15:07:30Z,19,0,19
C-cleanup;E-easy;E-mentor,59216,2019-03-15T17:12:04Z,24,19,43
"S-waiting-on-review,S-waiting-on-review,S-waiting-on-review,S-waiting-on-bors,S-waiting-on-review,S-waiting-on-bors;T-infra,S-waiting-on-review,S-waiting-on-review,S-waiting-on-review,S-waiting-on-review,S-waiting-on-bors,S-waiting-on-review,S-waiting-on-review,S-waiting-on-review",59223,2019-03-16T01:13:49Z,0,0,0
"S-waiting-on-bors;T-infra,S-waiting-on-review,S-waiting-on-review,S-waiting-on-bors,S-waiting-on-review,S-waiting-on-review,S-waiting-on-review,S-waiting-on-review,S-waiting-on-bors,S-waiting-on-review,S-waiting-on-review,S-waiting-on-review,S-waiting-on-bors,S-waiting-on-bors;T-libs;relnotes,S-waiting-on-review,S-waiting-on-review,S-waiting-on-review;beta-accepted;beta-nominated;stable-accepted;stable-nominated,S-waiting-on-review,S-waiting-on-review,S-waiting-on-review,S-waiting-on-review,S-waiting-on-review,S-waiting-on-review,S-waiting-on-review,S-waiting-on-review,S-waiting-on-review,S-waiting-on-review,S-waiting-on-review,S-waiting-on-review,S-waiting-on-review,S-waiting-on-review,S-waiting-on-review,S-waiting-on-review,S-waiting-on-bors",59226,2019-03-16T06:57:09Z,1184,492,1676
NULL,59231,2019-03-16T11:13:15Z,2,7,9
A-const-eval;A-mir;C-cleanup;E-help-wanted;E-medium,59232,2019-03-16T12:13:12Z,233,210,443
NULL,59234,2019-03-16T13:52:52Z,7,0,7
"S-waiting-on-bors;T-compiler;beta-accepted;beta-nominated,I-nominated;S-waiting-on-review;T-compiler,S-waiting-on-review,S-waiting-on-bors;beta-nominated,S-waiting-on-bors;T-compiler;beta-accepted;beta-nominated,S-waiting-on-bors",59235,2019-03-16T15:40:15Z,950,235,1185
"S-waiting-on-review,A-LLVM;A-codegen",59242,2019-03-16T20:19:02Z,29,2,31
"S-waiting-on-review,S-waiting-on-review,S-waiting-on-bors,S-waiting-on-review,S-waiting-on-review,S-waiting-on-bors,S-waiting-on-review,S-waiting-on-review,S-waiting-on-review,S-waiting-on-review,S-waiting-on-review",59244,2019-03-16T21:46:30Z,0,0,0
S-waiting-on-bors;T-infra,59253,2019-03-17T11:42:00Z,12,1,13
O-redox,59257,2019-03-17T14:20:45Z,4,10,14
A-suggestion-diagnostics,59258,2019-03-17T15:38:09Z,44,7,51
S-waiting-on-crater,59259,2019-03-17T16:01:57Z,403,296,699
C-bug;E-easy;E-mentor;I-slow;T-libs,59262,2019-03-17T18:39:34Z,24,98,122
A-diagnostics,59266,2019-03-18T03:11:48Z,111,58,169
A-diagnostics,59267,2019-03-18T04:19:24Z,66,55,121
NULL,59268,2019-03-18T05:44:02Z,42,0,42
"S-waiting-on-bors,S-waiting-on-review,S-waiting-on-review,S-waiting-on-bors,S-waiting-on-review,S-waiting-on-review,S-waiting-on-review,S-waiting-on-bors",59271,2019-03-18T08:06:22Z,0,0,0
S-waiting-on-review,59276,2019-03-18T13:24:04Z,488,397,885
I-nominated;T-compiler,59279,2019-03-18T17:11:25Z,55,81,136
NULL,59280,2019-03-18T19:00:10Z,2,5,7
S-waiting-on-review,59282,2019-03-18T19:54:35Z,0,0,0
B-RFC-approved;C-tracking-issue;T-lang,59288,2019-03-19T06:19:09Z,725,675,1400
"S-waiting-on-review,S-waiting-on-review,S-waiting-on-review,S-waiting-on-review,S-waiting-on-review,S-waiting-on-review,S-waiting-on-review,S-waiting-on-bors,S-waiting-on-review;relnotes,S-waiting-on-author,S-waiting-on-review,S-waiting-on-review",59289,2019-03-19T08:50:21Z,0,0,0
S-waiting-on-review,59290,2019-03-19T11:40:38Z,23,0,23
"S-waiting-on-review,S-waiting-on-review;T-libs;needs-fcp;relnotes,S-waiting-on-review,S-waiting-on-bors,S-waiting-on-review,S-waiting-on-bors,S-waiting-on-review,S-waiting-on-review;relnotes,S-waiting-on-review,S-waiting-on-review,S-waiting-on-review,S-waiting-on-bors,S-waiting-on-review,S-waiting-on-review;T-libs;needs-fcp;relnotes,S-waiting-on-review,S-waiting-on-review,S-waiting-on-review,S-waiting-on-bors,S-waiting-on-review;relnotes,S-waiting-on-review,S-waiting-on-review,S-waiting-on-review",59293,2019-03-19T14:17:05Z,315,72,387
"S-waiting-on-review,S-waiting-on-review,S-waiting-on-review,S-waiting-on-bors,S-waiting-on-review;beta-accepted;beta-nominated;stable-accepted;stable-nominated",59295,2019-03-19T16:16:10Z,104,35,139
A-diagnostics;A-resolve,59296,2019-03-19T19:56:22Z,20,4,24
"S-waiting-on-review,S-waiting-on-review,S-waiting-on-bors,S-waiting-on-review,S-waiting-on-review",59298,2019-03-19T20:34:09Z,122,49,171
"S-waiting-on-review,S-waiting-on-review,S-waiting-on-bors,S-waiting-on-bors,S-waiting-on-bors,S-waiting-on-review,S-waiting-on-review,S-waiting-on-review,S-waiting-on-review,S-waiting-on-review",59300,2019-03-19T22:50:03Z,0,0,0
S-waiting-on-review,59303,2019-03-19T23:44:05Z,33,19,52
E-mentor;I-compiletime;T-compiler,59312,2019-03-20T10:55:50Z,0,0,0
A-ffi;C-feature-request;T-libs,59314,2019-03-20T14:38:12Z,0,0,0
"T-compiler,S-waiting-on-review",59316,2019-03-20T15:29:49Z,684,103,787
NULL,59328,2019-03-20T21:13:16Z,30,0,30
NULL,59330,2019-03-20T22:25:37Z,89,78,167
S-waiting-on-review,59331,2019-03-21T00:02:21Z,251,99,350
NULL,59334,2019-03-21T04:34:17Z,16,0,16
"S-waiting-on-review,B-RFC-approved;C-tracking-issue;T-cargo",59335,2019-03-21T05:56:43Z,158,56,214
S-waiting-on-review,59338,2019-03-21T10:42:17Z,0,0,0
S-waiting-on-review,59341,2019-03-21T14:53:27Z,36,11,47
S-waiting-on-review,59343,2019-03-21T16:33:29Z,19,48,67
T-rustdoc,59349,2019-03-21T21:46:48Z,0,0,0
NULL,59351,2019-03-21T22:44:38Z,1,0,1
A-const-generics,59355,2019-03-22T01:50:02Z,37,9,46
A-const-eval;E-easy;E-mentor,59358,2019-03-22T07:21:21Z,12,6,18
"C-enhancement;S-waiting-on-review;T-libs,C-enhancement;S-waiting-on-review;T-libs",59360,2019-03-22T10:26:11Z,2,2,4
A-driver;C-enhancement;I-needs-decision;T-compiler,59363,2019-03-22T11:57:28Z,6,6,12
"S-waiting-on-review,S-waiting-on-bors,S-waiting-on-review,S-waiting-on-bors,S-waiting-on-review,S-waiting-on-review,S-waiting-on-review,S-waiting-on-review,S-waiting-on-bors;T-doc,S-waiting-on-review,S-waiting-on-review,S-waiting-on-review,S-waiting-on-review,S-waiting-on-review,S-waiting-on-review,S-waiting-on-bors,S-waiting-on-bors,S-waiting-on-review,S-waiting-on-review,S-waiting-on-review,S-waiting-on-review,S-waiting-on-review,S-waiting-on-bors,S-waiting-on-bors",59364,2019-03-22T12:53:00Z,0,0,0
C-bug;I-ICE;T-compiler,59369,2019-03-22T17:55:15Z,0,0,0
"S-waiting-on-review,S-waiting-on-review,S-waiting-on-review,S-waiting-on-review,S-waiting-on-bors,S-waiting-on-review,S-waiting-on-bors,S-waiting-on-review,S-waiting-on-review,S-waiting-on-review,S-waiting-on-review,S-waiting-on-bors,S-waiting-on-review,S-waiting-on-review,S-waiting-on-review,S-waiting-on-bors,S-waiting-on-review,S-waiting-on-review",59370,2019-03-22T18:31:42Z,1055,756,1811
S-waiting-on-review,59372,2019-03-22T19:05:29Z,20,4,24
NULL,59376,2019-03-23T02:17:59Z,219,216,435
NULL,59381,2019-03-23T10:11:43Z,0,0,0
S-waiting-on-review,59382,2019-03-23T11:54:32Z,859,780,1639
"S-waiting-on-bors,S-waiting-on-review,S-waiting-on-bors,S-waiting-on-bors,S-waiting-on-bors,I-nominated;S-waiting-on-team;T-infra;T-release,S-waiting-on-review;T-compiler,S-waiting-on-bors,S-waiting-on-bors",59387,2019-03-23T18:53:17Z,0,0,0
T-doc,59390,2019-03-24T01:27:40Z,48,2,50
NULL,59394,2019-03-24T03:03:32Z,12,6,18
NULL,59395,2019-03-24T04:18:25Z,0,0,0
"S-waiting-on-review,S-waiting-on-bors,S-waiting-on-review,I-nominated;S-waiting-on-team;T-infra;T-release,S-waiting-on-bors,S-waiting-on-review,S-waiting-on-review",59397,2019-03-24T07:32:58Z,233,74,307
"T-rustdoc,S-waiting-on-review",59400,2019-03-24T16:21:46Z,0,0,0
S-waiting-on-review,59402,2019-03-24T20:31:35Z,0,0,0
A-diagnostics,59403,2019-03-24T20:32:46Z,0,0,0
S-waiting-on-review,59404,2019-03-24T21:06:10Z,0,0,0
NULL,59408,2019-03-25T05:13:37Z,247,154,401
NULL,59409,2019-03-25T10:32:10Z,0,0,0
S-waiting-on-review,59413,2019-03-25T14:05:51Z,106,81,187
I-compiletime;T-compiler;WG-compiler-performance,59417,2019-03-25T18:43:19Z,0,0,0
NULL,59421,2019-03-25T23:11:47Z,120,74,194
A-lint;C-cleanup;T-compiler,59423,2019-03-25T23:37:20Z,3,3,6
C-bug;T-rustdoc,59424,2019-03-25T23:39:30Z,8,0,8
"S-waiting-on-review,S-waiting-on-review,S-waiting-on-review,S-waiting-on-review,S-waiting-on-review,S-waiting-on-review,S-waiting-on-review,S-waiting-on-bors,S-waiting-on-review,S-waiting-on-bors,S-waiting-on-review,S-waiting-on-bors;T-doc",59428,2019-03-26T02:21:07Z,0,0,0
"S-waiting-on-bors,S-waiting-on-bors",59429,2019-03-26T04:02:40Z,63,38,101
E-easy,59430,2019-03-26T04:11:03Z,72,72,144
"S-waiting-on-bors,S-waiting-on-review,S-waiting-on-bors,S-waiting-on-review,S-waiting-on-bors;T-doc,S-waiting-on-review,S-waiting-on-review,S-waiting-on-review,S-waiting-on-review,S-waiting-on-review,S-waiting-on-review",59431,2019-03-26T05:06:56Z,0,0,0
"S-waiting-on-review,S-waiting-on-bors;T-doc,S-waiting-on-review,S-waiting-on-review,S-waiting-on-review,S-waiting-on-review,S-waiting-on-review,S-waiting-on-bors,S-waiting-on-review,S-waiting-on-bors",59433,2019-03-26T08:05:55Z,1191,698,1889
"S-waiting-on-review,S-waiting-on-review,S-waiting-on-review,S-waiting-on-review,S-waiting-on-bors",59434,2019-03-26T09:03:58Z,3,4,7
"S-waiting-on-review,S-waiting-on-review",59439,2019-03-26T14:17:03Z,322,91,413
S-waiting-on-bors,59441,2019-03-26T15:58:12Z,0,12,12
NULL,59446,2019-03-26T19:39:40Z,134,17,151
"S-waiting-on-review,S-waiting-on-review,S-waiting-on-review,S-waiting-on-review,S-waiting-on-review,S-waiting-on-review,S-waiting-on-review",59447,2019-03-26T21:26:47Z,433,126,559
A-incr-comp,59449,2019-03-26T22:49:39Z,4,1,5
A-diagnostics,59455,2019-03-27T02:05:57Z,125,20,145
NULL,59456,2019-03-27T05:23:49Z,12,5,17
"I-slow;S-waiting-on-review;T-libs,S-waiting-on-review,S-waiting-on-review,S-waiting-on-review,S-waiting-on-review,S-waiting-on-review,S-waiting-on-review,S-waiting-on-review,S-waiting-on-review,S-waiting-on-review,S-waiting-on-review,I-nominated;S-waiting-on-review;T-lang;disposition-merge;proposed-final-comment-period,S-waiting-on-review",59457,2019-03-27T09:14:10Z,0,0,0
NULL,59459,2019-03-27T10:46:39Z,88,0,88
"S-waiting-on-review,S-waiting-on-bors,S-waiting-on-review,S-waiting-on-review,S-waiting-on-review,S-waiting-on-review,S-waiting-on-review,S-waiting-on-review,I-nominated;S-waiting-on-review;T-lang;disposition-merge;proposed-final-comment-period,S-waiting-on-review,I-slow;S-waiting-on-review;T-libs,S-waiting-on-review,S-waiting-on-review,S-waiting-on-review",59461,2019-03-27T13:27:06Z,0,0,0
S-waiting-on-review,59462,2019-03-27T13:51:12Z,24,1,25
A-edition-2018-lints,59463,2019-03-27T16:21:06Z,490,11,501
"I-nominated;S-waiting-on-review;T-lang;disposition-merge;proposed-final-comment-period,I-slow;S-waiting-on-review;T-libs,S-waiting-on-review,S-waiting-on-review,S-waiting-on-review,S-waiting-on-review,S-waiting-on-review,S-waiting-on-review,S-waiting-on-review,S-waiting-on-bors,S-waiting-on-review,S-waiting-on-review,S-waiting-on-review,S-waiting-on-review,S-waiting-on-review,S-waiting-on-review,S-waiting-on-review",59466,2019-03-27T16:45:30Z,0,0,0
NULL,59467,2019-03-27T17:21:59Z,184,88,272
A-linkage;C-bug;I-nominated;T-compiler;regression-from-stable-to-nightly,59468,2019-03-27T17:38:47Z,4,0,4
NULL,59470,2019-03-27T20:38:38Z,9,2,11
"S-waiting-on-review,S-waiting-on-review,S-waiting-on-review,S-waiting-on-review,S-waiting-on-bors,S-waiting-on-review,S-waiting-on-review,S-waiting-on-review,S-waiting-on-review,S-waiting-on-review,S-waiting-on-review,I-nominated;S-waiting-on-review;T-lang;disposition-merge;proposed-final-comment-period,I-slow;S-waiting-on-review;T-libs,S-waiting-on-review,S-waiting-on-review,S-waiting-on-review,S-waiting-on-review,S-waiting-on-review",59471,2019-03-28T01:15:45Z,1470,694,2164
NULL,59472,2019-03-28T02:12:19Z,4,0,4
A-diagnostics;C-bug;T-compiler,59473,2019-03-28T02:38:30Z,149,20,169
"S-waiting-on-review,S-waiting-on-review,S-waiting-on-review,S-waiting-on-author,S-waiting-on-bors,S-waiting-on-review,S-waiting-on-review,S-waiting-on-review,S-waiting-on-review,S-waiting-on-review,S-waiting-on-review,S-waiting-on-review",59478,2019-03-28T07:43:45Z,341,298,639
I-nominated;S-waiting-on-review;T-lang,59483,2019-03-28T10:14:40Z,0,0,0
"I-nominated;S-waiting-on-review;T-lang,I-nominated;S-waiting-on-review;T-lang",59484,2019-03-28T10:21:02Z,0,0,0
"I-nominated;S-waiting-on-review;T-lang,I-nominated;S-waiting-on-review;T-lang,I-nominated;S-waiting-on-review;T-lang",59485,2019-03-28T10:25:48Z,0,0,0
NULL,59486,2019-03-28T12:27:18Z,23,8,31
"S-waiting-on-review,S-waiting-on-review,S-waiting-on-review,S-waiting-on-review,S-waiting-on-bors,S-waiting-on-review,S-waiting-on-review,S-waiting-on-review;S-waiting-on-team;T-compiler,S-waiting-on-review,A-driver;C-enhancement;I-needs-decision;T-compiler,S-waiting-on-review",59487,2019-03-28T12:35:46Z,714,443,1157
S-waiting-on-review,59491,2019-03-28T14:41:42Z,0,0,0
NULL,59497,2019-03-28T18:23:21Z,0,0,0
S-waiting-on-review,59500,2019-03-28T18:53:21Z,119,100,219
"S-waiting-on-review,B-unstable;C-tracking-issue;T-libs;disposition-merge;proposed-final-comment-period",59503,2019-03-28T19:12:33Z,2,4,6
"T-compiler,S-waiting-on-review",59506,2019-03-28T21:51:52Z,141,40,181
S-waiting-on-review,59511,2019-03-29T00:50:59Z,1,1,2
"S-waiting-on-review,S-waiting-on-review,S-waiting-on-review,S-waiting-on-review,S-waiting-on-review,S-waiting-on-review,S-waiting-on-review,S-waiting-on-review,S-waiting-on-review,S-waiting-on-review,S-waiting-on-review,S-waiting-on-review",59513,2019-03-29T01:41:03Z,472,317,789
NULL,59520,2019-03-29T07:40:48Z,0,0,0
"S-waiting-on-review,S-waiting-on-review,S-waiting-on-review,S-waiting-on-review,S-waiting-on-review,S-waiting-on-review,S-waiting-on-review,S-waiting-on-review,S-waiting-on-review",59522,2019-03-29T11:32:34Z,435,166,601
A-incr-comp;A-lint;T-compiler,59525,2019-03-29T14:07:37Z,61,1,62
NULL,59527,2019-03-29T14:23:51Z,23,0,23
NULL,59528,2019-03-29T14:59:28Z,0,0,0
NULL,59529,2019-03-29T15:36:31Z,15,0,15
S-waiting-on-review,59533,2019-03-29T16:38:43Z,141,16,157
"S-waiting-on-review,S-waiting-on-review",59536,2019-03-29T20:12:50Z,288,25,313
"S-waiting-on-review,S-waiting-on-review,S-waiting-on-review,S-waiting-on-review,S-waiting-on-review,S-waiting-on-review,S-waiting-on-review,S-waiting-on-review,S-waiting-on-review,S-waiting-on-bors",59538,2019-03-29T22:32:00Z,0,0,0
NULL,59539,2019-03-29T22:57:41Z,9,5,14
S-waiting-on-review,59540,2019-03-29T23:11:03Z,107,89,196
S-waiting-on-review,59545,2019-03-30T02:15:41Z,355,352,707
A-llvm;I-nominated;I-wrong;T-compiler,59546,2019-03-30T02:27:58Z,0,0,0
"S-waiting-on-review,S-waiting-on-review,S-waiting-on-review,S-waiting-on-review,S-waiting-on-review,S-waiting-on-bors,S-waiting-on-review,S-waiting-on-review,S-waiting-on-review",59550,2019-03-30T06:51:48Z,722,281,1003
S-waiting-on-review,59552,2019-03-30T08:49:04Z,0,0,0
"S-waiting-on-review,S-waiting-on-review,S-waiting-on-review,S-waiting-on-review,S-waiting-on-review",59561,2019-03-30T13:14:59Z,590,66,656
S-waiting-on-review,59562,2019-03-30T13:29:06Z,3,3,6
NULL,59566,2019-03-30T16:47:12Z,34,43,77
"S-waiting-on-review,S-waiting-on-bors,S-waiting-on-review",59568,2019-03-30T18:39:52Z,0,0,0
T-doc,59569,2019-03-30T18:48:25Z,2,0,2
"S-waiting-on-review,S-waiting-on-bors,S-waiting-on-review,S-waiting-on-review",59570,2019-03-30T19:06:42Z,0,0,0
A-diagnostics;A-suggestion-diagnostics,59572,2019-03-30T19:59:16Z,140,38,178
NULL,59574,2019-03-30T21:36:42Z,16,5,21
"S-waiting-on-review,S-waiting-on-bors,S-waiting-on-review",59575,2019-03-30T22:14:45Z,8,6,14
"S-waiting-on-review,S-waiting-on-review,S-waiting-on-review",59576,2019-03-31T03:12:58Z,0,0,0
A-LLVM;C-bug;T-compiler,59577,2019-03-31T03:42:23Z,23,13,36
"S-waiting-on-review,S-waiting-on-review,S-waiting-on-review,S-waiting-on-review",59579,2019-03-31T10:59:30Z,0,0,0
A-coercions;A-inference;A-typesystem;T-lang,59580,2019-03-31T11:42:48Z,50,27,77
B-RFC-approved;T-libs,59581,2019-03-31T12:24:52Z,1,7,8
"S-waiting-on-review,S-waiting-on-review,S-waiting-on-review,S-waiting-on-review,S-waiting-on-review",59582,2019-03-31T12:35:10Z,0,0,0
"S-waiting-on-review,S-waiting-on-review,S-waiting-on-review,S-waiting-on-review",59584,2019-03-31T14:10:40Z,585,458,1043
"S-waiting-on-review,S-waiting-on-author,S-waiting-on-review,S-waiting-on-review,S-waiting-on-review,S-waiting-on-review,C-enhancement;S-waiting-on-bors;T-doc;beta-nominated",59590,2019-03-31T17:19:57Z,599,251,850
B-RFC-approved;C-tracking-issue;T-lang,59591,2019-03-31T18:54:03Z,0,0,0
"S-waiting-on-review;T-infra,S-waiting-on-review,S-waiting-on-bors,S-waiting-on-review,A-testsuite;C-cleanup;S-waiting-on-review;T-cargo",59602,2019-04-01T11:38:29Z,0,0,0
NULL,59603,2019-04-01T13:37:03Z,1,2,3
"I-slow,I-slow",59605,2019-04-01T14:52:43Z,0,0,0
"S-waiting-on-bors,S-waiting-on-review,A-testsuite;C-cleanup;S-waiting-on-review;T-cargo,S-waiting-on-review,S-waiting-on-review,S-waiting-on-review,S-waiting-on-review",59606,2019-04-01T15:30:00Z,111,45,156
E-easy,59607,2019-04-01T16:06:45Z,73,73,146
S-waiting-on-review,59617,2019-04-01T20:25:44Z,0,0,0
"S-waiting-on-review,S-waiting-on-review,S-waiting-on-review,S-waiting-on-review",59621,2019-04-01T21:58:11Z,0,0,0
NULL,59622,2019-04-01T22:08:38Z,83,3,86
A-const-eval;E-easy;E-mentor,59627,2019-04-02T03:34:41Z,54,30,84
"S-waiting-on-review,S-waiting-on-review,S-waiting-on-review,S-waiting-on-review,S-waiting-on-review,S-waiting-on-review,S-waiting-on-review,S-waiting-on-review,S-waiting-on-review",59632,2019-04-02T11:47:33Z,982,673,1655
NULL,59634,2019-04-02T13:52:20Z,30,1,31
"S-waiting-on-review,S-waiting-on-review",59635,2019-04-02T16:22:02Z,0,0,0
"S-waiting-on-review,S-waiting-on-review,S-waiting-on-review,S-waiting-on-review",59636,2019-04-02T16:25:18Z,377,65,442
P-high;T-infra,59638,2019-04-02T18:03:53Z,9,0,9
"A-codegen;I-cleanup,A-codegen;I-cleanup",59639,2019-04-02T18:57:42Z,39,0,39
C-tracking-issue;I-nominated;T-lang,59640,2019-04-02T19:27:28Z,5,3,8
"S-waiting-on-review,S-waiting-on-review,S-waiting-on-review,S-waiting-on-review,S-waiting-on-review",59642,2019-04-02T19:55:40Z,0,0,0
A-const-fn;A-diagnostics;C-enhancement;T-compiler,59646,2019-04-02T21:46:00Z,25,19,44
NULL,59648,2019-04-02T22:10:50Z,12,8,20
"S-waiting-on-review,S-waiting-on-review,S-waiting-on-review,S-waiting-on-review,S-waiting-on-review",59653,2019-04-02T23:40:29Z,0,0,0
E-easy,59654,2019-04-03T00:53:50Z,0,0,0
"S-waiting-on-review,S-waiting-on-review,S-waiting-on-review,S-waiting-on-review",59657,2019-04-03T02:36:15Z,1031,459,1490
NULL,59658,2019-04-03T03:27:35Z,0,0,0
NULL,59663,2019-04-03T08:39:52Z,10,4,14
C-enhancement;T-doc;T-libs,59664,2019-04-03T08:57:38Z,40,14,54
"S-waiting-on-review,S-waiting-on-review",59665,2019-04-03T11:12:22Z,5,1,6
NULL,59666,2019-04-03T13:52:47Z,2,2,4
S-waiting-on-review,59668,2019-04-03T14:40:22Z,0,0,0
"S-waiting-on-bors,S-waiting-on-review,S-waiting-on-review,S-waiting-on-review,S-waiting-on-review;T-libs",59670,2019-04-03T15:11:14Z,0,0,0
S-waiting-on-review,59672,2019-04-03T15:57:23Z,1,2,3
B-unstable;T-libs,59675,2019-04-03T18:17:01Z,25,43,68
NULL,59676,2019-04-03T19:23:37Z,65,13,78
"S-waiting-on-bors,S-waiting-on-review,S-waiting-on-bors,S-waiting-on-review,S-waiting-on-review,S-waiting-on-review,S-waiting-on-review",59678,2019-04-03T19:52:11Z,0,0,0
T-doc,59680,2019-04-03T20:22:37Z,9,2,11
S-waiting-on-review;T-libs,59681,2019-04-03T21:24:39Z,1,1,2
"S-waiting-on-bors,S-waiting-on-review,S-waiting-on-review,S-waiting-on-bors,S-waiting-on-review,S-waiting-on-review,S-waiting-on-bors,S-waiting-on-review",59682,2019-04-03T22:13:46Z,0,0,0
"S-waiting-on-review,S-waiting-on-review,S-waiting-on-bors,S-waiting-on-review,S-waiting-on-review,S-waiting-on-bors",59684,2019-04-03T23:49:14Z,939,716,1655
"S-waiting-on-bors,S-waiting-on-review,S-waiting-on-review,S-waiting-on-review,S-waiting-on-review,S-waiting-on-review,S-waiting-on-review",59688,2019-04-04T08:25:23Z,0,0,0
"S-waiting-on-review,S-waiting-on-review,S-waiting-on-review,S-waiting-on-review,S-waiting-on-bors,S-waiting-on-review",59689,2019-04-04T08:39:45Z,0,0,0
"S-waiting-on-review,S-waiting-on-review,S-waiting-on-bors,S-waiting-on-review,S-waiting-on-review,S-waiting-on-review,S-waiting-on-review",59692,2019-04-04T09:23:57Z,0,0,0
"S-waiting-on-review,S-waiting-on-review,S-waiting-on-review,S-waiting-on-review,S-waiting-on-review,S-waiting-on-review,S-waiting-on-bors",59694,2019-04-04T12:50:26Z,0,0,0
"S-waiting-on-review,S-waiting-on-review,S-waiting-on-bors,S-waiting-on-review,S-waiting-on-review,S-waiting-on-review,S-waiting-on-review,S-waiting-on-review",59695,2019-04-04T13:09:10Z,80,43,123
NULL,59696,2019-04-04T13:29:35Z,20,4,24
A-lint;C-cleanup;E-easy;T-compiler,59702,2019-04-04T17:29:00Z,2,20,22
NULL,59708,2019-04-04T19:37:05Z,87,28,115
A-testsuite;T-rustdoc,59711,2019-04-04T20:29:26Z,29,0,29
"S-waiting-on-review,S-waiting-on-review,S-waiting-on-review,S-waiting-on-review,S-waiting-on-review,S-waiting-on-review,S-waiting-on-review",59715,2019-04-05T00:06:50Z,0,0,0
NULL,59717,2019-04-05T03:08:23Z,3,4,7
S-waiting-on-review,59719,2019-04-05T07:47:20Z,0,0,0
S-waiting-on-review,59720,2019-04-05T10:41:56Z,0,0,0
"S-waiting-on-review,S-waiting-on-review,S-waiting-on-review,S-waiting-on-bors,S-waiting-on-review",59721,2019-04-05T10:46:55Z,24,32,56
S-waiting-on-review,59722,2019-04-05T11:14:36Z,0,0,0
NULL,59724,2019-04-05T12:38:39Z,65,4,69
"S-waiting-on-review,S-waiting-on-review,S-waiting-on-review,S-waiting-on-review",59730,2019-04-05T17:14:07Z,0,0,0
S-waiting-on-review,59733,2019-04-05T18:52:12Z,78,24,102
NULL,59734,2019-04-05T19:31:38Z,4,3,7
"S-waiting-on-review,S-waiting-on-review,S-waiting-on-review,S-waiting-on-review,S-waiting-on-review;T-release;beta-nominated,S-waiting-on-review",59736,2019-04-05T20:19:21Z,0,0,0
"S-waiting-on-author;beta-nominated,S-waiting-on-review,S-waiting-on-review,S-waiting-on-review;T-release;beta-nominated,C-enhancement;S-waiting-on-bors;T-doc;beta-nominated,S-waiting-on-review,S-waiting-on-review,S-waiting-on-review",59737,2019-04-05T20:48:40Z,869,116,985
S-waiting-on-review,59738,2019-04-05T21:10:35Z,114,107,221
"S-waiting-on-review,S-waiting-on-review",59739,2019-04-05T21:16:25Z,178,71,249
"S-waiting-on-review,S-waiting-on-review,S-waiting-on-review,S-waiting-on-review,S-waiting-on-review;T-release;beta-nominated,S-waiting-on-review",59741,2019-04-05T22:14:48Z,356,144,500
T-doc,59747,2019-04-06T10:02:38Z,12,11,23
NULL,59748,2019-04-06T10:14:23Z,16,0,16
"S-waiting-on-review,S-waiting-on-review,S-waiting-on-review,S-waiting-on-review,S-waiting-on-review",59758,2019-04-06T20:00:21Z,0,0,0
NULL,59759,2019-04-06T20:49:16Z,0,0,0
"S-waiting-on-review,S-waiting-on-review,S-waiting-on-review,S-waiting-on-review,S-waiting-on-review",59760,2019-04-06T20:52:51Z,129,134,263
S-waiting-on-review,59766,2019-04-07T07:19:09Z,5608,57,5665
C-bug;P-high;T-infra,59770,2019-04-07T11:57:50Z,15,3,18
NULL,59772,2019-04-07T14:10:01Z,0,0,0
T-rustdoc,59776,2019-04-07T16:10:09Z,6,6,12
A-LLVM;T-compiler;needs-fcp,59777,2019-04-07T16:46:37Z,0,0,0
"S-waiting-on-review,S-waiting-on-review",59779,2019-04-07T18:05:11Z,28,6,34
A-const-eval;T-compiler,59781,2019-04-07T19:15:29Z,6,28,34
A-diagnostics;A-macros;A-suggestion-diagnostics,59784,2019-04-07T22:14:53Z,751,114,865
"S-waiting-on-review,S-waiting-on-review",59789,2019-04-08T07:07:01Z,0,0,0
A-suggestion-diagnostics,59798,2019-04-08T15:02:28Z,188,3,191
S-waiting-on-review,59800,2019-04-08T16:18:33Z,0,0,0
"S-waiting-on-review,S-waiting-on-review,S-waiting-on-review,S-waiting-on-review,S-waiting-on-review,S-waiting-on-bors",59801,2019-04-08T16:29:40Z,0,0,0
T-rustdoc,59822,2019-04-09T19:07:50Z,3,3,6
NULL,59823,2019-04-09T19:31:35Z,685,131,816
A-diagnostics;A-suggestion-diagnostics,59826,2019-04-09T21:01:22Z,44,1,45
NULL,59831,2019-04-09T22:45:27Z,3,3,6
T-libs,59835,2019-04-10T03:25:54Z,3,1,4
"S-waiting-on-review,T-libs",59843,2019-04-10T16:30:06Z,3,1,4
A-const-fn;B-RFC-approved;T-lang,59847,2019-04-10T17:47:52Z,29,1,30
S-waiting-on-review,59849,2019-04-10T19:05:46Z,8,6,14
S-waiting-on-review,59850,2019-04-10T19:21:19Z,837,605,1442
C-bug;T-rustdoc,59855,2019-04-10T20:32:24Z,17,6,23
NULL,59858,2019-04-10T21:18:24Z,44,61,105
A-diagnostics;A-suggestion-diagnostics,59859,2019-04-10T21:30:12Z,84,2,86
"S-waiting-on-review,S-waiting-on-review,S-waiting-on-review,S-waiting-on-review,S-waiting-on-review,S-waiting-on-bors,S-waiting-on-review,S-waiting-on-review,S-waiting-on-review,S-waiting-on-review",59868,2019-04-11T01:49:26Z,0,0,0
B-unstable;C-tracking-issue;T-libs,59869,2019-04-11T02:48:27Z,60,15,75
S-waiting-on-review,59879,2019-04-11T13:00:45Z,7,0,7
"S-waiting-on-review,S-waiting-on-review,S-waiting-on-review,S-waiting-on-review,S-waiting-on-review,S-waiting-on-review,S-waiting-on-author,S-waiting-on-review,S-waiting-on-review,S-waiting-on-review,S-waiting-on-review,S-waiting-on-review,S-waiting-on-review,S-waiting-on-review,S-waiting-on-review,S-waiting-on-review",59885,2019-04-11T16:33:34Z,0,0,0
A-linkage;C-bug;I-nominated;T-compiler;regression-from-stable-to-nightly,59886,2019-04-11T17:03:17Z,5,3,8
A-lint;E-needstest,59896,2019-04-11T23:24:14Z,31,4,35
NULL,59900,2019-04-12T02:24:21Z,16,12,28
S-waiting-on-review,59904,2019-04-12T04:45:50Z,0,0,0
NULL,59908,2019-04-12T05:23:10Z,2,0,2
"S-waiting-on-review,S-waiting-on-review,S-waiting-on-review,S-waiting-on-review,S-waiting-on-review,S-waiting-on-review,S-waiting-on-review,S-waiting-on-review,S-waiting-on-review,S-waiting-on-review,S-waiting-on-review,S-waiting-on-review,S-waiting-on-review,S-waiting-on-review,S-waiting-on-bors;T-release",59910,2019-04-12T10:18:13Z,295,209,504
"A-linkage;C-bug;I-nominated;T-compiler;regression-from-stable-to-nightly,S-waiting-on-review",59911,2019-04-12T10:37:00Z,0,31,31
S-waiting-on-review,59915,2019-04-12T12:52:58Z,97,28,125
S-waiting-on-author,59916,2019-04-12T13:57:06Z,0,0,0
"S-waiting-on-review;T-rustdoc,S-waiting-on-review,S-waiting-on-review,S-waiting-on-review,S-waiting-on-review,S-waiting-on-review,S-waiting-on-review,S-waiting-on-review,S-waiting-on-review,S-waiting-on-review,S-waiting-on-review,S-waiting-on-review,S-waiting-on-review,S-waiting-on-review,S-waiting-on-review,S-waiting-on-review,S-waiting-on-review,S-waiting-on-review",59921,2019-04-12T18:30:35Z,0,0,0
"S-waiting-on-review,S-waiting-on-review,S-waiting-on-review,S-waiting-on-review,S-waiting-on-review,S-waiting-on-review,S-waiting-on-bors,S-waiting-on-review",59922,2019-04-12T18:36:20Z,1327,631,1958
S-waiting-on-bors,59924,2019-04-12T19:34:03Z,2,2,4
I-nominated;T-infra,59926,2019-04-12T20:28:28Z,224,68,292
A-lint;C-future-compatibility;T-compiler;T-lang,59928,2019-04-12T21:00:48Z,5,10,15
I-nominated;T-compiler,59929,2019-04-12T22:22:07Z,3,1,4
T-libs,59933,2019-04-13T05:41:34Z,4,3,7
S-waiting-on-review,59935,2019-04-13T09:20:18Z,0,0,0
S-waiting-on-review,59936,2019-04-13T11:50:01Z,24,1,25
"S-waiting-on-review,S-waiting-on-review,S-waiting-on-review,S-waiting-on-review,S-waiting-on-review,S-waiting-on-review,S-waiting-on-review,S-waiting-on-review,S-waiting-on-review;T-rustdoc,S-waiting-on-review,S-waiting-on-review,S-waiting-on-review,S-waiting-on-review,S-waiting-on-review,S-waiting-on-review,S-waiting-on-review,S-waiting-on-review,S-waiting-on-review,S-waiting-on-review",59937,2019-04-13T14:10:37Z,0,0,0
"S-waiting-on-review;T-rustdoc,S-waiting-on-review;beta-nominated,S-waiting-on-review,S-waiting-on-review,S-waiting-on-review,S-waiting-on-review,S-waiting-on-review,S-waiting-on-review,S-waiting-on-bors",59938,2019-04-13T14:20:15Z,0,0,0
"S-waiting-on-bors,S-waiting-on-bors",59939,2019-04-13T14:25:28Z,0,0,0
"S-waiting-on-review,S-waiting-on-review;T-rustdoc,S-waiting-on-review,S-waiting-on-review,S-waiting-on-review,S-waiting-on-review,S-waiting-on-review,S-waiting-on-review,S-waiting-on-review,S-waiting-on-review,S-waiting-on-review,S-waiting-on-review,S-waiting-on-review,S-waiting-on-review,S-waiting-on-review,S-waiting-on-review,S-waiting-on-review",59941,2019-04-13T16:55:49Z,0,0,0
"S-waiting-on-review,S-waiting-on-review,S-waiting-on-review,S-waiting-on-review,S-waiting-on-bors,S-waiting-on-review;T-rustdoc,S-waiting-on-review;beta-nominated,S-waiting-on-review",59942,2019-04-13T17:00:06Z,0,0,0
"S-waiting-on-review,S-waiting-on-review,S-waiting-on-review,S-waiting-on-review,S-waiting-on-review,S-waiting-on-review,S-waiting-on-review,S-waiting-on-review,S-waiting-on-review,S-waiting-on-review,S-waiting-on-review,S-waiting-on-review;T-rustdoc,S-waiting-on-review,S-waiting-on-review,S-waiting-on-review,S-waiting-on-review,S-waiting-on-review",59949,2019-04-13T22:23:52Z,584,499,1083
"S-waiting-on-bors,S-waiting-on-review;T-rustdoc,S-waiting-on-review;beta-nominated,S-waiting-on-review,S-waiting-on-review,S-waiting-on-review",59950,2019-04-13T22:39:51Z,880,198,1078
S-waiting-on-review,59953,2019-04-14T02:23:37Z,0,0,0
"S-waiting-on-review,S-waiting-on-review,S-waiting-on-review,S-waiting-on-review,S-waiting-on-review,S-waiting-on-bors",59964,2019-04-14T15:16:13Z,0,0,0
"S-waiting-on-review,S-waiting-on-review,S-waiting-on-review,S-waiting-on-review,S-waiting-on-bors,S-waiting-on-review,S-waiting-on-review",59966,2019-04-14T15:27:57Z,0,0,0
"S-waiting-on-review,S-waiting-on-bors,S-waiting-on-review,S-waiting-on-review,S-waiting-on-review,S-waiting-on-review",59967,2019-04-14T15:49:29Z,384,148,532
S-waiting-on-review,59974,2019-04-14T20:38:34Z,30,34,64
NULL,59978,2019-04-14T23:03:58Z,67,16,83
NULL,59981,2019-04-15T00:07:13Z,341,282,623
NULL,59984,2019-04-15T08:56:49Z,3,4,7
S-waiting-on-review,59990,2019-04-15T16:06:38Z,3,1,4
"S-waiting-on-review,S-waiting-on-review,S-waiting-on-review,S-waiting-on-review,S-waiting-on-review,S-waiting-on-bors",59991,2019-04-15T16:23:50Z,155,48,203
NULL,59993,2019-04-15T17:12:26Z,119,5,124
"S-waiting-on-review,S-waiting-on-bors,S-waiting-on-review,S-waiting-on-review,S-waiting-on-review,S-waiting-on-review,S-waiting-on-review",60001,2019-04-15T22:17:45Z,0,0,0
T-rustdoc,60002,2019-04-15T22:24:05Z,0,0,0
"S-waiting-on-review;T-rustdoc,S-waiting-on-review,S-waiting-on-review,S-waiting-on-review,S-waiting-on-review,S-waiting-on-review,S-waiting-on-review,S-waiting-on-review",60004,2019-04-16T00:03:59Z,0,0,0
"S-waiting-on-review,S-waiting-on-review,S-waiting-on-review,S-waiting-on-review;T-rustdoc,S-waiting-on-review,S-waiting-on-review",60007,2019-04-16T03:14:28Z,191,14,205
NULL,60022,2019-04-16T21:41:41Z,7,1,8
NULL,60023,2019-04-16T21:56:25Z,49,0,49
A-diagnostics;E-easy;T-compiler,60025,2019-04-16T23:12:30Z,2520,2520,5040
"S-waiting-on-review,S-waiting-on-review",60027,2019-04-17T01:12:42Z,11,19,30
S-waiting-on-review,60029,2019-04-17T08:07:50Z,0,0,0
"S-waiting-on-review,S-waiting-on-review,S-waiting-on-review,S-waiting-on-review",60030,2019-04-17T08:31:39Z,444,426,870
T-rustdoc,60032,2019-04-17T08:43:57Z,0,1,1
NULL,60037,2019-04-17T10:29:21Z,20,20,40
S-waiting-on-review,60038,2019-04-17T11:00:33Z,71,43,114
A-macros;C-bug;P-medium;T-compiler;T-libs,60039,2019-04-17T12:35:27Z,151,14,165
NULL,60045,2019-04-17T17:29:30Z,134,40,174
A-diagnostics,60046,2019-04-17T17:29:51Z,563,936,1499
NULL,60048,2019-04-17T19:01:03Z,48,0,48
"S-waiting-on-review,S-waiting-on-bors,S-waiting-on-review;T-libs,S-waiting-on-bors",60054,2019-04-17T22:23:42Z,27,26,53
A-const-generics;A-typesystem;C-bug;T-compiler,60058,2019-04-17T23:32:08Z,47,38,85
S-waiting-on-review,60060,2019-04-18T00:22:06Z,5,1,6
A-diagnostics;A-suggestion-diagnostics;C-bug;T-compiler,60061,2019-04-18T00:22:36Z,60,30,90
NULL,60064,2019-04-18T01:33:17Z,39,19,58
NULL,60065,2019-04-18T01:43:51Z,136,80,216
P-medium;T-compiler,60071,2019-04-18T09:06:02Z,1,1,2
"C-bug;I-ICE;P-high;T-compiler;regression-from-stable-to-nightly,S-waiting-on-review",60073,2019-04-18T10:49:57Z,61,10,71
E-easy;T-doc,60080,2019-04-18T13:50:06Z,3,3,6
"S-waiting-on-author,S-waiting-on-bors,S-waiting-on-bors,S-waiting-on-author,S-waiting-on-bors",60084,2019-04-18T16:53:24Z,0,0,0
"S-waiting-on-bors,S-waiting-on-author,S-waiting-on-bors,S-waiting-on-review,S-waiting-on-author,S-waiting-on-bors;T-doc,S-waiting-on-bors",60087,2019-04-18T17:50:50Z,0,0,0
A-async-await;C-bug;I-nominated;P-high;T-compiler,60088,2019-04-18T18:16:30Z,79,41,120
"S-waiting-on-bors,S-waiting-on-review,S-waiting-on-author,S-waiting-on-bors;T-doc,S-waiting-on-bors,S-waiting-on-bors,S-waiting-on-author,S-waiting-on-author",60089,2019-04-18T18:36:50Z,0,0,0
"S-waiting-on-bors,S-waiting-on-bors,S-waiting-on-author,S-waiting-on-bors,S-waiting-on-bors,S-waiting-on-bors;merged-by-bors,S-waiting-on-bors,S-waiting-on-review,S-waiting-on-author,S-waiting-on-bors;T-doc",60090,2019-04-18T19:38:52Z,0,0,0
"S-waiting-on-bors,S-waiting-on-bors,S-waiting-on-review,S-waiting-on-author,S-waiting-on-bors;T-doc,S-waiting-on-author,S-waiting-on-bors,S-waiting-on-bors,S-waiting-on-author,S-waiting-on-bors",60091,2019-04-18T19:41:07Z,0,0,0
"S-waiting-on-author,S-waiting-on-bors;T-doc,S-waiting-on-author,S-waiting-on-bors,S-waiting-on-bors,S-waiting-on-author,S-waiting-on-bors,S-waiting-on-bors,S-waiting-on-bors,S-waiting-on-review",60092,2019-04-18T20:10:33Z,0,0,0
"T-rustdoc,T-rustdoc",60093,2019-04-18T21:07:22Z,51,30,81
"S-waiting-on-author,S-waiting-on-bors,S-waiting-on-bors,S-waiting-on-bors,S-waiting-on-bors,S-waiting-on-review,S-waiting-on-author,S-waiting-on-bors,S-waiting-on-bors;T-doc,S-waiting-on-bors,S-waiting-on-review,S-waiting-on-bors",60094,2019-04-18T21:31:04Z,0,0,0
"S-waiting-on-bors;merged-by-bors,S-waiting-on-bors",60095,2019-04-18T21:31:34Z,0,0,0
NULL,60097,2019-04-18T22:15:16Z,1,10,11
"S-waiting-on-author,S-waiting-on-bors,S-waiting-on-bors;T-doc,S-waiting-on-bors,S-waiting-on-review,S-waiting-on-bors,S-waiting-on-review,S-waiting-on-bors,S-waiting-on-author,S-waiting-on-bors,S-waiting-on-author,S-waiting-on-bors,S-waiting-on-bors,S-waiting-on-bors,S-waiting-on-bors,S-waiting-on-bors,S-waiting-on-bors",60099,2019-04-19T00:25:01Z,0,0,0
"S-waiting-on-review,S-waiting-on-bors,S-waiting-on-author,S-waiting-on-bors,S-waiting-on-author,S-waiting-on-bors,S-waiting-on-bors,S-waiting-on-bors,S-waiting-on-bors,S-waiting-on-bors,S-waiting-on-bors,S-waiting-on-author,S-waiting-on-bors,S-waiting-on-bors;T-doc,S-waiting-on-bors,S-waiting-on-bors,S-waiting-on-review",60100,2019-04-19T00:26:54Z,0,0,0
"S-waiting-on-bors,S-waiting-on-bors,S-waiting-on-bors,S-waiting-on-bors,S-waiting-on-author,S-waiting-on-bors,S-waiting-on-bors;T-doc,S-waiting-on-bors,S-waiting-on-bors,S-waiting-on-review,S-waiting-on-review,S-waiting-on-bors,S-waiting-on-author,S-waiting-on-bors,S-waiting-on-bors",60101,2019-04-19T01:38:03Z,0,0,0
"S-waiting-on-bors,S-waiting-on-bors,S-waiting-on-review,S-waiting-on-review,S-waiting-on-bors,S-waiting-on-bors,S-waiting-on-bors,S-waiting-on-bors,S-waiting-on-bors,S-waiting-on-bors,S-waiting-on-bors,S-waiting-on-author,S-waiting-on-bors,S-waiting-on-bors,S-waiting-on-bors;T-doc,S-waiting-on-bors",60104,2019-04-19T04:03:31Z,670,403,1073
B-unstable;T-libs,60109,2019-04-19T09:30:46Z,0,0,0
S-waiting-on-review,60118,2019-04-19T17:38:42Z,0,0,0
NULL,60119,2019-04-19T18:05:05Z,17,1,18
S-waiting-on-review,60124,2019-04-19T20:33:33Z,93,96,189
"S-waiting-on-review,I-ICE,A-diagnostics;C-cleanup;T-compiler",60125,2019-04-19T21:50:36Z,449,125,574
NULL,60126,2019-04-19T22:38:43Z,179,201,380
NULL,60131,2019-04-20T07:53:53Z,3,2,5
A-parser;C-bug;I-ICE;P-high;T-compiler,60132,2019-04-20T10:37:09Z,55,1,56
C-tracking-issue;T-compiler;WG-epoch,60133,2019-04-20T11:46:36Z,56,52,108
C-bug;T-rustdoc,60134,2019-04-20T14:45:35Z,18,30,48
T-rustdoc,60140,2019-04-20T17:07:04Z,113,124,237
"A-io;B-unstable;T-libs,S-waiting-on-review",60145,2019-04-20T21:16:24Z,781,163,944
"C-cleanup;E-easy;E-mentor;T-compiler,C-cleanup;E-easy;E-mentor;T-compiler",60152,2019-04-21T14:16:51Z,37,11,48
A-diagnostics;A-suggestion-diagnostics,60155,2019-04-21T19:02:20Z,175,55,230
"I-nominated;T-compiler,S-waiting-on-review",60158,2019-04-21T21:07:09Z,1,1,2
NULL,60159,2019-04-21T22:46:23Z,3515,733,4248
A-diagnostics;E-easy,60160,2019-04-22T02:15:55Z,19,18,37
A-diagnostics;A-frontend;E-easy,60167,2019-04-22T14:32:08Z,76,3,79
A-NLL;NLL-sound;P-medium,60171,2019-04-22T15:50:41Z,5202,964,6166
S-waiting-on-review,60172,2019-04-22T15:59:15Z,5,248,253
C-cleanup;T-compiler;WG-compiler-nll,60174,2019-04-22T16:53:35Z,726,276,1002
regression-from-stable-to-beta,60186,2019-04-22T22:57:58Z,31,3,34
S-waiting-on-review,60187,2019-04-23T01:28:24Z,960,324,1284
NULL,60188,2019-04-23T02:40:23Z,312,24,336
"S-waiting-on-review,S-waiting-on-review,S-waiting-on-review,S-waiting-on-review,S-waiting-on-review,S-waiting-on-review",60189,2019-04-23T04:57:05Z,0,0,0
S-waiting-on-review,60190,2019-04-23T06:00:16Z,37,23,60
NULL,60192,2019-04-23T09:21:47Z,83,0,83
"S-waiting-on-review,S-waiting-on-review,S-waiting-on-bors,S-waiting-on-review,S-blocked;S-waiting-on-review,S-waiting-on-review,S-waiting-on-review",60206,2019-04-23T18:18:46Z,0,0,0
"S-waiting-on-bors,S-waiting-on-review,S-blocked;S-waiting-on-review,S-waiting-on-review,S-waiting-on-review,S-waiting-on-review",60208,2019-04-23T18:37:42Z,0,0,0
"S-waiting-on-review,S-waiting-on-review,S-waiting-on-review,S-waiting-on-bors,S-waiting-on-review,S-waiting-on-review",60211,2019-04-23T19:51:02Z,1182,546,1728
"S-waiting-on-review,S-waiting-on-review,S-waiting-on-bors,S-waiting-on-review,S-waiting-on-review,S-waiting-on-review",60212,2019-04-23T19:51:33Z,0,0,0
NULL,60220,2019-04-24T01:41:39Z,55,6,61
"I-nominated;S-waiting-on-review;T-compiler;beta-nominated,S-waiting-on-review,S-waiting-on-review,S-waiting-on-review,S-waiting-on-review,S-blocked;S-waiting-on-review",60221,2019-04-24T01:41:48Z,0,0,0
"S-waiting-on-review,S-waiting-on-review,S-blocked;S-waiting-on-review,I-nominated;S-waiting-on-review;T-compiler;beta-nominated,S-waiting-on-review",60224,2019-04-24T03:16:25Z,567,354,921
S-waiting-on-review,60225,2019-04-24T04:48:56Z,92,52,144
E-mentor;T-compiler,60227,2019-04-24T05:57:31Z,0,0,0
E-medium;E-mentor,60237,2019-04-24T15:01:33Z,233,154,387
NULL,60243,2019-04-24T18:12:48Z,47,0,47
S-waiting-on-review,60246,2019-04-24T19:47:28Z,102,60,162
"A-diagnostics;A-macros;C-enhancement,A-diagnostics;A-macros",60248,2019-04-24T23:46:57Z,27,9,36
"S-waiting-on-review,S-waiting-on-author,A-diagnostics;E-easy,S-waiting-on-review,S-waiting-on-review,S-waiting-on-bors,S-waiting-on-review",60250,2019-04-25T01:05:28Z,245,101,346
NULL,60252,2019-04-25T07:35:03Z,54,51,105
S-waiting-on-review,60257,2019-04-25T11:22:57Z,8,6,14
NULL,60259,2019-04-25T12:19:22Z,4,16,20
"S-waiting-on-review,S-waiting-on-review",60261,2019-04-25T13:35:01Z,1048,785,1833
A-libs;I-completion;I-wishlist,60266,2019-04-25T14:48:51Z,0,0,0
NULL,60270,2019-04-25T16:10:49Z,2,3,5
"A-rustbuild;regression-from-stable-to-beta,S-waiting-on-bors",60273,2019-04-25T17:21:30Z,0,2,2
NULL,60277,2019-04-25T18:36:42Z,21,0,21
NULL,60278,2019-04-25T18:45:41Z,15,0,15
NULL,60281,2019-04-25T19:17:55Z,0,0,0
S-waiting-on-bors;merged-by-bors,60284,2019-04-25T20:14:48Z,117,2,119
C-bug;I-ICE;T-compiler,60285,2019-04-25T20:16:53Z,11,5,16
S-waiting-on-review,60287,2019-04-25T20:31:06Z,44,29,73
"S-waiting-on-review,S-waiting-on-review,S-waiting-on-review,S-waiting-on-review,S-waiting-on-review,S-waiting-on-review,S-waiting-on-review,S-waiting-on-review,S-waiting-on-review,S-waiting-on-review",60290,2019-04-25T21:35:49Z,0,0,0
"S-waiting-on-review,S-waiting-on-review,S-waiting-on-review,S-waiting-on-review,S-waiting-on-review,S-waiting-on-review,S-waiting-on-review,S-waiting-on-review,S-waiting-on-review,S-waiting-on-review",60291,2019-04-25T22:25:16Z,0,0,0
NULL,60292,2019-04-25T23:28:56Z,146,93,239
A-diagnostics;T-compiler,60295,2019-04-26T01:38:20Z,0,0,0
"S-waiting-on-review,S-waiting-on-review,S-waiting-on-review;T-rustdoc,S-waiting-on-review,S-waiting-on-review,S-waiting-on-review,S-waiting-on-bors,S-waiting-on-review,S-waiting-on-review,S-waiting-on-review,S-waiting-on-review,S-waiting-on-review",60296,2019-04-26T01:50:28Z,640,218,858
B-RFC-approved;T-libs,60303,2019-04-26T10:17:33Z,2,6,8
NULL,60307,2019-04-26T14:24:45Z,35,11,46
"I-nominated;S-waiting-on-review;T-compiler;beta-nominated,S-waiting-on-review,S-waiting-on-bors;T-release;beta-accepted;beta-nominated,S-waiting-on-bors;T-release,S-waiting-on-review,S-waiting-on-review;beta-nominated,S-waiting-on-review;beta-accepted;beta-nominated,S-waiting-on-review",60311,2019-04-26T15:01:16Z,124,65,189
NULL,60313,2019-04-26T16:01:12Z,4,1,5
C-cleanup;T-doc;T-libs,60316,2019-04-26T16:50:23Z,16,16,32
NULL,60317,2019-04-26T17:00:43Z,480,170,650
NULL,60323,2019-04-27T02:16:00Z,0,0,0
"S-waiting-on-review,S-waiting-on-review,S-waiting-on-review,S-waiting-on-bors;T-release;beta-accepted;beta-nominated,S-waiting-on-review",60324,2019-04-27T02:50:12Z,0,0,0
A-NLL;C-bug;I-ICE;T-compiler,60327,2019-04-27T11:16:07Z,57,2,59
"S-waiting-on-bors,S-waiting-on-review,S-waiting-on-review,S-waiting-on-bors;T-release;beta-accepted;beta-nominated,S-waiting-on-review,S-waiting-on-bors,S-waiting-on-review",60328,2019-04-27T11:49:26Z,0,0,0
"S-waiting-on-bors;T-release;beta-accepted;beta-nominated,S-waiting-on-review,S-waiting-on-review,S-waiting-on-review,S-waiting-on-review",60329,2019-04-27T12:12:44Z,210,122,332
NULL,60330,2019-04-27T12:55:09Z,551,399,950
NULL,60332,2019-04-27T13:29:39Z,0,0,0
NULL,60333,2019-04-27T14:48:11Z,9,11,20
B-unstable;C-tracking-issue;T-libs,60334,2019-04-27T15:36:59Z,294,280,574
NULL,60337,2019-04-27T17:28:42Z,39,60,99
S-waiting-on-review,60340,2019-04-27T19:33:39Z,0,0,0
S-waiting-on-review,60341,2019-04-27T19:39:11Z,0,0,0
C-bug;I-ICE;T-rustdoc,60344,2019-04-28T00:36:34Z,2,1,3
A-NLL;E-easy;E-mentor,60347,2019-04-28T03:54:19Z,3,14,17
A-diagnostics;A-frontend;E-easy,60348,2019-04-28T05:45:45Z,231,162,393
"S-waiting-on-review,S-waiting-on-review,S-waiting-on-review,S-waiting-on-review",60351,2019-04-28T12:17:14Z,13,18,31
NULL,60353,2019-04-28T13:59:29Z,26,0,26
C-tracking-issue;T-libs;disposition-merge;final-comment-period,60356,2019-04-28T17:36:52Z,1,1,2
"S-waiting-on-review,S-waiting-on-review,S-waiting-on-review,S-waiting-on-review",60357,2019-04-28T19:20:52Z,0,0,0
NULL,60358,2019-04-28T19:35:06Z,8,6,14
"S-waiting-on-review,A-diagnostics;T-compiler",60359,2019-04-28T19:38:45Z,36,0,36
NULL,60360,2019-04-28T20:15:04Z,10,0,10
S-waiting-on-review,60362,2019-04-28T23:49:13Z,268,193,461
NULL,60364,2019-04-29T03:44:53Z,0,3,3
S-waiting-on-review,60369,2019-04-29T12:16:44Z,80,8,88
NULL,60370,2019-04-29T15:36:26Z,34,1,35
"A-rustbuild;E-easy,S-waiting-on-review",60373,2019-04-29T18:00:30Z,256,82,338
NULL,60376,2019-04-29T19:39:34Z,1,3,4
"S-waiting-on-review,S-waiting-on-review,S-waiting-on-review,S-waiting-on-review,S-waiting-on-review,S-waiting-on-review,S-waiting-on-review,S-waiting-on-review,S-waiting-on-review",60377,2019-04-29T20:22:48Z,514,491,1005
NULL,60379,2019-04-29T21:03:18Z,9,3,12
T-rustdoc,60380,2019-04-29T21:15:24Z,4,0,4
S-waiting-on-review,60382,2019-04-29T21:17:58Z,3,3,6
T-rustdoc,60383,2019-04-29T21:47:09Z,214,207,421
NULL,60388,2019-04-30T01:21:57Z,150,65,215
"S-waiting-on-bors,S-waiting-on-review,S-waiting-on-bors,S-waiting-on-review",60389,2019-04-30T01:28:41Z,246,303,549
NULL,60393,2019-04-30T02:03:32Z,151,17,168
A-NLL;C-cleanup,60400,2019-04-30T06:31:46Z,2,22,24
NULL,60401,2019-04-30T08:37:20Z,9,9,18
A-runtime;A-rustbuild;C-bug;E-help-wanted;T-compiler;T-infra,60402,2019-04-30T08:51:40Z,16,3,19
NULL,60409,2019-04-30T11:48:36Z,106,14,120
"S-waiting-on-review,S-waiting-on-bors,S-waiting-on-review,S-waiting-on-review,S-waiting-on-review",60410,2019-04-30T12:56:19Z,0,0,0
"S-waiting-on-review,S-waiting-on-review,S-waiting-on-review,S-waiting-on-review,S-waiting-on-bors,S-waiting-on-review",60411,2019-04-30T13:08:33Z,0,0,0
"S-waiting-on-review,S-waiting-on-review,S-waiting-on-bors,S-waiting-on-review,S-waiting-on-review,S-waiting-on-review,S-waiting-on-review",60412,2019-04-30T13:13:52Z,0,0,0
NULL,60415,2019-04-30T14:05:03Z,127,48,175
"S-waiting-on-review,S-waiting-on-review,S-waiting-on-review,S-waiting-on-review,S-waiting-on-review,S-waiting-on-review,S-waiting-on-review",60416,2019-04-30T14:10:34Z,350,276,626
"S-waiting-on-review,S-waiting-on-review",60417,2019-04-30T15:50:00Z,32,26,58
"S-waiting-on-review,S-waiting-on-review,S-waiting-on-review,S-waiting-on-review,S-waiting-on-review,S-waiting-on-review,S-waiting-on-bors",60420,2019-04-30T18:17:50Z,0,0,0
S-waiting-on-review,60423,2019-04-30T19:40:20Z,35,16,51
"A-build;A-frontend;E-easy;E-mentor;I-papercut,A-build;A-frontend;E-easy;E-mentor;I-papercut",60426,2019-04-30T20:55:56Z,60,18,78
"S-waiting-on-review,S-waiting-on-review,S-waiting-on-review,S-waiting-on-review,S-waiting-on-bors,S-waiting-on-review,S-waiting-on-bors,S-waiting-on-review",60433,2019-05-01T04:26:27Z,0,0,0
"S-waiting-on-review,S-waiting-on-bors,S-waiting-on-review,S-waiting-on-bors,S-waiting-on-review,S-waiting-on-review,S-waiting-on-review",60434,2019-05-01T06:11:51Z,0,0,0
"S-waiting-on-review,S-waiting-on-review,S-waiting-on-review,S-waiting-on-review,S-waiting-on-bors,S-waiting-on-review,S-waiting-on-review",60435,2019-05-01T06:29:17Z,759,462,1221
I-nominated;S-waiting-on-review;T-lang;relnotes,60436,2019-05-01T10:28:20Z,2,2,4
A-async-await,60437,2019-05-01T12:55:01Z,505,232,737
S-waiting-on-bors,60443,2019-05-01T16:02:02Z,17,2,19
A-traits;C-bug;T-compiler;regression-from-stable-to-stable,60444,2019-05-01T17:25:06Z,144,2,146
C-bug;I-ICE;T-compiler,60449,2019-05-01T20:24:10Z,129,72,201
NULL,60451,2019-05-01T20:41:51Z,24,0,24
A-NLL;C-cleanup,60452,2019-05-01T21:07:19Z,171,211,382
NULL,60453,2019-05-01T21:12:05Z,6,1,7
NULL,60454,2019-05-01T21:26:59Z,0,0,0
NULL,60455,2019-05-01T21:57:49Z,43,18,61
S-waiting-on-review,60457,2019-05-01T22:11:31Z,81,56,137
"S-waiting-on-bors,S-waiting-on-review,S-waiting-on-bors,S-waiting-on-review,S-waiting-on-review,S-waiting-on-review,S-waiting-on-review",60460,2019-05-01T23:09:34Z,1132,789,1921
B-RFC-approved;C-tracking-issue;T-lang,60463,2019-05-02T01:15:49Z,730,208,938
"B-unstable;C-tracking-issue;T-compiler,S-waiting-on-review,S-waiting-on-review",60464,2019-05-02T02:57:09Z,87,74,161
S-waiting-on-review,60469,2019-05-02T11:51:20Z,0,0,0
"S-waiting-on-review,S-waiting-on-review,S-waiting-on-review,S-waiting-on-crater,S-waiting-on-review,S-waiting-on-review,S-waiting-on-review",60472,2019-05-02T15:23:55Z,0,0,0
NULL,60476,2019-05-02T16:11:22Z,4,1,5
T-rustdoc,60487,2019-05-02T21:32:51Z,10,9,19
"S-waiting-on-crater,S-waiting-on-review,S-waiting-on-review,S-waiting-on-review,S-waiting-on-review,S-waiting-on-review,S-waiting-on-review,S-waiting-on-bors,S-waiting-on-review,S-waiting-on-review,S-waiting-on-review",60488,2019-05-02T22:14:23Z,0,0,0
T-rustdoc,60489,2019-05-02T22:14:23Z,4,0,4
NULL,60492,2019-05-02T22:39:55Z,0,0,0
A-async-await;T-compiler,60501,2019-05-03T04:14:47Z,14,6,20
A-frontend;A-macros,60506,2019-05-03T11:44:57Z,0,0,0
NULL,60508,2019-05-03T13:43:48Z,106,36,142
"S-waiting-on-review,S-waiting-on-review,S-waiting-on-review,S-waiting-on-review,S-waiting-on-review,S-waiting-on-review,S-waiting-on-review,S-waiting-on-bors,S-waiting-on-review,S-waiting-on-crater,S-waiting-on-review,S-waiting-on-review",60510,2019-05-03T14:25:11Z,891,297,1188
S-waiting-on-review,60511,2019-05-03T15:10:43Z,94,2,96
A-NLL;C-cleanup,60513,2019-05-03T17:00:09Z,128,675,803
NULL,60515,2019-05-03T17:09:20Z,4,5,9
A-NLL;C-cleanup;T-compiler,60516,2019-05-03T17:27:28Z,131,192,323
"S-waiting-on-review,S-waiting-on-review,S-waiting-on-bors,S-waiting-on-bors,S-waiting-on-review,S-waiting-on-review,S-waiting-on-review,S-waiting-on-review",60519,2019-05-03T18:11:41Z,0,0,0
"S-waiting-on-review,S-waiting-on-review,S-waiting-on-review,S-waiting-on-review,S-waiting-on-bors,S-waiting-on-bors,S-waiting-on-review",60523,2019-05-03T19:50:51Z,0,0,0
S-waiting-on-author,60525,2019-05-03T20:31:01Z,86,121,207
A-frontend;I-ICE;I-nominated;T-compiler,60527,2019-05-03T22:01:37Z,15,1,16
NULL,60529,2019-05-04T00:26:56Z,1019,12,1031
S-waiting-on-review,60530,2019-05-04T01:14:19Z,120,145,265
"S-waiting-on-review,A-rustbuild;E-easy",60531,2019-05-04T01:29:53Z,43,21,64
A-async-await;A-testsuite;AsyncAwait-Blocking;E-needstest;T-compiler,60535,2019-05-04T06:09:46Z,341,22,363
"S-waiting-on-bors,S-waiting-on-review,S-waiting-on-bors,S-waiting-on-review,S-waiting-on-bors,S-waiting-on-review,S-waiting-on-review,S-waiting-on-review,S-waiting-on-review",60537,2019-05-04T07:21:36Z,562,1100,1662
I-nominated;T-compiler,60538,2019-05-04T10:00:22Z,1,1,2
NULL,60539,2019-05-04T10:19:47Z,0,0,0
S-waiting-on-review,60541,2019-05-04T11:16:44Z,29,42,71
NULL,60542,2019-05-04T11:42:57Z,44,0,44
S-waiting-on-author,60544,2019-05-04T12:50:53Z,143,169,312
NULL,60547,2019-05-04T16:07:31Z,0,0,0
A-const-fn;A-typesystem;B-RFC-approved;C-tracking-issue;T-compiler;T-lang,60550,2019-05-04T20:55:04Z,50,0,50
NULL,60555,2019-05-05T09:36:19Z,124,0,124
S-waiting-on-review,60559,2019-05-05T12:25:09Z,0,0,0
NULL,60562,2019-05-05T14:38:14Z,22,1,23
"S-waiting-on-bors,S-waiting-on-review,S-waiting-on-review,S-waiting-on-review",60567,2019-05-05T19:37:33Z,188,171,359
NULL,60568,2019-05-05T19:43:34Z,68,82,150
S-waiting-on-review,60572,2019-05-06T00:28:28Z,23,0,23
S-waiting-on-review,60573,2019-05-06T04:32:29Z,9,12,21
NULL,60574,2019-05-06T07:36:01Z,0,0,0
C-cleanup;E-easy,60581,2019-05-06T12:57:05Z,46,57,103
NULL,60588,2019-05-06T20:03:14Z,1,4,5
NULL,60590,2019-05-06T21:32:59Z,94,0,94
NULL,60592,2019-05-06T22:46:26Z,72,32,104
"S-waiting-on-review,S-waiting-on-review,S-waiting-on-review,S-waiting-on-review,S-waiting-on-review,S-waiting-on-review",60612,2019-05-07T17:30:13Z,375,62,437
"S-waiting-on-review,A-diagnostics;A-syntaxext;I-cleanup;P-low,A-diagnostics;A-syntaxext;I-cleanup;P-low",60620,2019-05-07T23:08:51Z,7,9,16
"S-waiting-on-review,A-typesystem;I-wrong,I-nominated;T-compiler",60626,2019-05-08T06:23:58Z,1,1,2
NULL,60627,2019-05-08T07:00:50Z,40,0,40
A-hir;C-cleanup,60634,2019-05-08T13:01:41Z,60,37,97
"S-waiting-on-review,S-waiting-on-review,S-waiting-on-review",60636,2019-05-08T21:14:59Z,0,0,0
"S-waiting-on-review,S-waiting-on-review,S-waiting-on-review,S-waiting-on-review,S-waiting-on-review",60640,2019-05-08T17:08:46Z,0,0,0
C-bug;I-ICE;I-nominated;T-compiler,60641,2019-05-08T17:24:41Z,35,2,37
NULL,60644,2019-05-08T18:45:00Z,61,5,66
"S-waiting-on-review,S-waiting-on-review,S-waiting-on-review,S-waiting-on-review",60646,2019-05-08T20:06:28Z,0,0,0
NULL,60649,2019-05-08T22:30:13Z,48,4,52
"S-waiting-on-review,S-waiting-on-review,S-waiting-on-review,S-waiting-on-review,S-waiting-on-review,S-waiting-on-review,S-waiting-on-review",60651,2019-05-08T22:58:33Z,370,92,462
NULL,60656,2019-05-09T02:55:46Z,6,0,6
NULL,60657,2019-05-09T03:01:10Z,0,0,0
T-libs,60667,2019-05-09T11:49:14Z,0,0,0
"S-waiting-on-review,S-waiting-on-review,S-waiting-on-review,S-waiting-on-perf,S-waiting-on-review",60672,2019-05-09T16:34:59Z,275,409,684
A-async-await;T-compiler,60675,2019-05-09T17:51:35Z,0,23,23
"A-async-await;A-macros;C-bug,S-waiting-on-review",60676,2019-05-09T18:21:12Z,76,43,119
NULL,60678,2019-05-09T19:13:32Z,2,7,9
"A-frontend;A-macros,S-waiting-on-review",60679,2019-05-09T19:28:33Z,671,796,1467
"S-waiting-on-review,S-waiting-on-review,S-waiting-on-review,S-waiting-on-review,S-waiting-on-bors,S-waiting-on-review,S-waiting-on-review,S-waiting-on-review",60683,2019-05-09T21:56:20Z,818,294,1112
S-waiting-on-review,60684,2019-05-09T22:02:55Z,1,0,1
S-waiting-on-bors,60692,2019-05-10T07:58:01Z,8,0,8
A-hir;A-impl-trait;A-pretty;E-easy,60694,2019-05-10T10:15:13Z,25,1,26
A-incr-comp;C-bug;I-ICE;T-compiler,60696,2019-05-10T10:31:07Z,0,0,0
A-incr-comp;C-bug;I-ICE;T-compiler,60697,2019-05-10T11:03:29Z,10,0,10
"S-waiting-on-review,B-unstable;T-libs,S-waiting-on-review",60703,2019-05-10T15:48:19Z,0,0,0
"S-waiting-on-bors,S-waiting-on-review,A-incr-comp;C-bug;I-ICE;T-compiler,S-waiting-on-review,S-waiting-on-bors,S-waiting-on-review,S-waiting-on-bors,S-waiting-on-review",60708,2019-05-10T18:31:15Z,1106,45,1151
NULL,60710,2019-05-10T19:53:58Z,81,3,84
NULL,60714,2019-05-10T21:11:51Z,70,19,89
"S-waiting-on-review,C-tracking-issue;I-nominated;T-lang",60716,2019-05-10T22:11:29Z,11,3,14
A-const-generics,60717,2019-05-10T23:08:54Z,34,1,35
A-testsuite,60719,2019-05-10T23:44:42Z,13,2,15
NULL,60720,2019-05-10T23:58:47Z,34,23,57
NULL,60721,2019-05-11T01:23:07Z,29,2,31
A-impl-trait;A-lifetimes;A-typesystem;C-tracking-issue;T-lang,60756,2019-05-12T11:31:27Z,102,0,102
C-bug;I-ICE;I-nominated;T-compiler;regression-from-stable-to-stable,60765,2019-05-12T17:55:55Z,63,10,73
"S-waiting-on-review,A-hir;A-impl-trait;A-pretty;E-easy",60767,2019-05-12T19:14:13Z,80,89,169
A-frontend;E-easy;E-mentor;T-compiler,60770,2019-05-12T22:04:49Z,29,7,36
"A-runtime;I-completion,E-easy",60771,2019-05-12T22:08:06Z,0,0,0
NULL,60772,2019-05-12T22:39:16Z,0,0,0
"S-waiting-on-review,S-waiting-on-review",60780,2019-05-13T09:42:40Z,2,5,7
"C-bug;I-unsound%20%F0%9F%92%A5;T-libs,S-waiting-on-bors;T-libs;relnotes",60785,2019-05-13T15:19:07Z,13,2,15
"C-bug;I-unsound%20%F0%9F%92%A5;T-libs,S-waiting-on-bors;T-libs;relnotes",60786,2019-05-13T15:19:11Z,12,1,13
"C-bug;I-unsound%20%F0%9F%92%A5;T-libs,S-waiting-on-bors;T-libs;relnotes",60787,2019-05-13T15:19:13Z,12,1,13
S-waiting-on-review,60788,2019-05-13T15:26:45Z,7,14,21
NULL,60793,2019-05-13T18:53:27Z,180,135,315
"S-waiting-on-review,S-waiting-on-review,S-waiting-on-review,S-waiting-on-bors,S-waiting-on-review",60794,2019-05-13T19:36:57Z,240,38,278
T-lang,60796,2019-05-13T20:37:48Z,0,0,0
A-async-await;A-generators;A-impl-trait;AsyncAwait-Deferred,60799,2019-05-13T21:01:34Z,35,2,37
NULL,60802,2019-05-13T21:22:13Z,22,24,46
S-waiting-on-review,60806,2019-05-13T22:09:01Z,48,4,52
A-async-await;A-diagnostics;E-easy;E-mentor;T-compiler,60807,2019-05-13T22:13:07Z,0,0,0
A-async-await;A-diagnostics;E-easy;E-mentor;T-compiler,60808,2019-05-13T22:14:58Z,1,1,2
E-easy;E-mentor;T-doc,60817,2019-05-14T09:47:12Z,279,15,294
"A-incr-comp;A-lint;C-bug;T-compiler,A-incr-comp;A-lint;C-bug;T-compiler",60823,2019-05-14T12:20:38Z,12,8,20
NULL,60826,2019-05-14T13:43:05Z,0,0,0
A-async-await;A-diagnostics;A-parser;AsyncAwait-Deferred;E-easy,60829,2019-05-14T15:57:53Z,0,0,0
NULL,60831,2019-05-14T17:56:33Z,1,1,2
A-rustbuild;E-easy;E-mentor,60832,2019-05-14T18:41:33Z,4,0,4
"S-waiting-on-bors,S-waiting-on-review,S-waiting-on-review,S-waiting-on-bors,S-waiting-on-review,S-waiting-on-review,S-waiting-on-bors,S-waiting-on-review,S-waiting-on-bors",60834,2019-05-14T20:00:28Z,379,29,408
"S-waiting-on-review,S-waiting-on-review;T-release;beta-accepted;beta-nominated,S-waiting-on-review",60838,2019-05-14T20:51:32Z,155,10,165
NULL,60839,2019-05-14T20:57:34Z,74,73,147
"S-waiting-on-review,S-waiting-on-review",60840,2019-05-14T21:40:22Z,93,44,137
A-linkage;C-bug;I-nominated;O-ARM;T-compiler,60841,2019-05-14T21:45:07Z,21,20,41
"S-waiting-on-review,S-waiting-on-review,S-waiting-on-review,S-waiting-on-review,S-waiting-on-bors,S-waiting-on-review",60843,2019-05-15T00:03:18Z,0,0,0
"S-waiting-on-review,S-waiting-on-review,S-waiting-on-review,S-waiting-on-review,S-waiting-on-review,S-waiting-on-review",60844,2019-05-15T00:05:39Z,0,0,0
S-waiting-on-review;T-libs;disposition-merge;proposed-final-comment-period,60850,2019-05-15T09:56:47Z,1,9,10
A-parser;E-easy;E-mentor,60851,2019-05-15T13:24:02Z,1,1,2
"S-waiting-on-review,S-waiting-on-review,S-waiting-on-review,S-waiting-on-review,S-waiting-on-review,S-waiting-on-review,S-waiting-on-review,S-waiting-on-review",60859,2019-05-15T18:34:40Z,0,0,0
NULL,60860,2019-05-15T19:00:56Z,0,0,0
"S-waiting-on-review,B-RFC-approved;C-tracking-issue;T-lang",60861,2019-05-15T19:15:22Z,0,0,0
"S-waiting-on-review,S-waiting-on-review,S-waiting-on-review,S-waiting-on-review,S-waiting-on-review,S-waiting-on-review,S-waiting-on-review,S-waiting-on-review",60864,2019-05-15T20:38:32Z,0,0,0
A-async-await;A-diagnostics;A-suggestion-diagnostics;AsyncAwait-Unclear,60873,2019-05-16T02:48:09Z,690,288,978
"S-waiting-on-review,S-waiting-on-review,S-waiting-on-review,S-waiting-on-review,S-waiting-on-review,S-waiting-on-review",60877,2019-05-16T08:43:37Z,197,38,235
NULL,60878,2019-05-16T09:02:26Z,0,0,0
S-waiting-on-review,60881,2019-05-16T14:44:49Z,5,21,26
T-rustdoc,60885,2019-05-16T18:54:43Z,6,6,12
"S-waiting-on-bors,S-waiting-on-review,S-waiting-on-review,S-waiting-on-review,S-waiting-on-review;T-release;beta-accepted;beta-nominated",60888,2019-05-16T19:31:50Z,312,21,333
NULL,60891,2019-05-16T20:26:24Z,2,0,2
NULL,60892,2019-05-16T21:05:24Z,52,5,57
"S-waiting-on-review,S-waiting-on-review,S-waiting-on-review,S-waiting-on-review,S-waiting-on-review,S-waiting-on-review",60898,2019-05-17T00:54:20Z,781,322,1103
C-bug;I-unsound%20%F0%9F%92%A5;T-libs,60902,2019-05-17T02:50:32Z,10,2,12
T-libs,60904,2019-05-17T06:14:48Z,0,0,0
NULL,60908,2019-05-17T08:42:53Z,123,25,148
A-NLL;I-nominated;T-compiler,60911,2019-05-17T11:02:07Z,0,0,0
A-NLL;I-nominated;T-compiler,60914,2019-05-17T12:23:24Z,0,0,0
"S-waiting-on-review,S-waiting-on-review,S-waiting-on-bors,S-waiting-on-review",60920,2019-05-17T18:34:15Z,253,46,299
B-unstable;T-libs,60921,2019-05-17T18:57:46Z,9,1130,1139
"S-waiting-on-review,S-waiting-on-review,S-waiting-on-review,S-waiting-on-review;beta-nominated,S-waiting-on-review",60922,2019-05-17T18:58:46Z,103,29,132
A-diagnostics;C-enhancement;T-compiler,60924,2019-05-17T19:19:21Z,9,3,12
"S-waiting-on-review,E-easy",60928,2019-05-17T22:38:27Z,458,447,905
A-macros;C-tracking-issue;T-lang,60932,2019-05-18T06:26:38Z,281,321,602
C-cleanup;E-easy,60934,2019-05-18T11:21:38Z,36,58,94
"A-attributes;A-rustdoc;C-tracking-issue;T-dev-tools;T-doc;WG-docs-rustdoc,S-waiting-on-review,A-attributes;A-rustdoc;C-tracking-issue;T-dev-tools;T-doc;WG-docs-rustdoc",60938,2019-05-18T14:14:45Z,0,0,0
NULL,60944,2019-05-18T18:36:54Z,0,0,0
S-waiting-on-review,60946,2019-05-18T20:57:33Z,2,7,9
"S-blocked;S-waiting-on-review,S-waiting-on-review,S-waiting-on-review,S-waiting-on-review,S-waiting-on-review,S-waiting-on-review,S-waiting-on-bors",60949,2019-05-19T00:31:47Z,108,101,209
S-waiting-on-review,60950,2019-05-19T03:17:43Z,5,3,8
S-waiting-on-review,60952,2019-05-19T03:41:37Z,43,0,43
C-cleanup;E-easy,60955,2019-05-19T08:40:22Z,350,350,700
S-waiting-on-perf,60965,2019-05-19T17:43:40Z,526,558,1084
S-waiting-on-review,60967,2019-05-19T19:17:23Z,22,0,22
S-waiting-on-review,60968,2019-05-19T21:16:40Z,0,0,0
"S-waiting-on-review,S-waiting-on-bors,S-waiting-on-review,S-waiting-on-bors,S-waiting-on-review",60969,2019-05-19T23:01:45Z,402,128,530
NULL,60972,2019-05-20T07:53:44Z,0,6,6
S-waiting-on-review,60973,2019-05-20T08:59:14Z,34,34,68
S-waiting-on-review,60974,2019-05-20T12:08:08Z,88,4,92
NULL,60982,2019-05-20T18:47:18Z,11,11,22
NULL,60985,2019-05-20T20:55:49Z,1,1,2
"S-waiting-on-review,S-waiting-on-review,S-waiting-on-review,S-waiting-on-review,S-waiting-on-review,S-waiting-on-review,S-waiting-on-review,S-waiting-on-review,S-waiting-on-review,S-waiting-on-review,S-waiting-on-review",60986,2019-05-20T21:03:11Z,441,287,728
S-waiting-on-review,60990,2019-05-20T23:02:07Z,0,0,0
"S-waiting-on-review,S-waiting-on-review,S-waiting-on-review",60992,2019-05-21T00:40:19Z,0,0,0
S-waiting-on-review,61003,2019-05-21T10:09:27Z,34,66,100
A-LLVM;O-windows-msvc;T-compiler,61005,2019-05-21T10:14:15Z,53,8,61
S-waiting-on-review,61006,2019-05-21T11:11:27Z,1,1,2
A-debuginfo;I-nominated;T-compiler;regression-from-stable-to-stable,61007,2019-05-21T11:50:58Z,21,2,23
NULL,61008,2019-05-21T12:53:03Z,14,3,17
"S-waiting-on-bors,S-waiting-on-review,S-waiting-on-review,S-waiting-on-review,S-waiting-on-review,S-waiting-on-review",61009,2019-05-21T13:57:04Z,0,0,0
"B-unstable;C-tracking-issue;I-compiletime;T-compiler,I-nominated;T-compiler",61014,2019-05-21T19:42:08Z,12,9,21
"S-waiting-on-review,S-waiting-on-review,S-waiting-on-bors,S-waiting-on-review,S-waiting-on-review,S-waiting-on-review,S-waiting-on-review,S-waiting-on-review,S-waiting-on-review",61016,2019-05-21T20:01:11Z,0,0,0
"S-waiting-on-bors,S-waiting-on-review,S-waiting-on-review,S-waiting-on-review,S-waiting-on-review,S-waiting-on-review,S-waiting-on-review,S-waiting-on-review",61018,2019-05-21T21:41:38Z,0,0,0
"S-waiting-on-review,S-waiting-on-review,S-waiting-on-author,S-waiting-on-bors,S-waiting-on-review,S-waiting-on-review,S-waiting-on-review,S-waiting-on-review",61025,2019-05-22T00:52:40Z,0,0,0
A-diagnostics;A-parser,61026,2019-05-22T01:12:37Z,184,114,298
"S-waiting-on-author,S-waiting-on-bors,S-waiting-on-review,S-waiting-on-review,S-waiting-on-review,S-waiting-on-review,S-waiting-on-review,S-waiting-on-review,S-waiting-on-review,S-waiting-on-review",61027,2019-05-22T01:47:44Z,377,346,723
"S-waiting-on-review,S-waiting-on-review,S-waiting-on-review,S-waiting-on-review,S-waiting-on-review",61032,2019-05-22T05:59:16Z,0,0,0
S-waiting-on-review,61034,2019-05-22T09:20:27Z,157,665,822
"S-waiting-on-review,S-waiting-on-review,S-waiting-on-bors,S-waiting-on-review,S-waiting-on-review,S-waiting-on-bors,S-waiting-on-review,S-waiting-on-review",61044,2019-05-22T16:08:28Z,582,838,1420
NULL,61046,2019-05-22T17:22:37Z,57,8,65
S-waiting-on-review,61050,2019-05-22T18:16:10Z,0,0,0
A-save-analysis;C-enhancement;T-compiler,61052,2019-05-22T19:09:31Z,26,8,34
NULL,61054,2019-05-22T20:10:58Z,93,5,98
NULL,61055,2019-05-22T20:44:30Z,1,1,2
NULL,61056,2019-05-22T21:00:39Z,63,26,89
S-waiting-on-review,61060,2019-05-22T23:50:50Z,0,0,0
C-cleanup;T-compiler,61062,2019-05-23T00:37:05Z,733,636,1369